MURDGRP,SEX,MSA_LABEL,WEAPON_CODE,TOTAL,SOLVED,PERCENT,WEAPON_LABEL,UNSOLVED
44682127,1,"New York-New Jersey-Long Island, NY-NJ",6,32079,14715,0.4587113064621715,"Handgun - pistol, revolver, etc",17364
53190724,1,"Los Angeles-Long Beach, CA",6,32105,17445,0.5433733063385765,"Handgun - pistol, revolver, etc",14660
19709284,1,"Chicago-Naperville-Joliet, IL-IN-WI",6,20953,10767,0.513864363098363,"Handgun - pistol, revolver, etc",10186
90858271,1,"Baltimore-Towson, MD",6,9672,4423,0.45729942100909843,"Handgun - pistol, revolver, etc",5249
58219790,1,"Washington-Arlington-Alexandria, DC-VA-MD-WV",6,8712,3699,0.42458677685950413,"Handgun - pistol, revolver, etc",5013
45536119,1,"Philadelphia-Camden-Wilmington, PA-NJ-DE",6,13978,9318,0.6666189726713406,"Handgun - pistol, revolver, etc",4660
10996978,1,"San Francisco-Oakland-Fremont, CA",6,7486,3707,0.49519102324338765,"Handgun - pistol, revolver, etc",3779
32521546,1,"Detroit-Warren-Livonia, MI",6,10017,6641,0.6629729459918139,"Handgun - pistol, revolver, etc",3376
45913255,1,"Atlanta-Sandy Springs-Marietta, GA",6,8718,5485,0.6291580637760954,"Handgun - pistol, revolver, etc",3233
95120032,1,"New Orleans-Metairie-Kenner, LA",6,6960,3901,0.5604885057471264,"Handgun - pistol, revolver, etc",3059
6189223,1,"New York-New Jersey-Long Island, NY-NJ",7,9696,6707,0.6917285478547854,Knife or cutting instrument,2989
46187837,1,"Dallas-Fort Worth-Arlington, TX",6,9603,7054,0.734562116005415,"Handgun - pistol, revolver, etc",2549
99585251,1,"Detroit-Warren-Livonia, MI",5,4516,2036,0.4508414526129318,"Firearm, type not stated",2480
36238627,1,"Miami-Fort Lauderdale, FL",6,6658,4379,0.657705016521478,"Handgun - pistol, revolver, etc",2279
19864334,1,"Houston-Sugar Land-Baytown, TX",6,11935,9743,0.816338500209468,"Handgun - pistol, revolver, etc",2192
94137227,1,"Riverside-San Bernardino, CA",6,5598,3434,0.6134333690603787,"Handgun - pistol, revolver, etc",2164
40039679,1,"St. Louis, MO-IL",5,2961,811,0.2738939547450186,"Firearm, type not stated",2150
34133536,1,"Los Angeles-Long Beach, CA",7,6671,4630,0.6940488682356468,Knife or cutting instrument,2041
99793829,1,"Miami-Fort Lauderdale, FL",5,4294,2275,0.5298090358639963,"Firearm, type not stated",2019
24100873,1,"St. Louis, MO-IL",6,4810,2916,0.6062370062370063,"Handgun - pistol, revolver, etc",1894
93362112,1,"Los Angeles-Long Beach, CA",5,2700,969,0.35888888888888887,"Firearm, type not stated",1731
19338578,1,"Chicago-Naperville-Joliet, IL-IN-WI",5,2476,964,0.3893376413570275,"Firearm, type not stated",1512
65899067,1,"Dallas-Fort Worth-Arlington, TX",5,2667,1185,0.44431946006749157,"Firearm, type not stated",1482
43911881,1,"Phoenix-Mesa-Scottsdale, AZ",6,5687,4237,0.745032530332337,"Handgun - pistol, revolver, etc",1450
68843893,2,"New York-New Jersey-Long Island, NY-NJ",6,3386,2219,0.6553455404607206,"Handgun - pistol, revolver, etc",1167
70993400,1,"Washington-Arlington-Alexandria, DC-VA-MD-WV",5,2192,1029,0.46943430656934304,"Firearm, type not stated",1163
38308722,1,"New York-New Jersey-Long Island, NY-NJ",5,1981,864,0.43614336193841496,"Firearm, type not stated",1117
62493998,2,"Los Angeles-Long Beach, CA",6,3936,2839,0.7212906504065041,"Handgun - pistol, revolver, etc",1097
51713198,1,"New York-New Jersey-Long Island, NY-NJ",11,2907,1810,0.6226350189198486,"Personal weapons, includes beating",1097
50337986,1,"San Diego-Carlsbad-San Marcos, CA",6,2484,1497,0.6026570048309179,"Handgun - pistol, revolver, etc",987
72627105,1,"New Orleans-Metairie-Kenner, LA",5,1694,739,0.436245572609209,"Firearm, type not stated",955
27678137,1,"Cleveland-Elyria-Mentor, OH",6,3260,2328,0.7141104294478527,"Handgun - pistol, revolver, etc",932
99478562,1,"Houston-Sugar Land-Baytown, TX",5,2736,1821,0.6655701754385965,"Firearm, type not stated",915
82618234,1,"New York-New Jersey-Long Island, NY-NJ",10,1755,841,0.4792022792022792,Other or type unknown,914
54914405,1,"Richmond, VA",6,2451,1540,0.6283149734802121,"Handgun - pistol, revolver, etc",911
47592722,1,"Boston-Cambridge-Quincy, MA-NH",6,1737,827,0.4761082325849165,"Handgun - pistol, revolver, etc",910
65759645,2,"New York-New Jersey-Long Island, NY-NJ",7,3187,2288,0.7179165359272043,Knife or cutting instrument,899
70836703,1,"Jacksonville, FL",6,2271,1395,0.6142668428005285,"Handgun - pistol, revolver, etc",876
41751451,1,"Pittsburgh, PA",6,2040,1178,0.5774509803921568,"Handgun - pistol, revolver, etc",862
69589827,1,"San Francisco-Oakland-Fremont, CA",5,1185,326,0.2751054852320675,"Firearm, type not stated",859
29045847,1,"Los Angeles-Long Beach, CA",1,1912,1078,0.5638075313807531,"Blunt object - hammer, club, etc",834
8805645,1,"San Antonio, TX",6,2972,2151,0.7237550471063257,"Handgun - pistol, revolver, etc",821
2604783,1,"Indianapolis, IN",6,2653,1844,0.6950621937429325,"Handgun - pistol, revolver, etc",809
76648504,1,"Kansas City, MO-KS",5,1950,1146,0.5876923076923077,"Firearm, type not stated",804
44764014,1,"New York-New Jersey-Long Island, NY-NJ",1,1916,1162,0.6064718162839249,"Blunt object - hammer, club, etc",754
84362175,2,"Chicago-Naperville-Joliet, IL-IN-WI",6,2463,1717,0.6971173365814048,"Handgun - pistol, revolver, etc",746
71539109,1,"Las Vegas-Paradise, NV",6,2134,1395,0.6537019681349578,"Handgun - pistol, revolver, etc",739
9036801,1,"Birmingham-Hoover, AL",6,2798,2064,0.7376697641172266,"Handgun - pistol, revolver, etc",734
15750562,1,"Chicago-Naperville-Joliet, IL-IN-WI",7,3587,2854,0.7956509618065235,Knife or cutting instrument,733
15641893,2,"New York-New Jersey-Long Island, NY-NJ",11,1867,1153,0.6175682913765399,"Personal weapons, includes beating",714
28022569,1,"Philadelphia-Camden-Wilmington, PA-NJ-DE",5,1109,395,0.35617673579801623,"Firearm, type not stated",714
6149125,1,"Memphis, TN-MS-AR",5,1790,1120,0.6256983240223464,"Firearm, type not stated",670
31423762,1,"Sacramento-Roseville, CA",6,2140,1479,0.6911214953271028,"Handgun - pistol, revolver, etc",661
33263246,1,"Washington-Arlington-Alexandria, DC-VA-MD-WV",7,2054,1396,0.6796494644595911,Knife or cutting instrument,658
45659510,1,"Baton Rouge, LA",6,2228,1579,0.7087073608617595,"Handgun - pistol, revolver, etc",649
68323444,1,"Miami-Fort Lauderdale, FL",10,1137,496,0.436235708003518,Other or type unknown,641
29448632,1,"Indianapolis, IN",5,995,362,0.36381909547738694,"Firearm, type not stated",633
11984985,1,"Los Angeles-Long Beach, CA",15,1958,1329,0.6787538304392237,Shotgun,629
74647787,1,"Charlotte-Gastonia-Concord, NC-SC",6,2689,2070,0.7698029007065824,"Handgun - pistol, revolver, etc",619
44942469,1,"Los Angeles-Long Beach, CA",14,1841,1230,0.66811515480717,Rifle,611
1954022,1,"Columbus, OH",6,2012,1402,0.6968190854870775,"Handgun - pistol, revolver, etc",610
24734218,1,"Chicago-Naperville-Joliet, IL-IN-WI",10,1109,507,0.4571686203787196,Other or type unknown,602
55458832,1,"Fresno, CA",6,1442,849,0.5887656033287101,"Handgun - pistol, revolver, etc",593
69765402,1,"Seattle-Tacoma-Bellevue, WA",6,2269,1680,0.7404142794182459,"Handgun - pistol, revolver, etc",589
17233914,1,"Boston-Cambridge-Quincy, MA-NH",5,884,296,0.334841628959276,"Firearm, type not stated",588
63282489,1,"Louisville, KY-IN",6,1814,1233,0.6797133406835723,"Handgun - pistol, revolver, etc",581
72599967,1,"Buffalo-Niagara Falls, NY",6,848,274,0.3231132075471698,"Handgun - pistol, revolver, etc",574
48923699,1,"San Francisco-Oakland-Fremont, CA",7,1825,1254,0.6871232876712329,Knife or cutting instrument,571
69850304,1,"Memphis, TN-MS-AR",6,3811,3242,0.8506953555497245,"Handgun - pistol, revolver, etc",569
5079396,1,"Virginia Beach-Norfolk-Newport News, VA-NC",6,2758,2192,0.794778825235678,"Handgun - pistol, revolver, etc",566
14121707,1,"Kansas City, MO-KS",6,2342,1777,0.7587532023911187,"Handgun - pistol, revolver, etc",565
10510510,1,"Nashville-Davidson-Murfreesboro, TN",6,2404,1843,0.7666389351081531,"Handgun - pistol, revolver, etc",561
74159704,1,"Houston-Sugar Land-Baytown, TX",7,2801,2248,0.8025705105319528,Knife or cutting instrument,553
94368706,1,"Stockton, CA",6,1300,756,0.5815384615384616,"Handgun - pistol, revolver, etc",544
63054398,1,"Cincinnati-Middletown, OH-KY-IN",6,1631,1100,0.674432863274065,"Handgun - pistol, revolver, etc",531
79363330,1,"Phoenix-Mesa-Scottsdale, AZ",5,824,295,0.3580097087378641,"Firearm, type not stated",529
64797007,1,"Dallas-Fort Worth-Arlington, TX",7,2081,1559,0.7491590581451225,Knife or cutting instrument,522
87064103,1,"Detroit-Warren-Livonia, MI",7,2269,1762,0.7765535478184222,Knife or cutting instrument,507
37119478,1,"Richmond, VA",5,1141,642,0.5626643295354952,"Firearm, type not stated",499
67936706,2,"New York-New Jersey-Long Island, NY-NJ",10,985,502,0.5096446700507614,Other or type unknown,483
13022657,1,"Jackson, MS",6,1713,1234,0.7203736135434909,"Handgun - pistol, revolver, etc",479
78349742,1,"San Antonio, TX",5,1166,693,0.5943396226415094,"Firearm, type not stated",473
40158611,1,"Columbus, OH",5,827,362,0.437726723095526,"Firearm, type not stated",465
83833774,1,"Virginia Beach-Norfolk-Newport News, VA-NC",5,1184,720,0.6081081081081081,"Firearm, type not stated",464
89201110,2,"Los Angeles-Long Beach, CA",7,1674,1217,0.7270011947431302,Knife or cutting instrument,457
22469366,1,"Baltimore-Towson, MD",7,1677,1233,0.7352415026833632,Knife or cutting instrument,444
80898044,1,"Denver-Aurora, CO",6,2180,1740,0.7981651376146789,"Handgun - pistol, revolver, etc",440
27704717,1,"Bridgeport-Stamford-Norwalk, CT",6,859,419,0.48777648428405124,"Handgun - pistol, revolver, etc",440
96588414,1,"Milwaukee-Waukesha-West Allis, WI",6,2394,1958,0.8178780284043442,"Handgun - pistol, revolver, etc",436
33140496,1,"Los Angeles-Long Beach, CA",11,1766,1336,0.7565118912797282,"Personal weapons, includes beating",430
61115302,1,"Cleveland-Elyria-Mentor, OH",5,764,337,0.4410994764397906,"Firearm, type not stated",427
89352075,1,Rural North Carolina,6,2766,2340,0.8459869848156182,"Handgun - pistol, revolver, etc",426
77611810,1,"Bakersfield, CA",6,1138,715,0.6282952548330404,"Handgun - pistol, revolver, etc",423
66346982,1,"Detroit-Warren-Livonia, MI",10,927,505,0.5447680690399137,Other or type unknown,422
12135859,1,"Minneapolis-St. Paul-Bloomington, MN-WI",6,1687,1277,0.7569650266745702,"Handgun - pistol, revolver, etc",410
4190482,1,"Tucson, AZ",6,1483,1075,0.724881995954147,"Handgun - pistol, revolver, etc",408
49139698,2,"Detroit-Warren-Livonia, MI",6,1649,1247,0.7562158884172225,"Handgun - pistol, revolver, etc",402
2841061,1,"Milwaukee-Waukesha-West Allis, WI",5,928,533,0.5743534482758621,"Firearm, type not stated",395
95627511,2,"Washington-Arlington-Alexandria, DC-VA-MD-WV",6,1188,798,0.6717171717171717,"Handgun - pistol, revolver, etc",390
19359957,1,"Philadelphia-Camden-Wilmington, PA-NJ-DE",7,2508,2126,0.8476874003189793,Knife or cutting instrument,382
87723568,1,"Oklahoma City, OK",6,1862,1484,0.7969924812030075,"Handgun - pistol, revolver, etc",378
34531413,1,"Riverside-San Bernardino, CA",5,681,305,0.447870778267254,"Firearm, type not stated",376
72485252,1,"Rochester, NY",6,788,413,0.5241116751269036,"Handgun - pistol, revolver, etc",375
49753899,1,"Miami-Fort Lauderdale, FL",7,1615,1248,0.7727554179566564,Knife or cutting instrument,367
41912975,2,"San Francisco-Oakland-Fremont, CA",6,1195,835,0.698744769874477,"Handgun - pistol, revolver, etc",360
63557112,1,"Las Vegas-Paradise, NV",5,970,612,0.6309278350515464,"Firearm, type not stated",358
96817244,1,"Riverside-San Bernardino, CA",7,1323,974,0.7362055933484505,Knife or cutting instrument,349
27703851,1,"Buffalo-Niagara Falls, NY",5,467,120,0.2569593147751606,"Firearm, type not stated",347
32353954,1,"Atlanta-Sandy Springs-Marietta, GA",5,980,635,0.6479591836734694,"Firearm, type not stated",345
71288141,1,"San Diego-Carlsbad-San Marcos, CA",7,1102,762,0.691470054446461,Knife or cutting instrument,340
91987908,1,"New York-New Jersey-Long Island, NY-NJ",15,900,565,0.6277777777777778,Shotgun,335
72485359,1,"Los Angeles-Long Beach, CA",10,730,397,0.5438356164383562,Other or type unknown,333
4149824,1,"Tampa-St. Petersburg-Clearwater, FL",5,959,627,0.6538060479666319,"Firearm, type not stated",332
23314615,1,"Flint, MI",6,856,524,0.6121495327102804,"Handgun - pistol, revolver, etc",332
35364536,1,"Orlando-Kissimmee, FL",6,1468,1139,0.7758855585831063,"Handgun - pistol, revolver, etc",329
91103951,1,"Albuquerque, NM",6,1064,737,0.6926691729323309,"Handgun - pistol, revolver, etc",327
84878321,2,"Chicago-Naperville-Joliet, IL-IN-WI",7,1260,936,0.7428571428571429,Knife or cutting instrument,324
57935069,1,"Detroit-Warren-Livonia, MI",1,853,531,0.6225087924970691,"Blunt object - hammer, club, etc",322
21172763,1,"Chicago-Naperville-Joliet, IL-IN-WI",1,1079,758,0.7025023169601483,"Blunt object - hammer, club, etc",321
55733196,1,"Youngstown-Warren-Boardman, OH-PA",6,753,432,0.5737051792828686,"Handgun - pistol, revolver, etc",321
72355246,1,"Dallas-Fort Worth-Arlington, TX",10,719,399,0.5549374130737135,Other or type unknown,320
8196399,1,"San Antonio, TX",7,1090,771,0.7073394495412844,Knife or cutting instrument,319
29128553,1,"Savannah, GA",6,905,588,0.6497237569060773,"Handgun - pistol, revolver, etc",317
75201777,1,"Pittsburgh, PA",5,521,204,0.3915547024952015,"Firearm, type not stated",317
66036809,2,"Atlanta-Sandy Springs-Marietta, GA",6,1688,1373,0.8133886255924171,"Handgun - pistol, revolver, etc",315
44629677,1,"Louisville, KY-IN",5,474,164,0.3459915611814346,"Firearm, type not stated",310
32612844,2,"Baltimore-Towson, MD",6,938,629,0.6705756929637526,"Handgun - pistol, revolver, etc",309
35119246,2,"Dallas-Fort Worth-Arlington, TX",6,1863,1555,0.8346752549651101,"Handgun - pistol, revolver, etc",308
56235592,1,"Tampa-St. Petersburg-Clearwater, FL",6,1804,1497,0.8298226164079823,"Handgun - pistol, revolver, etc",307
38678938,2,"Philadelphia-Camden-Wilmington, PA-NJ-DE",6,1566,1259,0.8039591315453385,"Handgun - pistol, revolver, etc",307
18652928,1,"Bakersfield, CA",5,492,191,0.3882113821138211,"Firearm, type not stated",301
73055159,1,"Phoenix-Mesa-Scottsdale, AZ",7,1114,814,0.7307001795332136,Knife or cutting instrument,300
23414703,1,"Boston-Cambridge-Quincy, MA-NH",7,1088,788,0.7242647058823529,Knife or cutting instrument,300
53171280,1,"Greensboro-High Point, NC",6,1044,745,0.7136015325670498,"Handgun - pistol, revolver, etc",299
55795940,1,"Hartford, CT",6,725,427,0.5889655172413794,"Handgun - pistol, revolver, etc",298
1066748,2,"Detroit-Warren-Livonia, MI",5,640,345,0.5390625,"Firearm, type not stated",295
36513824,2,"New York-New Jersey-Long Island, NY-NJ",1,774,485,0.6266149870801033,"Blunt object - hammer, club, etc",289
54334364,1,"Houston-Sugar Land-Baytown, TX",10,650,362,0.556923076923077,Other or type unknown,288
45095,1,"Salinas, CA",6,583,295,0.5060034305317325,"Handgun - pistol, revolver, etc",288
31399337,1,"Chicago-Naperville-Joliet, IL-IN-WI",9,439,152,0.3462414578587699,Other gun,287
20778030,1,"Cleveland-Elyria-Mentor, OH",10,435,150,0.3448275862068966,Other or type unknown,285
19933317,2,"Miami-Fort Lauderdale, FL",10,616,334,0.5422077922077922,Other or type unknown,282
9294900,2,"Los Angeles-Long Beach, CA",1,728,447,0.614010989010989,"Blunt object - hammer, club, etc",281
49044812,2,"Los Angeles-Long Beach, CA",16,596,317,0.5318791946308725,Strangulation - hanging,279
72291480,1,"Cincinnati-Middletown, OH-KY-IN",5,502,223,0.4442231075697211,"Firearm, type not stated",279
19773120,1,"Flint, MI",5,442,165,0.3733031674208145,"Firearm, type not stated",277
97402048,1,"Mobile, AL",6,1081,805,0.7446808510638298,"Handgun - pistol, revolver, etc",276
78734823,1,Rural Texas,6,2321,2047,0.8819474364498061,"Handgun - pistol, revolver, etc",274
76973139,1,"San Jose-Sunnyvale-Santa Clara, CA",6,962,688,0.7151767151767152,"Handgun - pistol, revolver, etc",274
69489799,1,"St. Louis, MO-IL",7,937,663,0.7075773745997865,Knife or cutting instrument,274
6072693,1,"Birmingham-Hoover, AL",5,595,324,0.5445378151260504,"Firearm, type not stated",271
83034583,1,"St. Louis, MO-IL",10,521,250,0.4798464491362764,Other or type unknown,271
45260945,1,"New York-New Jersey-Long Island, NY-NJ",4,601,331,0.5507487520798668,Fire,270
48136053,1,"Fresno, CA",5,481,211,0.4386694386694387,"Firearm, type not stated",270
99973225,1,"Baltimore-Towson, MD",5,362,92,0.2541436464088398,"Firearm, type not stated",270
90501062,1,"San Francisco-Oakland-Fremont, CA",1,575,307,0.5339130434782609,"Blunt object - hammer, club, etc",268
53039841,1,"Toledo, OH",6,782,516,0.659846547314578,"Handgun - pistol, revolver, etc",266
76190407,1,"Atlanta-Sandy Springs-Marietta, GA",7,1337,1073,0.8025430067314884,Knife or cutting instrument,264
21494356,1,"Little Rock-North Little Rock, AR",6,1399,1136,0.8120085775553967,"Handgun - pistol, revolver, etc",263
53553475,1,"Jacksonville, FL",10,481,220,0.4573804573804574,Other or type unknown,261
78682457,2,"Los Angeles-Long Beach, CA",11,989,730,0.7381193124368048,"Personal weapons, includes beating",259
45947700,1,"Detroit-Warren-Livonia, MI",15,1259,1001,0.7950754567116759,Shotgun,258
30681935,1,"Jacksonville, FL",5,435,184,0.42298850574712643,"Firearm, type not stated",251
67245872,1,"Houston-Sugar Land-Baytown, TX",1,736,486,0.6603260869565217,"Blunt object - hammer, club, etc",250
70159158,1,"Vallejo-Fairfield, CA",6,548,299,0.5456204379562044,"Handgun - pistol, revolver, etc",249
23459577,1,"Visalia-Porterville, CA",6,668,421,0.6302395209580839,"Handgun - pistol, revolver, etc",247
352629,2,"Houston-Sugar Land-Baytown, TX",6,2077,1831,0.8815599422243621,"Handgun - pistol, revolver, etc",246
52026530,1,"Dallas-Fort Worth-Arlington, TX",1,594,349,0.5875420875420876,"Blunt object - hammer, club, etc",245
92677818,2,"New Orleans-Metairie-Kenner, LA",6,920,680,0.7391304347826086,"Handgun - pistol, revolver, etc",240
83889725,2,"Miami-Fort Lauderdale, FL",6,1317,1080,0.8200455580865603,"Handgun - pistol, revolver, etc",237
15416964,1,"Shreveport-Bossier City, LA",6,1225,988,0.806530612244898,"Handgun - pistol, revolver, etc",237
41396316,1,"Detroit-Warren-Livonia, MI",14,1190,954,0.8016806722689076,Rifle,236
1224210,2,"St. Louis, MO-IL",5,372,142,0.3817204301075269,"Firearm, type not stated",230
14985016,2,"Washington-Arlington-Alexandria, DC-VA-MD-WV",7,696,467,0.6709770114942529,Knife or cutting instrument,229
82542895,1,"Little Rock-North Little Rock, AR",5,525,298,0.5676190476190476,"Firearm, type not stated",227
68537278,1,Rural North Carolina,10,591,365,0.6175972927241963,Other or type unknown,226
53475514,1,"Washington-Arlington-Alexandria, DC-VA-MD-WV",10,558,335,0.600358422939068,Other or type unknown,223
7392255,1,"New Orleans-Metairie-Kenner, LA",7,881,659,0.7480136208853575,Knife or cutting instrument,222
68262923,1,"Oxnard-Thousand Oaks-Ventura, CA",6,514,293,0.5700389105058365,"Handgun - pistol, revolver, etc",221
9617288,2,"Los Angeles-Long Beach, CA",10,488,267,0.5471311475409836,Other or type unknown,221
5438667,1,"Atlanta-Sandy Springs-Marietta, GA",10,510,291,0.5705882352941176,Other or type unknown,219
80550664,2,"Miami-Fort Lauderdale, FL",5,716,501,0.6997206703910615,"Firearm, type not stated",215
11714105,1,"Trenton-Ewing, NJ",6,425,211,0.4964705882352941,"Handgun - pistol, revolver, etc",214
34929405,1,"Tulsa, OK",6,1452,1239,0.8533057851239669,"Handgun - pistol, revolver, etc",213
37169241,1,"Durham, NC",6,821,611,0.7442143727161997,"Handgun - pistol, revolver, etc",210
3904379,1,"Denver-Aurora, CO",5,627,417,0.6650717703349283,"Firearm, type not stated",210
8781615,1,Rural South Carolina,6,1770,1562,0.8824858757062147,"Handgun - pistol, revolver, etc",208
57568740,1,"Portland-Vancouver-Beaverton, OR-WA",6,945,741,0.7841269841269841,"Handgun - pistol, revolver, etc",204
37597933,2,"Detroit-Warren-Livonia, MI",7,797,593,0.7440401505646174,Knife or cutting instrument,204
34121579,1,"Shreveport-Bossier City, LA",5,328,124,0.3780487804878049,"Firearm, type not stated",204
22769818,1,Rural Alabama,6,1141,938,0.8220858895705522,"Handgun - pistol, revolver, etc",203
71530296,2,"Houston-Sugar Land-Baytown, TX",7,833,630,0.7563025210084033,Knife or cutting instrument,203
98038283,1,Rural Kentucky,6,1521,1319,0.8671926364234056,"Handgun - pistol, revolver, etc",202
79913697,1,"Dayton, OH",6,920,718,0.7804347826086957,"Handgun - pistol, revolver, etc",202
22438396,1,"New Haven-Milford, CT",6,631,432,0.6846275752773375,"Handgun - pistol, revolver, etc",199
33402462,2,"Chicago-Naperville-Joliet, IL-IN-WI",16,394,195,0.4949238578680203,Strangulation - hanging,199
46693167,1,"Montgomery, AL",6,660,462,0.7,"Handgun - pistol, revolver, etc",198
94777060,1,"Chicago-Naperville-Joliet, IL-IN-WI",15,609,411,0.6748768472906403,Shotgun,198
76278697,2,"Riverside-San Bernardino, CA",6,970,774,0.797938144329897,"Handgun - pistol, revolver, etc",196
59723782,1,"Washington-Arlington-Alexandria, DC-VA-MD-WV",1,445,249,0.5595505617977528,"Blunt object - hammer, club, etc",196
81926623,1,"Providence-New Bedford-Fall River, RI-MA",5,379,183,0.48284960422163586,"Firearm, type not stated",196
31637159,1,"San Francisco-Oakland-Fremont, CA",14,473,278,0.587737843551797,Rifle,195
35404490,2,"St. Louis, MO-IL",6,835,643,0.770059880239521,"Handgun - pistol, revolver, etc",192
81611960,1,"San Antonio, TX",10,443,251,0.5665914221218962,Other or type unknown,192
67547368,1,"Orlando-Kissimmee, FL",5,754,563,0.746684350132626,"Firearm, type not stated",191
56242357,1,"Augusta-Richmond County, GA-SC",6,839,649,0.7735399284862932,"Handgun - pistol, revolver, etc",190
78163644,1,"New Haven-Milford, CT",5,376,187,0.4973404255319149,"Firearm, type not stated",189
13938178,1,"Chicago-Naperville-Joliet, IL-IN-WI",14,507,320,0.631163708086785,Rifle,187
3146360,1,"Los Angeles-Long Beach, CA",16,351,164,0.4672364672364672,Strangulation - hanging,187
46554254,2,"Dallas-Fort Worth-Arlington, TX",7,728,542,0.7445054945054945,Knife or cutting instrument,186
69914095,2,"New York-New Jersey-Long Island, NY-NJ",16,399,213,0.5338345864661654,Strangulation - hanging,186
20600690,1,"San Diego-Carlsbad-San Marcos, CA",5,356,170,0.47752808988764045,"Firearm, type not stated",186
10773703,1,"Salinas, CA",5,241,57,0.23651452282157676,"Firearm, type not stated",184
19275896,1,Rural Mississippi,6,1749,1566,0.8953687821612349,"Handgun - pistol, revolver, etc",183
49903048,2,"Detroit-Warren-Livonia, MI",10,477,294,0.6163522012578616,Other or type unknown,183
1663831,2,"Dallas-Fort Worth-Arlington, TX",10,462,279,0.6038961038961039,Other or type unknown,183
59779,1,"Seattle-Tacoma-Bellevue, WA",5,433,250,0.5773672055427251,"Firearm, type not stated",183
7418546,1,"Miami-Fort Lauderdale, FL",14,450,268,0.5955555555555555,Rifle,182
8855518,2,"Philadelphia-Camden-Wilmington, PA-NJ-DE",7,910,729,0.8010989010989011,Knife or cutting instrument,181
74781994,1,"Dallas-Fort Worth-Arlington, TX",15,974,796,0.8172484599589322,Shotgun,178
95129861,2,"Baltimore-Towson, MD",7,603,425,0.7048092868988391,Knife or cutting instrument,178
40764653,2,"Dallas-Fort Worth-Arlington, TX",5,408,231,0.5661764705882353,"Firearm, type not stated",177
3073598,2,"Phoenix-Mesa-Scottsdale, AZ",6,1176,1000,0.8503401360544217,"Handgun - pistol, revolver, etc",176
59607891,1,"New York-New Jersey-Long Island, NY-NJ",17,482,308,0.6390041493775933,Weapon Not Reported,174
49417425,1,"Phoenix-Mesa-Scottsdale, AZ",1,456,284,0.6228070175438597,"Blunt object - hammer, club, etc",172
2294834,2,"Chicago-Naperville-Joliet, IL-IN-WI",10,454,283,0.6233480176211453,Other or type unknown,171
47345041,1,Rural Georgia,6,1424,1255,0.8813202247191011,"Handgun - pistol, revolver, etc",169
39817670,1,"Fayetteville, NC",6,627,458,0.7304625199362041,"Handgun - pistol, revolver, etc",169
75935142,2,"San Francisco-Oakland-Fremont, CA",7,594,425,0.7154882154882155,Knife or cutting instrument,169
50424729,1,"Miami-Fort Lauderdale, FL",1,510,342,0.6705882352941176,"Blunt object - hammer, club, etc",168
51195641,1,Rural South Carolina,5,516,349,0.6763565891472868,"Firearm, type not stated",167
90479569,1,"Phoenix-Mesa-Scottsdale, AZ",10,341,175,0.5131964809384164,Other or type unknown,166
99076783,1,"Philadelphia-Camden-Wilmington, PA-NJ-DE",10,485,320,0.6597938144329897,Other or type unknown,165
93386009,1,"Sacramento-Roseville, CA",5,308,143,0.4642857142857143,"Firearm, type not stated",165
26417084,1,"Las Vegas-Paradise, NV",7,598,436,0.7290969899665551,Knife or cutting instrument,162
9390153,1,"Dayton, OH",5,384,223,0.5807291666666666,"Firearm, type not stated",161
43917400,1,"Omaha-Council Bluffs, NE-IA",6,475,315,0.6631578947368421,"Handgun - pistol, revolver, etc",160
46604445,1,"Baltimore-Towson, MD",1,431,271,0.62877030162413,"Blunt object - hammer, club, etc",160
60832981,1,"Atlantic City, NJ",6,305,146,0.4786885245901639,"Handgun - pistol, revolver, etc",159
24753262,1,"Hartford, CT",5,265,106,0.4,"Firearm, type not stated",159
15024316,2,"Detroit-Warren-Livonia, MI",16,253,94,0.3715415019762846,Strangulation - hanging,159
75707719,1,"Atlanta-Sandy Springs-Marietta, GA",1,429,271,0.6317016317016317,"Blunt object - hammer, club, etc",158
19050234,2,"Houston-Sugar Land-Baytown, TX",10,380,222,0.5842105263157895,Other or type unknown,158
46662322,1,"Philadelphia-Camden-Wilmington, PA-NJ-DE",1,609,452,0.7422003284072249,"Blunt object - hammer, club, etc",157
59121225,1,"Portland-Vancouver-Beaverton, OR-WA",5,369,212,0.5745257452574526,"Firearm, type not stated",157
73038755,1,"Columbus, GA-AL",6,591,435,0.7360406091370558,"Handgun - pistol, revolver, etc",156
17167116,1,"Baton Rouge, LA",5,353,197,0.5580736543909348,"Firearm, type not stated",156
90862538,1,"Seattle-Tacoma-Bellevue, WA",7,663,508,0.7662141779788839,Knife or cutting instrument,155
77401058,1,"Cape Coral-Fort Myers, FL",5,346,191,0.5520231213872833,"Firearm, type not stated",155
8997210,2,"Los Angeles-Long Beach, CA",5,280,125,0.44642857142857145,"Firearm, type not stated",155
69741176,1,"Rochester, NY",5,274,119,0.4343065693430657,"Firearm, type not stated",155
50760948,1,"Modesto, CA",6,542,388,0.7158671586715867,"Handgun - pistol, revolver, etc",154
45486699,2,"New York-New Jersey-Long Island, NY-NJ",4,408,255,0.625,Fire,153
23723215,1,"Denver-Aurora, CO",7,744,593,0.7970430107526881,Knife or cutting instrument,151
44225040,1,"New Orleans-Metairie-Kenner, LA",14,349,199,0.5702005730659025,Rifle,150
51553793,1,"Riverside-San Bernardino, CA",1,477,328,0.6876310272536688,"Blunt object - hammer, club, etc",149
50508012,2,"Chicago-Naperville-Joliet, IL-IN-WI",11,631,483,0.7654516640253566,"Personal weapons, includes beating",148
16770086,1,"Columbus, OH",10,281,136,0.48398576512455516,Other or type unknown,145
62731276,1,"Montgomery, AL",5,184,39,0.21195652173913043,"Firearm, type not stated",145
2899776,1,"Riverside-San Bernardino, CA",15,577,433,0.7504332755632582,Shotgun,144
45753882,1,Rural North Carolina,9,354,210,0.5932203389830508,Other gun,144
65437114,1,"Fresno, CA",7,509,366,0.7190569744597249,Knife or cutting instrument,143
26494183,1,"Kansas City, MO-KS",10,359,216,0.6016713091922006,Other or type unknown,143
49033221,1,"Providence-New Bedford-Fall River, RI-MA",6,423,282,0.6666666666666666,"Handgun - pistol, revolver, etc",141
16787539,2,"Chicago-Naperville-Joliet, IL-IN-WI",5,299,158,0.5284280936454849,"Firearm, type not stated",141
97993828,1,"Saginaw, MI",6,402,263,0.654228855721393,"Handgun - pistol, revolver, etc",139
52010447,1,"Albuquerque, NM",5,398,260,0.6532663316582915,"Firearm, type not stated",138
21272424,1,"San Jose-Sunnyvale-Santa Clara, CA",7,525,388,0.7390476190476191,Knife or cutting instrument,137
89197221,1,"South Bend-Mishawaka, IN-MI",6,410,273,0.6658536585365854,"Handgun - pistol, revolver, etc",137
52987648,1,"Chicago-Naperville-Joliet, IL-IN-WI",11,830,695,0.8373493975903614,"Personal weapons, includes beating",135
48051212,1,"McAllen-Edinburg-Mission, TX",6,523,388,0.7418738049713193,"Handgun - pistol, revolver, etc",135
200798,1,"Allentown-Bethlehem-Easton, PA-NJ",6,281,146,0.5195729537366548,"Handgun - pistol, revolver, etc",135
32499191,1,"Youngstown-Warren-Boardman, OH-PA",5,246,111,0.45121951219512196,"Firearm, type not stated",135
87578992,1,Rural Louisiana,6,1362,1228,0.9016152716593245,"Handgun - pistol, revolver, etc",134
81660252,1,"Sacramento-Roseville, CA",7,696,563,0.8089080459770115,Knife or cutting instrument,133
10973117,2,"Birmingham-Hoover, AL",6,543,410,0.7550644567219152,"Handgun - pistol, revolver, etc",133
5143162,1,"San Francisco-Oakland-Fremont, CA",11,498,365,0.7329317269076305,"Personal weapons, includes beating",133
69290965,1,"Bakersfield, CA",7,434,301,0.6935483870967742,Knife or cutting instrument,133
81567919,1,"St. Louis, MO-IL",15,424,291,0.6863207547169812,Shotgun,133
72872784,1,"Stockton, CA",5,250,117,0.468,"Firearm, type not stated",133
52926741,2,"Miami-Fort Lauderdale, FL",7,654,523,0.7996941896024465,Knife or cutting instrument,131
95457850,1,"San Diego-Carlsbad-San Marcos, CA",1,292,161,0.5513698630136986,"Blunt object - hammer, club, etc",131
6039924,1,"Bridgeport-Stamford-Norwalk, CT",5,242,111,0.45867768595041325,"Firearm, type not stated",131
38270100,1,"Fort Wayne, IN",6,438,308,0.7031963470319634,"Handgun - pistol, revolver, etc",130
58034469,1,"Riverside-San Bernardino, CA",10,293,164,0.5597269624573379,Other or type unknown,129
73856129,1,"Birmingham-Hoover, AL",10,268,139,0.5186567164179104,Other or type unknown,129
58856918,1,"New Orleans-Metairie-Kenner, LA",10,297,169,0.569023569023569,Other or type unknown,128
7521512,2,"Dallas-Fort Worth-Arlington, TX",1,275,147,0.5345454545454545,"Blunt object - hammer, club, etc",128
58105479,1,"Dallas-Fort Worth-Arlington, TX",14,650,523,0.8046153846153846,Rifle,127
67154924,1,"Houston-Sugar Land-Baytown, TX",15,1152,1026,0.890625,Shotgun,126
72834439,2,"Washington-Arlington-Alexandria, DC-VA-MD-WV",10,381,255,0.6692913385826772,Other or type unknown,126
883702,2,"Atlanta-Sandy Springs-Marietta, GA",7,531,406,0.7645951035781544,Knife or cutting instrument,125
66216185,1,"Tampa-St. Petersburg-Clearwater, FL",10,318,193,0.6069182389937107,Other or type unknown,125
19292148,1,"Milwaukee-Waukesha-West Allis, WI",10,258,133,0.5155038759689923,Other or type unknown,125
19220219,1,"San Francisco-Oakland-Fremont, CA",15,407,283,0.6953316953316954,Shotgun,124
63790425,2,"Detroit-Warren-Livonia, MI",1,345,221,0.6405797101449275,"Blunt object - hammer, club, etc",124
26870293,2,"Jacksonville, FL",10,254,130,0.5118110236220472,Other or type unknown,124
26922025,2,"Atlanta-Sandy Springs-Marietta, GA",16,206,83,0.4029126213592233,Strangulation - hanging,123
19530468,1,"Mobile, AL",5,177,54,0.3050847457627119,"Firearm, type not stated",123
89578501,1,"Raleigh-Cary, NC",6,711,589,0.8284106891701828,"Handgun - pistol, revolver, etc",122
90841038,1,"Miami-Fort Lauderdale, FL",11,622,501,0.8054662379421221,"Personal weapons, includes beating",121
99701400,1,"Reading, PA",5,180,61,0.3388888888888889,"Firearm, type not stated",119
91514688,1,"Macon, GA",6,589,472,0.801358234295416,"Handgun - pistol, revolver, etc",117
7177061,1,"Charleston-North Charleston, SC",5,401,284,0.7082294264339152,"Firearm, type not stated",117
82723760,1,"Indianapolis, IN",10,253,136,0.5375494071146245,Other or type unknown,117
70830521,2,"Chicago-Naperville-Joliet, IL-IN-WI",1,374,258,0.6898395721925134,"Blunt object - hammer, club, etc",116
67808140,1,"New Orleans-Metairie-Kenner, LA",1,250,136,0.544,"Blunt object - hammer, club, etc",114
97315714,1,Rural Alabama,5,241,127,0.5269709543568465,"Firearm, type not stated",114
85564782,1,"Knoxville, TN",6,725,612,0.8441379310344828,"Handgun - pistol, revolver, etc",113
48826624,2,"Kansas City, MO-KS",5,327,214,0.654434250764526,"Firearm, type not stated",113
21913277,1,"New York-New Jersey-Long Island, NY-NJ",16,217,104,0.4792626728110599,Strangulation - hanging,113
15556631,1,"Merced, CA",6,267,155,0.5805243445692884,"Handgun - pistol, revolver, etc",112
62127489,2,"Seattle-Tacoma-Bellevue, WA",10,202,90,0.44554455445544555,Other or type unknown,112
13844317,1,Rural Oklahoma,6,1071,960,0.896358543417367,"Handgun - pistol, revolver, etc",111
79954906,1,"Albuquerque, NM",7,398,287,0.7211055276381909,Knife or cutting instrument,111
17281222,1,"Atlanta-Sandy Springs-Marietta, GA",14,387,276,0.7131782945736435,Rifle,111
82733969,1,"Richmond, VA",10,280,169,0.6035714285714285,Other or type unknown,111
91011267,1,"Minneapolis-St. Paul-Bloomington, MN-WI",5,278,167,0.6007194244604317,"Firearm, type not stated",111
79490481,1,"San Diego-Carlsbad-San Marcos, CA",10,232,121,0.521551724137931,Other or type unknown,111
30464436,1,"Austin-Round Rock, TX",6,944,834,0.8834745762711864,"Handgun - pistol, revolver, etc",110
39339778,1,"Atlanta-Sandy Springs-Marietta, GA",15,431,321,0.7447795823665894,Shotgun,110
29263762,1,Rural North Carolina,5,355,246,0.6929577464788732,"Firearm, type not stated",109
75819734,2,"Indianapolis, IN",6,529,421,0.7958412098298677,"Handgun - pistol, revolver, etc",108
76038365,1,"St. Louis, MO-IL",14,320,212,0.6625,Rifle,108
47556930,1,"Kansas City, MO-KS",7,534,428,0.8014981273408239,Knife or cutting instrument,106
12037258,2,"Detroit-Warren-Livonia, MI",11,442,336,0.7601809954751131,"Personal weapons, includes beating",106
65025796,2,"Tampa-St. Petersburg-Clearwater, FL",10,246,140,0.5691056910569106,Other or type unknown,106
68763064,1,"Las Vegas-Paradise, NV",10,225,119,0.5288888888888889,Other or type unknown,106
14232566,1,"Memphis, TN-MS-AR",10,505,400,0.7920792079207921,Other or type unknown,105
82454852,1,"Nashville-Davidson-Murfreesboro, TN",5,332,227,0.6837349397590361,"Firearm, type not stated",105
94159157,1,"Springfield, MA",5,212,107,0.5047169811320755,"Firearm, type not stated",105
68585539,1,Rural Arkansas,6,1124,1020,0.9074733096085409,"Handgun - pistol, revolver, etc",104
5079387,1,"Philadelphia-Camden-Wilmington, PA-NJ-DE",11,848,744,0.8773584905660378,"Personal weapons, includes beating",104
41143703,2,"Cleveland-Elyria-Mentor, OH",6,617,513,0.8314424635332253,"Handgun - pistol, revolver, etc",104
77019184,2,"St. Louis, MO-IL",7,380,276,0.7263157894736842,Knife or cutting instrument,104
23284283,1,"Saginaw, MI",5,165,61,0.3696969696969697,"Firearm, type not stated",104
33250191,1,"Syracuse, NY",6,350,247,0.7057142857142857,"Handgun - pistol, revolver, etc",103
74599809,2,"Atlanta-Sandy Springs-Marietta, GA",10,328,225,0.6859756097560976,Other or type unknown,103
4210873,2,"St. Louis, MO-IL",10,268,165,0.6156716417910447,Other or type unknown,103
24861879,1,"Detroit-Warren-Livonia, MI",11,534,432,0.8089887640449438,"Personal weapons, includes beating",102
36765881,1,"San Francisco-Oakland-Fremont, CA",10,234,133,0.5683760683760684,Other or type unknown,101
80080337,1,Rural California,6,521,421,0.8080614203454894,"Handgun - pistol, revolver, etc",100
31586316,1,"Stockton, CA",7,387,287,0.7416020671834626,Knife or cutting instrument,100
5286946,2,Rural North Carolina,10,304,204,0.6710526315789473,Other or type unknown,100
1648643,2,"Philadelphia-Camden-Wilmington, PA-NJ-DE",10,303,203,0.66996699669967,Other or type unknown,100
85997859,2,"San Antonio, TX",10,258,158,0.6124031007751938,Other or type unknown,100
2276581,2,"Houston-Sugar Land-Baytown, TX",16,190,90,0.47368421052631576,Strangulation - hanging,100
68417871,1,"Beaumont-Port Arthur, TX",6,659,560,0.849772382397572,"Handgun - pistol, revolver, etc",99
99818836,1,"Los Angeles-Long Beach, CA",4,234,135,0.5769230769230769,Fire,99
39718665,1,"Columbia, SC",6,1117,1019,0.9122649955237243,"Handgun - pistol, revolver, etc",98
27691926,1,"Tampa-St. Petersburg-Clearwater, FL",7,683,585,0.8565153733528551,Knife or cutting instrument,98
58566396,1,"Phoenix-Mesa-Scottsdale, AZ",14,485,387,0.797938144329897,Rifle,98
34246451,1,"Akron, OH",5,213,115,0.539906103286385,"Firearm, type not stated",98
27895274,1,"Detroit-Warren-Livonia, MI",4,178,80,0.449438202247191,Fire,98
16339242,2,"Riverside-San Bernardino, CA",7,441,344,0.780045351473923,Knife or cutting instrument,97
52937903,2,"San Antonio, TX",6,589,493,0.8370118845500849,"Handgun - pistol, revolver, etc",96
60831222,2,"Houston-Sugar Land-Baytown, TX",5,423,327,0.7730496453900709,"Firearm, type not stated",96
42420523,2,"New Orleans-Metairie-Kenner, LA",5,227,131,0.5770925110132159,"Firearm, type not stated",96
27756073,1,"Orlando-Kissimmee, FL",10,186,90,0.4838709677419355,Other or type unknown,96
26329675,1,"Rockford, IL",6,303,208,0.6864686468646864,"Handgun - pistol, revolver, etc",95
40375588,1,Rural Virginia,6,980,886,0.9040816326530612,"Handgun - pistol, revolver, etc",94
71703841,1,"Charleston-North Charleston, SC",6,933,839,0.8992497320471597,"Handgun - pistol, revolver, etc",94
47269956,1,"Cleveland-Elyria-Mentor, OH",7,627,533,0.8500797448165869,Knife or cutting instrument,94
15424575,2,"Richmond, VA",6,473,379,0.8012684989429175,"Handgun - pistol, revolver, etc",94
97115069,1,"Fort Wayne, IN",5,220,126,0.5727272727272728,"Firearm, type not stated",94
51989615,2,"San Francisco-Oakland-Fremont, CA",16,209,115,0.5502392344497608,Strangulation - hanging,94
98050848,1,"Trenton-Ewing, NJ",5,154,60,0.38961038961038963,"Firearm, type not stated",94
71911395,1,"Riverside-San Bernardino, CA",14,516,423,0.8197674418604651,Rifle,93
37720067,1,"Philadelphia-Camden-Wilmington, PA-NJ-DE",15,481,388,0.8066528066528067,Shotgun,93
7548301,1,"Jacksonville, FL",7,401,308,0.7680798004987531,Knife or cutting instrument,93
16308177,2,"Houston-Sugar Land-Baytown, TX",1,273,180,0.6593406593406593,"Blunt object - hammer, club, etc",93
73648672,1,"Dallas-Fort Worth-Arlington, TX",11,587,495,0.8432708688245315,"Personal weapons, includes beating",92
62523317,2,"Jacksonville, FL",6,481,389,0.8087318087318087,"Handgun - pistol, revolver, etc",92
80786127,2,"Washington-Arlington-Alexandria, DC-VA-MD-WV",5,272,180,0.6617647058823529,"Firearm, type not stated",92
4473151,1,"Kansas City, MO-KS",1,247,155,0.6275303643724697,"Blunt object - hammer, club, etc",92
89113558,2,"Phoenix-Mesa-Scottsdale, AZ",7,361,270,0.7479224376731302,Knife or cutting instrument,91
6254110,1,"Boston-Cambridge-Quincy, MA-NH",10,218,127,0.5825688073394495,Other or type unknown,91
86751969,2,"New Orleans-Metairie-Kenner, LA",7,298,208,0.697986577181208,Knife or cutting instrument,90
34974875,2,"Pittsburgh, PA",6,420,331,0.7880952380952381,"Handgun - pistol, revolver, etc",89
10031146,1,"Las Vegas-Paradise, NV",1,290,201,0.6931034482758621,"Blunt object - hammer, club, etc",89
35501113,1,"San Antonio, TX",1,192,104,0.5416666666666666,"Blunt object - hammer, club, etc",88
34054787,1,"Mobile, AL",10,191,103,0.5392670157068062,Other or type unknown,88
35849394,1,"Killeen-Temple-Fort Hood, TX",6,318,231,0.7264150943396226,"Handgun - pistol, revolver, etc",87
30566423,1,"Brownsville-Harlingen, TX",6,301,214,0.7109634551495017,"Handgun - pistol, revolver, etc",87
79750482,2,"Philadelphia-Camden-Wilmington, PA-NJ-DE",1,291,204,0.7010309278350515,"Blunt object - hammer, club, etc",87
51941327,1,"Baltimore-Towson, MD",10,248,161,0.6491935483870968,Other or type unknown,87
10240362,2,"Riverside-San Bernardino, CA",10,212,125,0.589622641509434,Other or type unknown,87
80370940,1,"Chicago-Naperville-Joliet, IL-IN-WI",16,174,87,0.5,Strangulation - hanging,87
43954209,2,"San Diego-Carlsbad-San Marcos, CA",6,451,365,0.8093126385809313,"Handgun - pistol, revolver, etc",86
72967852,1,"Indianapolis, IN",7,444,358,0.8063063063063063,Knife or cutting instrument,86
11235252,1,"Richmond, VA",7,396,310,0.7828282828282829,Knife or cutting instrument,86
77850802,1,Rural Texas,5,371,285,0.7681940700808625,"Firearm, type not stated",86
30043801,1,Rural Arkansas,5,308,222,0.7207792207792207,"Firearm, type not stated",86
27350720,2,"San Francisco-Oakland-Fremont, CA",1,228,142,0.6228070175438597,"Blunt object - hammer, club, etc",86
37364874,1,"Seattle-Tacoma-Bellevue, WA",1,228,142,0.6228070175438597,"Blunt object - hammer, club, etc",86
52753863,1,"Winston-Salem, NC",6,477,392,0.8218029350104822,"Handgun - pistol, revolver, etc",85
19221240,1,"Lakeland, FL",6,463,378,0.816414686825054,"Handgun - pistol, revolver, etc",85
61993223,1,Rural North Carolina,11,440,355,0.8068181818181818,"Personal weapons, includes beating",85
29721694,1,"Buffalo-Niagara Falls, NY",7,378,293,0.7751322751322751,Knife or cutting instrument,85
61912529,2,"Philadelphia-Camden-Wilmington, PA-NJ-DE",4,202,117,0.5792079207920792,Fire,85
80362518,1,"Dayton, OH",10,187,102,0.5454545454545454,Other or type unknown,85
16233610,2,"Philadelphia-Camden-Wilmington, PA-NJ-DE",11,566,482,0.8515901060070671,"Personal weapons, includes beating",84
15959872,1,"Salt Lake City, UT",6,533,449,0.8424015009380863,"Handgun - pistol, revolver, etc",84
16571269,2,"Las Vegas-Paradise, NV",6,501,418,0.8343313373253493,"Handgun - pistol, revolver, etc",83
11327206,2,"San Antonio, TX",7,263,180,0.6844106463878327,Knife or cutting instrument,83
29973923,1,Rural Tennessee,6,892,810,0.9080717488789237,"Handgun - pistol, revolver, etc",82
73886665,1,Rural New Mexico,6,563,481,0.8543516873889876,"Handgun - pistol, revolver, etc",82
48480416,2,"Philadelphia-Camden-Wilmington, PA-NJ-DE",16,186,104,0.5591397849462365,Strangulation - hanging,82
33712129,1,Rural Texas,7,943,862,0.9141039236479321,Knife or cutting instrument,81
91891624,1,Rural Florida,6,660,579,0.8772727272727273,"Handgun - pistol, revolver, etc",81
85902307,2,"Baton Rouge, LA",6,438,357,0.815068493150685,"Handgun - pistol, revolver, etc",81
93322224,1,"Washington-Arlington-Alexandria, DC-VA-MD-WV",11,393,312,0.7938931297709924,"Personal weapons, includes beating",81
25775220,1,"Virginia Beach-Norfolk-Newport News, VA-NC",10,253,172,0.6798418972332015,Other or type unknown,81
41980449,2,"Phoenix-Mesa-Scottsdale, AZ",10,199,118,0.592964824120603,Other or type unknown,81
98857260,2,"Washington-Arlington-Alexandria, DC-VA-MD-WV",16,145,64,0.4413793103448276,Strangulation - hanging,81
93951986,2,"Dallas-Fort Worth-Arlington, TX",11,437,357,0.816933638443936,"Personal weapons, includes beating",80
36791193,1,"Lexington-Fayette, KY",6,387,307,0.7932816537467701,"Handgun - pistol, revolver, etc",80
58373885,2,"Louisville, KY-IN",6,387,307,0.7932816537467701,"Handgun - pistol, revolver, etc",80
7955487,2,"San Francisco-Oakland-Fremont, CA",5,152,72,0.47368421052631576,"Firearm, type not stated",80
84936465,1,Rural North Carolina,7,816,737,0.9031862745098039,Knife or cutting instrument,79
76693224,1,"Akron, OH",6,373,294,0.7882037533512064,"Handgun - pistol, revolver, etc",79
7431979,1,"Phoenix-Mesa-Scottsdale, AZ",15,359,280,0.7799442896935933,Shotgun,79
73346434,1,"Minneapolis-St. Paul-Bloomington, MN-WI",10,241,162,0.6721991701244814,Other or type unknown,79
69350798,2,"Dallas-Fort Worth-Arlington, TX",16,137,58,0.4233576642335766,Strangulation - hanging,79
92612917,2,"Seattle-Tacoma-Bellevue, WA",6,566,488,0.8621908127208481,"Handgun - pistol, revolver, etc",78
32496391,1,"Sarasota-Bradenton-Venice, FL",6,352,274,0.7784090909090909,"Handgun - pistol, revolver, etc",78
91940566,2,"San Diego-Carlsbad-San Marcos, CA",7,322,244,0.7577639751552795,Knife or cutting instrument,78
20679706,1,"Pensacola-Ferry Pass-Brent, FL",5,276,198,0.717391304347826,"Firearm, type not stated",78
59921823,2,"Baltimore-Towson, MD",1,215,137,0.6372093023255814,"Blunt object - hammer, club, etc",78
4330639,2,"Washington-Arlington-Alexandria, DC-VA-MD-WV",1,201,123,0.6119402985074627,"Blunt object - hammer, club, etc",78
18663719,1,"Chattanooga, TN-GA",5,195,117,0.6,"Firearm, type not stated",78
42886314,1,"Pine Bluff, AR",6,332,255,0.7680722891566265,"Handgun - pistol, revolver, etc",77
57653237,1,"Washington-Arlington-Alexandria, DC-VA-MD-WV",15,330,253,0.7666666666666667,Shotgun,77
26770988,1,"Port St. Lucie-Fort Pierce, FL",6,304,227,0.7467105263157895,"Handgun - pistol, revolver, etc",77
43482540,2,"Cleveland-Elyria-Mentor, OH",10,149,72,0.48322147651006714,Other or type unknown,77
90273407,1,"Dallas-Fort Worth-Arlington, TX",9,128,51,0.3984375,Other gun,77
19083299,1,"Waco, TX",6,358,282,0.7877094972067039,"Handgun - pistol, revolver, etc",76
39668513,1,Rural Georgia,5,298,222,0.7449664429530202,"Firearm, type not stated",76
51359526,1,"San Jose-Sunnyvale-Santa Clara, CA",5,154,78,0.5064935064935064,"Firearm, type not stated",76
93299853,1,"Charlotte-Gastonia-Concord, NC-SC",7,524,449,0.8568702290076335,Knife or cutting instrument,75
93950171,1,"Portland-Vancouver-Beaverton, OR-WA",7,416,341,0.8197115384615384,Knife or cutting instrument,75
42318516,2,"Boston-Cambridge-Quincy, MA-NH",7,385,310,0.8051948051948052,Knife or cutting instrument,75
41113026,2,"Miami-Fort Lauderdale, FL",11,347,272,0.7838616714697406,"Personal weapons, includes beating",75
63007751,1,Rural Tennessee,5,259,184,0.7104247104247104,"Firearm, type not stated",75
13472740,2,"Memphis, TN-MS-AR",5,255,180,0.7058823529411765,"Firearm, type not stated",75
34743338,2,"Kansas City, MO-KS",10,220,145,0.6590909090909091,Other or type unknown,75
81634479,2,"Baltimore-Towson, MD",10,186,111,0.5967741935483871,Other or type unknown,75
70206470,1,Rural Florida,10,133,58,0.43609022556390975,Other or type unknown,75
66461758,2,"Las Vegas-Paradise, NV",16,125,50,0.4,Strangulation - hanging,75
42952100,1,"New York-New Jersey-Long Island, NY-NJ",14,353,279,0.7903682719546742,Rifle,74
39913145,2,"Fresno, CA",6,274,200,0.7299270072992701,"Handgun - pistol, revolver, etc",74
51993112,1,"York-Hanover, PA",6,223,149,0.6681614349775785,"Handgun - pistol, revolver, etc",74
61983792,1,"St. Louis, MO-IL",1,221,147,0.665158371040724,"Blunt object - hammer, club, etc",74
66226914,1,"Oklahoma City, OK",5,168,94,0.5595238095238095,"Firearm, type not stated",74
16585986,2,"Columbus, OH",10,147,73,0.4965986394557823,Other or type unknown,74
68648233,2,"Charlotte-Gastonia-Concord, NC-SC",6,491,418,0.8513238289205702,"Handgun - pistol, revolver, etc",73
54549875,2,"Columbus, OH",6,426,353,0.8286384976525821,"Handgun - pistol, revolver, etc",73
39760217,1,"Miami-Fort Lauderdale, FL",15,338,265,0.7840236686390533,Shotgun,73
70897418,1,Rural Florida,5,264,191,0.7234848484848485,"Firearm, type not stated",73
23067585,2,"Las Vegas-Paradise, NV",10,153,80,0.5228758169934641,Other or type unknown,73
68278828,1,"Oklahoma City, OK",7,452,380,0.8407079646017699,Knife or cutting instrument,72
10266165,2,"Memphis, TN-MS-AR",6,637,566,0.8885400313971743,"Handgun - pistol, revolver, etc",71
12546936,2,"Kansas City, MO-KS",6,465,394,0.8473118279569892,"Handgun - pistol, revolver, etc",71
38839692,1,"Oxnard-Thousand Oaks-Ventura, CA",7,229,158,0.6899563318777293,Knife or cutting instrument,71
88458519,1,"Jacksonville, FL",14,167,96,0.5748502994011976,Rifle,71
56330557,1,"Tucson, AZ",10,131,60,0.4580152671755725,Other or type unknown,71
21356111,1,"Youngstown-Warren-Boardman, OH-PA",10,103,32,0.3106796116504854,Other or type unknown,71
94637022,2,Rural Kentucky,6,478,408,0.8535564853556485,"Handgun - pistol, revolver, etc",70
63277907,2,"Seattle-Tacoma-Bellevue, WA",7,338,268,0.7928994082840237,Knife or cutting instrument,70
19563301,2,"Baltimore-Towson, MD",11,288,218,0.7569444444444444,"Personal weapons, includes beating",70
61396759,1,"Albany-Schenectady-Troy, NY",6,179,109,0.6089385474860335,"Handgun - pistol, revolver, etc",70
88990898,2,"San Francisco-Oakland-Fremont, CA",10,176,106,0.6022727272727273,Other or type unknown,70
33780726,1,"St. Louis, MO-IL",9,106,36,0.33962264150943394,Other gun,70
62912028,1,Rural Texas,15,665,596,0.8962406015037594,Shotgun,69
22024271,1,"Baltimore-Towson, MD",15,329,260,0.790273556231003,Shotgun,69
42440154,1,Rural Texas,10,271,202,0.7453874538745388,Other or type unknown,69
30442505,1,"Laredo, TX",6,227,158,0.6960352422907489,"Handgun - pistol, revolver, etc",69
45712433,1,"Charlotte-Gastonia-Concord, NC-SC",10,218,149,0.6834862385321101,Other or type unknown,69
24596394,1,"Philadelphia-Camden-Wilmington, PA-NJ-DE",4,204,135,0.6617647058823529,Fire,69
98660239,2,"Indianapolis, IN",5,140,71,0.5071428571428571,"Firearm, type not stated",69
46241419,1,"Corpus Christi, TX",6,514,446,0.867704280155642,"Handgun - pistol, revolver, etc",68
10925970,2,"Oklahoma City, OK",6,474,406,0.8565400843881856,"Handgun - pistol, revolver, etc",68
40333961,1,"Riverside-San Bernardino, CA",11,457,389,0.8512035010940919,"Personal weapons, includes beating",68
76803826,2,"Los Angeles-Long Beach, CA",0,194,126,0.6494845360824743,Asphyxiation - includes death by gas,68
4347357,1,"Birmingham-Hoover, AL",7,475,408,0.8589473684210527,Knife or cutting instrument,67
88610972,1,Rural Arizona,6,409,342,0.8361858190709046,"Handgun - pistol, revolver, etc",67
67666860,1,"Cleveland-Elyria-Mentor, OH",11,295,228,0.7728813559322034,"Personal weapons, includes beating",67
24386287,1,"Boston-Cambridge-Quincy, MA-NH",1,208,141,0.6778846153846154,"Blunt object - hammer, club, etc",67
74684234,1,"San Diego-Carlsbad-San Marcos, CA",15,195,128,0.6564102564102564,Shotgun,67
21104733,1,"Pine Bluff, AR",5,109,42,0.3853211009174312,"Firearm, type not stated",67
68058381,2,Rural Texas,6,734,668,0.9100817438692098,"Handgun - pistol, revolver, etc",66
36081111,1,"Memphis, TN-MS-AR",7,733,667,0.9099590723055935,Knife or cutting instrument,66
58323684,2,"Denver-Aurora, CO",7,284,218,0.7676056338028169,Knife or cutting instrument,66
10449648,2,"New York-New Jersey-Long Island, NY-NJ",5,203,137,0.6748768472906403,"Firearm, type not stated",66
25885613,1,"Santa Fe, NM",10,109,43,0.3944954128440367,Other or type unknown,66
67839286,2,"Sacramento-Roseville, CA",6,454,389,0.8568281938325991,"Handgun - pistol, revolver, etc",65
70960321,2,"San Francisco-Oakland-Fremont, CA",11,282,217,0.7695035460992907,"Personal weapons, includes beating",65
37317701,1,"Cleveland-Elyria-Mentor, OH",15,269,204,0.758364312267658,Shotgun,65
28082717,1,Rural Mississippi,5,263,198,0.752851711026616,"Firearm, type not stated",65
71774927,2,"Las Vegas-Paradise, NV",7,261,196,0.7509578544061303,Knife or cutting instrument,65
54327519,1,"Cleveland-Elyria-Mentor, OH",1,201,136,0.6766169154228856,"Blunt object - hammer, club, etc",65
48214508,1,"Santa Rosa-Petaluma, CA",6,199,134,0.6733668341708543,"Handgun - pistol, revolver, etc",65
83768963,1,"Charlotte-Gastonia-Concord, NC-SC",9,148,83,0.5608108108108109,Other gun,65
26408039,1,"Lexington-Fayette, KY",5,126,61,0.48412698412698413,"Firearm, type not stated",65
83384437,1,"Detroit-Warren-Livonia, MI",16,108,43,0.39814814814814814,Strangulation - hanging,65
55370389,1,"Grand Rapids-Wyoming, MI",6,334,270,0.8083832335329342,"Handgun - pistol, revolver, etc",64
77991965,1,"San Diego-Carlsbad-San Marcos, CA",11,324,260,0.8024691358024691,"Personal weapons, includes beating",64
26774281,2,Rural North Carolina,7,314,250,0.7961783439490446,Knife or cutting instrument,64
13294683,1,"Nashville-Davidson-Murfreesboro, TN",10,188,124,0.6595744680851063,Other or type unknown,64
80394474,1,"Augusta-Richmond County, GA-SC",5,135,71,0.5259259259259259,"Firearm, type not stated",64
98698365,1,"Visalia-Porterville, CA",5,129,65,0.5038759689922481,"Firearm, type not stated",64
581865,2,"Phoenix-Mesa-Scottsdale, AZ",5,125,61,0.488,"Firearm, type not stated",64
94166718,1,"El Paso, TX",6,481,418,0.8690228690228691,"Handgun - pistol, revolver, etc",63
32142091,2,"Cleveland-Elyria-Mentor, OH",7,257,194,0.754863813229572,Knife or cutting instrument,63
28182942,2,"Kansas City, MO-KS",7,240,177,0.7375,Knife or cutting instrument,63
59750022,2,"Denver-Aurora, CO",10,203,140,0.6896551724137931,Other or type unknown,63
93026877,2,"Atlanta-Sandy Springs-Marietta, GA",1,200,137,0.685,"Blunt object - hammer, club, etc",63
17626333,1,"Harrisburg-Carlisle, PA",5,113,50,0.4424778761061947,"Firearm, type not stated",63
33761055,2,"Houston-Sugar Land-Baytown, TX",11,429,367,0.8554778554778555,"Personal weapons, includes beating",62
18006087,2,"Nashville-Davidson-Murfreesboro, TN",6,427,365,0.8548009367681498,"Handgun - pistol, revolver, etc",62
80172329,1,Rural Ohio,6,345,283,0.8202898550724638,"Handgun - pistol, revolver, etc",62
83451920,1,"Kansas City, MO-KS",15,260,198,0.7615384615384615,Shotgun,62
2720795,1,"Sacramento-Roseville, CA",1,197,135,0.6852791878172588,"Blunt object - hammer, club, etc",62
69386973,2,"Los Angeles-Long Beach, CA",4,189,127,0.671957671957672,Fire,62
21403178,1,"Fresno, CA",1,147,85,0.5782312925170068,"Blunt object - hammer, club, etc",62
23562498,1,"Greensboro-High Point, NC",10,144,82,0.5694444444444444,Other or type unknown,62
36539503,1,Rural North Carolina,15,701,640,0.912981455064194,Shotgun,61
5212610,1,"Houston-Sugar Land-Baytown, TX",11,641,580,0.9048361934477379,"Personal weapons, includes beating",61
36982897,1,Rural North Carolina,14,526,465,0.8840304182509505,Rifle,61
32815222,1,"Wichita, KS",6,514,453,0.8813229571984436,"Handgun - pistol, revolver, etc",61
92333825,1,"Columbus, OH",7,384,323,0.8411458333333334,Knife or cutting instrument,61
55508660,1,"Harrisburg-Carlisle, PA",6,291,230,0.7903780068728522,"Handgun - pistol, revolver, etc",61
17733229,2,"Boston-Cambridge-Quincy, MA-NH",6,246,185,0.7520325203252033,"Handgun - pistol, revolver, etc",61
15403355,1,"New Orleans-Metairie-Kenner, LA",15,241,180,0.7468879668049793,Shotgun,61
30755209,1,"Seattle-Tacoma-Bellevue, WA",10,195,134,0.6871794871794872,Other or type unknown,61
43081056,1,"Buffalo-Niagara Falls, NY",11,153,92,0.6013071895424836,"Personal weapons, includes beating",61
31750274,2,"Cleveland-Elyria-Mentor, OH",5,133,72,0.5413533834586466,"Firearm, type not stated",61
21192733,1,"Merced, CA",5,110,49,0.44545454545454544,"Firearm, type not stated",61
24277168,1,"Jacksonville, FL",17,107,46,0.42990654205607476,Weapon Not Reported,61
55323138,1,"Houston-Sugar Land-Baytown, TX",14,716,656,0.9162011173184358,Rifle,60
16558732,1,"Baltimore-Towson, MD",11,385,325,0.8441558441558441,"Personal weapons, includes beating",60
12469327,1,"Yakima, WA",6,280,220,0.7857142857142857,"Handgun - pistol, revolver, etc",60
16794380,1,"Charlotte-Gastonia-Concord, NC-SC",5,228,168,0.7368421052631579,"Firearm, type not stated",60
69832032,2,"Cleveland-Elyria-Mentor, OH",11,203,143,0.7044334975369458,"Personal weapons, includes beating",60
13087597,1,"Poughkeepsie-Newburgh-Middletown, NY",6,187,127,0.679144385026738,"Handgun - pistol, revolver, etc",60
77728172,2,"New Orleans-Metairie-Kenner, LA",11,186,126,0.6774193548387096,"Personal weapons, includes beating",60
5344852,1,"Los Angeles-Long Beach, CA",0,170,110,0.6470588235294118,Asphyxiation - includes death by gas,60
55708908,1,"Tucson, AZ",5,95,35,0.3684210526315789,"Firearm, type not stated",60
24587746,2,Rural North Carolina,6,722,663,0.9182825484764543,"Handgun - pistol, revolver, etc",59
97106870,1,"Chattanooga, TN-GA",6,528,469,0.8882575757575758,"Handgun - pistol, revolver, etc",59
27563398,1,"Tampa-St. Petersburg-Clearwater, FL",11,390,331,0.8487179487179487,"Personal weapons, includes beating",59
54657176,1,"Cape Coral-Fort Myers, FL",6,296,237,0.8006756756756757,"Handgun - pistol, revolver, etc",59
32469957,1,"Atlanta-Sandy Springs-Marietta, GA",11,295,236,0.8,"Personal weapons, includes beating",59
29776626,2,"Tampa-St. Petersburg-Clearwater, FL",7,264,205,0.7765151515151515,Knife or cutting instrument,59
529706,1,"Denver-Aurora, CO",10,246,187,0.7601626016260162,Other or type unknown,59
18003242,2,"Orlando-Kissimmee, FL",10,152,93,0.6118421052631579,Other or type unknown,59
37806723,1,"Sarasota-Bradenton-Venice, FL",5,152,93,0.6118421052631579,"Firearm, type not stated",59
79664158,2,"Detroit-Warren-Livonia, MI",4,139,80,0.5755395683453237,Fire,59
99355924,1,"Montgomery, AL",10,117,58,0.49572649572649574,Other or type unknown,59
13710360,1,"Greensboro-High Point, NC",9,94,35,0.3723404255319149,Other gun,59
91657692,1,"Tucson, AZ",7,314,256,0.8152866242038217,Knife or cutting instrument,58
35219670,1,Rural Virginia,5,242,184,0.7603305785123967,"Firearm, type not stated",58
84414167,1,"San Antonio, TX",14,241,183,0.7593360995850622,Rifle,58
25191257,2,"Richmond, VA",7,198,140,0.7070707070707071,Knife or cutting instrument,58
20114929,1,"Tallahassee, FL",5,159,101,0.6352201257861635,"Firearm, type not stated",58
91253170,2,"Riverside-San Bernardino, CA",1,157,99,0.6305732484076433,"Blunt object - hammer, club, etc",58
82102302,1,"Madera, CA",6,151,93,0.6158940397350994,"Handgun - pistol, revolver, etc",58
15444221,1,"Modesto, CA",5,122,64,0.5245901639344263,"Firearm, type not stated",58
10934817,1,"Albany-Schenectady-Troy, NY",5,113,55,0.48672566371681414,"Firearm, type not stated",58
56955632,1,"Nashville-Davidson-Murfreesboro, TN",7,439,382,0.8701594533029613,Knife or cutting instrument,57
83763018,2,"Tucson, AZ",6,294,237,0.8061224489795918,"Handgun - pistol, revolver, etc",57
40149365,1,"Tampa-St. Petersburg-Clearwater, FL",1,224,167,0.7455357142857143,"Blunt object - hammer, club, etc",57
98817839,1,Rural Louisiana,5,209,152,0.7272727272727273,"Firearm, type not stated",57
74633228,1,"Santa Cruz-Watsonville, CA",6,182,125,0.6868131868131868,"Handgun - pistol, revolver, etc",57
92978387,1,"Santa Barbara-Santa Maria, CA",6,179,122,0.6815642458100558,"Handgun - pistol, revolver, etc",57
85695678,1,"Fayetteville, NC",10,152,95,0.625,Other or type unknown,57
47491001,2,"Virginia Beach-Norfolk-Newport News, VA-NC",6,513,457,0.8908382066276803,"Handgun - pistol, revolver, etc",56
62729610,2,"Los Angeles-Long Beach, CA",14,269,213,0.79182156133829,Rifle,56
31179421,2,"Kansas City, MO-KS",16,87,31,0.3563218390804598,Strangulation - hanging,56
7906430,2,"Denver-Aurora, CO",6,509,454,0.8919449901768173,"Handgun - pistol, revolver, etc",55
39006187,1,"San Antonio, TX",11,236,181,0.7669491525423728,"Personal weapons, includes beating",55
52082149,1,"Chicago-Naperville-Joliet, IL-IN-WI",4,169,114,0.6745562130177515,Fire,55
85657894,1,"Albuquerque, NM",10,145,90,0.6206896551724138,Other or type unknown,55
49249644,1,"Greensboro-High Point, NC",5,125,70,0.56,"Firearm, type not stated",55
97254811,1,"Longview, TX",6,339,285,0.8407079646017699,"Handgun - pistol, revolver, etc",54
17431416,2,"San Antonio, TX",5,209,155,0.7416267942583732,"Firearm, type not stated",54
56490157,2,"Baltimore-Towson, MD",16,117,63,0.5384615384615384,Strangulation - hanging,54
26284056,1,"Flint, MI",10,109,55,0.5045871559633027,Other or type unknown,54
22670065,1,"Bakersfield, CA",10,103,49,0.47572815533980584,Other or type unknown,54
12525673,1,"Atlanta-Sandy Springs-Marietta, GA",16,90,36,0.4,Strangulation - hanging,54
40828678,1,"Minneapolis-St. Paul-Bloomington, MN-WI",7,493,440,0.8924949290060852,Knife or cutting instrument,53
30775607,1,"Providence-New Bedford-Fall River, RI-MA",7,321,268,0.8348909657320872,Knife or cutting instrument,53
15125829,1,"Denver-Aurora, CO",11,310,257,0.8290322580645161,"Personal weapons, includes beating",53
82124418,2,"Mobile, AL",6,237,184,0.7763713080168776,"Handgun - pistol, revolver, etc",53
38888110,1,"Salinas, CA",7,173,120,0.6936416184971098,Knife or cutting instrument,53
17427129,2,"Milwaukee-Waukesha-West Allis, WI",5,163,110,0.6748466257668712,"Firearm, type not stated",53
28073675,1,"Tulsa, OK",5,142,89,0.6267605633802817,"Firearm, type not stated",53
38922928,1,"Tucson, AZ",1,139,86,0.6187050359712231,"Blunt object - hammer, club, etc",53
21403357,1,Rural New Mexico,5,137,84,0.6131386861313869,"Firearm, type not stated",53
54437549,1,"Oxnard-Thousand Oaks-Ventura, CA",5,126,73,0.5793650793650794,"Firearm, type not stated",53
63578213,1,"Utica-Rome, NY",6,110,57,0.5181818181818182,"Handgun - pistol, revolver, etc",53
84738034,2,"Boston-Cambridge-Quincy, MA-NH",16,98,45,0.45918367346938777,Strangulation - hanging,53
73513526,1,"Lafayette, LA",6,364,312,0.8571428571428571,"Handgun - pistol, revolver, etc",52
90550969,1,"Honolulu, HI",6,291,239,0.8213058419243986,"Handgun - pistol, revolver, etc",52
4587761,1,"Wilmington, NC",6,256,204,0.796875,"Handgun - pistol, revolver, etc",52
33286516,2,"Washington-Arlington-Alexandria, DC-VA-MD-WV",11,255,203,0.796078431372549,"Personal weapons, includes beating",52
7597445,2,Rural North Carolina,11,238,186,0.7815126050420168,"Personal weapons, includes beating",52
91550362,1,"Deltona-Daytona Beach-Ormond Beach, FL",5,180,128,0.7111111111111111,"Firearm, type not stated",52
95358412,2,"Youngstown-Warren-Boardman, OH-PA",6,166,114,0.6867469879518072,"Handgun - pistol, revolver, etc",52
53426145,1,"Albuquerque, NM",1,118,66,0.559322033898305,"Blunt object - hammer, club, etc",52
32949859,2,"Seattle-Tacoma-Bellevue, WA",16,103,51,0.49514563106796117,Strangulation - hanging,52
86112561,1,"Houston-Sugar Land-Baytown, TX",16,101,49,0.48514851485148514,Strangulation - hanging,52
16350230,1,"Virginia Beach-Norfolk-Newport News, VA-NC",7,627,576,0.9186602870813397,Knife or cutting instrument,51
82133094,1,Rural Missouri,6,586,535,0.9129692832764505,"Handgun - pistol, revolver, etc",51
3126853,1,"Austin-Round Rock, TX",7,422,371,0.8791469194312796,Knife or cutting instrument,51
44154039,2,"Tulsa, OK",6,381,330,0.8661417322834646,"Handgun - pistol, revolver, etc",51
11021529,1,"Orlando-Kissimmee, FL",7,371,320,0.862533692722372,Knife or cutting instrument,51
16377564,1,Rural Kansas,6,327,276,0.8440366972477065,"Handgun - pistol, revolver, etc",51
37144000,1,"Anchorage, AK",6,318,267,0.839622641509434,"Handgun - pistol, revolver, etc",51
40083286,1,"Honolulu, HI",7,216,165,0.7638888888888888,Knife or cutting instrument,51
51144589,2,"Stockton, CA",6,197,146,0.7411167512690355,"Handgun - pistol, revolver, etc",51
91629197,2,Rural Texas,10,192,141,0.734375,Other or type unknown,51
45432248,1,"Fresno, CA",15,185,134,0.7243243243243244,Shotgun,51
34735753,2,"Virginia Beach-Norfolk-Newport News, VA-NC",10,159,108,0.6792452830188679,Other or type unknown,51
55062167,2,"Riverside-San Bernardino, CA",16,155,104,0.6709677419354839,Strangulation - hanging,51
46589520,1,"Bakersfield, CA",1,125,74,0.592,"Blunt object - hammer, club, etc",51
62368938,2,"Buffalo-Niagara Falls, NY",6,125,74,0.592,"Handgun - pistol, revolver, etc",51
17771705,1,"Lakeland, FL",10,98,47,0.47959183673469385,Other or type unknown,51
88061791,9,"Miami-Fort Lauderdale, FL",10,52,1,0.019230769230769232,Other or type unknown,51
32153706,1,Rural Pennsylvania,6,479,429,0.8956158663883089,"Handgun - pistol, revolver, etc",50
72457695,1,"Gulfport-Biloxi, MS",6,273,223,0.8168498168498168,"Handgun - pistol, revolver, etc",50
42509533,1,"Des Moines, IA",6,238,188,0.7899159663865546,"Handgun - pistol, revolver, etc",50
88372439,1,"Denver-Aurora, CO",1,169,119,0.7041420118343196,"Blunt object - hammer, club, etc",50
21251896,2,"Miami-Fort Lauderdale, FL",1,154,104,0.6753246753246753,"Blunt object - hammer, club, etc",50
91431640,2,"Richmond, VA",5,153,103,0.673202614379085,"Firearm, type not stated",50
13940472,1,"San Francisco-Oakland-Fremont, CA",16,120,70,0.5833333333333334,Strangulation - hanging,50
1000672,1,Rural Kentucky,15,432,383,0.8865740740740741,Shotgun,49
29653217,1,"Pittsburgh, PA",7,401,352,0.8778054862842892,Knife or cutting instrument,49
82238026,1,"Rochester, NY",7,324,275,0.8487654320987654,Knife or cutting instrument,49
55615796,1,"Canton-Massillon, OH",6,238,189,0.7941176470588235,"Handgun - pistol, revolver, etc",49
16298928,2,"Portland-Vancouver-Beaverton, OR-WA",7,193,144,0.7461139896373057,Knife or cutting instrument,49
44349491,1,"Knoxville, TN",5,120,71,0.5916666666666667,"Firearm, type not stated",49
62195890,1,"Cincinnati-Middletown, OH-KY-IN",10,117,68,0.5811965811965812,Other or type unknown,49
15911394,1,"Spartanburg, SC",6,451,403,0.893569844789357,"Handgun - pistol, revolver, etc",48
13711586,1,"Florence, SC",6,413,365,0.8837772397094431,"Handgun - pistol, revolver, etc",48
8053754,1,"Columbia, SC",5,221,173,0.7828054298642534,"Firearm, type not stated",48
79907403,2,"Buffalo-Niagara Falls, NY",7,167,119,0.7125748502994012,Knife or cutting instrument,48
59573723,1,"Indianapolis, IN",1,144,96,0.6666666666666666,"Blunt object - hammer, club, etc",48
19577270,1,Rural Georgia,10,140,92,0.6571428571428571,Other or type unknown,48
16296529,2,"Philadelphia-Camden-Wilmington, PA-NJ-DE",5,129,81,0.627906976744186,"Firearm, type not stated",48
27759003,2,"Phoenix-Mesa-Scottsdale, AZ",16,100,52,0.52,Strangulation - hanging,48
30581405,1,"Durham, NC",5,92,44,0.4782608695652174,"Firearm, type not stated",48
8591938,2,"Cincinnati-Middletown, OH-KY-IN",6,375,328,0.8746666666666667,"Handgun - pistol, revolver, etc",47
16626963,1,Rural Kentucky,7,293,246,0.8395904436860068,Knife or cutting instrument,47
58376826,1,"Philadelphia-Camden-Wilmington, PA-NJ-DE",14,286,239,0.8356643356643356,Rifle,47
19574048,2,"Atlanta-Sandy Springs-Marietta, GA",11,252,205,0.8134920634920635,"Personal weapons, includes beating",47
21261102,1,"Richmond, VA",15,216,169,0.7824074074074074,Shotgun,47
69109716,1,"Sacramento-Roseville, CA",15,213,166,0.7793427230046949,Shotgun,47
5885220,1,"Honolulu, HI",11,201,154,0.7661691542288557,"Personal weapons, includes beating",47
5095810,2,"Jacksonville, FL",7,183,136,0.7431693989071039,Knife or cutting instrument,47
23663311,2,"Virginia Beach-Norfolk-Newport News, VA-NC",5,157,110,0.7006369426751592,"Firearm, type not stated",47
7584585,1,"Killeen-Temple-Fort Hood, TX",5,89,42,0.47191011235955055,"Firearm, type not stated",47
90826793,2,"Tampa-St. Petersburg-Clearwater, FL",6,513,467,0.9103313840155945,"Handgun - pistol, revolver, etc",46
33671454,1,"Milwaukee-Waukesha-West Allis, WI",7,463,417,0.9006479481641468,Knife or cutting instrument,46
86333694,1,"Huntsville, AL",6,366,320,0.8743169398907104,"Handgun - pistol, revolver, etc",46
81807457,1,"Charlotte-Gastonia-Concord, NC-SC",15,324,278,0.8580246913580247,Shotgun,46
16645494,1,"St. Louis, MO-IL",11,277,231,0.8339350180505415,"Personal weapons, includes beating",46
91921434,1,"New Orleans-Metairie-Kenner, LA",11,232,186,0.8017241379310345,"Personal weapons, includes beating",46
44898696,1,"Visalia-Porterville, CA",7,227,181,0.7973568281938326,Knife or cutting instrument,46
33096213,2,"Tampa-St. Petersburg-Clearwater, FL",5,204,158,0.7745098039215687,"Firearm, type not stated",46
96109183,1,"Portland-Vancouver-Beaverton, OR-WA",10,194,148,0.7628865979381443,Other or type unknown,46
8513529,1,"Bridgeport-Stamford-Norwalk, CT",7,186,140,0.7526881720430108,Knife or cutting instrument,46
37903661,1,"Indianapolis, IN",14,173,127,0.7341040462427746,Rifle,46
90820001,1,"Pittsburgh, PA",10,165,119,0.7212121212121212,Other or type unknown,46
8850844,2,"Albuquerque, NM",10,101,55,0.5445544554455446,Other or type unknown,46
29972480,1,"Birmingham-Hoover, AL",11,99,53,0.5353535353535354,"Personal weapons, includes beating",46
32364235,1,"Jackson, MS",5,75,29,0.38666666666666666,"Firearm, type not stated",46
76122559,2,"Jackson, MS",6,298,253,0.8489932885906041,"Handgun - pistol, revolver, etc",45
27543657,1,"Louisville, KY-IN",7,283,238,0.8409893992932862,Knife or cutting instrument,45
73857442,2,"Memphis, TN-MS-AR",7,271,226,0.8339483394833949,Knife or cutting instrument,45
92031096,1,"Cincinnati-Middletown, OH-KY-IN",11,261,216,0.8275862068965517,"Personal weapons, includes beating",45
36684384,2,"Las Vegas-Paradise, NV",5,207,162,0.782608695652174,"Firearm, type not stated",45
24089759,1,"San Diego-Carlsbad-San Marcos, CA",14,197,152,0.7715736040609137,Rifle,45
50939302,2,"Atlanta-Sandy Springs-Marietta, GA",5,176,131,0.7443181818181818,"Firearm, type not stated",45
56053570,2,"Richmond, VA",10,176,131,0.7443181818181818,Other or type unknown,45
68415664,1,"Palm Bay-Melbourne-Titusville, FL",5,168,123,0.7321428571428571,"Firearm, type not stated",45
31705296,2,"Indianapolis, IN",7,156,111,0.7115384615384616,Knife or cutting instrument,45
22755451,2,"Chicago-Naperville-Joliet, IL-IN-WI",4,142,97,0.6830985915492958,Fire,45
46345235,2,"Milwaukee-Waukesha-West Allis, WI",10,126,81,0.6428571428571429,Other or type unknown,45
2830241,1,"McAllen-Edinburg-Mission, TX",5,111,66,0.5945945945945946,"Firearm, type not stated",45
59767874,2,"Columbus, OH",5,104,59,0.5673076923076923,"Firearm, type not stated",45
98331016,1,"Springfield, IL",5,73,28,0.3835616438356164,"Firearm, type not stated",45
53601116,2,"Miami-Fort Lauderdale, FL",16,71,26,0.36619718309859156,Strangulation - hanging,45
93347608,9,"Birmingham-Hoover, AL",10,49,4,0.08163265306122448,Other or type unknown,45
21145786,2,"Los Angeles-Long Beach, CA",15,311,267,0.8585209003215434,Shotgun,44
51360664,1,Rural Texas,1,264,220,0.8333333333333334,"Blunt object - hammer, club, etc",44
59330846,1,"Hartford, CT",7,264,220,0.8333333333333334,Knife or cutting instrument,44
88136351,1,"Flint, MI",7,223,179,0.8026905829596412,Knife or cutting instrument,44
59300264,2,"Flint, MI",6,157,113,0.7197452229299363,"Handgun - pistol, revolver, etc",44
50292615,2,"Birmingham-Hoover, AL",7,153,109,0.7124183006535948,Knife or cutting instrument,44
10894364,2,"Rochester, NY",6,120,76,0.6333333333333333,"Handgun - pistol, revolver, etc",44
441216,1,Rural Arizona,10,118,74,0.6271186440677966,Other or type unknown,44
10684940,1,"Akron, OH",10,101,57,0.5643564356435643,Other or type unknown,44
60246682,2,"New Orleans-Metairie-Kenner, LA",1,101,57,0.5643564356435643,"Blunt object - hammer, club, etc",44
10198858,1,"Miami-Fort Lauderdale, FL",9,96,52,0.5416666666666666,Other gun,44
43896920,1,"Springfield, MA",6,253,210,0.8300395256916996,"Handgun - pistol, revolver, etc",43
55800330,1,Rural New Mexico,7,251,208,0.8286852589641435,Knife or cutting instrument,43
15343430,2,"Tampa-St. Petersburg-Clearwater, FL",11,228,185,0.8114035087719298,"Personal weapons, includes beating",43
21021703,2,"San Diego-Carlsbad-San Marcos, CA",11,199,156,0.7839195979899497,"Personal weapons, includes beating",43
9918095,1,"Reading, PA",6,184,141,0.7663043478260869,"Handgun - pistol, revolver, etc",43
58313631,1,"Las Vegas-Paradise, NV",15,163,120,0.7361963190184049,Shotgun,43
6819166,1,"Lancaster, PA",6,141,98,0.6950354609929078,"Handgun - pistol, revolver, etc",43
56608701,1,"Laredo, TX",5,140,97,0.6928571428571428,"Firearm, type not stated",43
15696044,1,"Vineland-Millville-Bridgeton, NJ",6,138,95,0.6884057971014492,"Handgun - pistol, revolver, etc",43
821501,2,"San Diego-Carlsbad-San Marcos, CA",10,123,80,0.6504065040650406,Other or type unknown,43
10278792,2,"Birmingham-Hoover, AL",10,105,62,0.5904761904761905,Other or type unknown,43
41667572,1,"McAllen-Edinburg-Mission, TX",10,91,48,0.5274725274725275,Other or type unknown,43
30270823,2,"Boston-Cambridge-Quincy, MA-NH",5,85,42,0.49411764705882355,"Firearm, type not stated",43
50865857,1,"Roanoke, VA",6,318,276,0.8679245283018868,"Handgun - pistol, revolver, etc",42
55770562,1,"Albany, GA",6,296,254,0.8581081081081081,"Handgun - pistol, revolver, etc",42
1344866,1,"Corpus Christi, TX",7,278,236,0.8489208633093526,Knife or cutting instrument,42
14171385,1,"Asheville, NC",6,245,203,0.8285714285714286,"Handgun - pistol, revolver, etc",42
84102288,1,"Tuscaloosa, AL",6,245,203,0.8285714285714286,"Handgun - pistol, revolver, etc",42
4756291,1,"Palm Bay-Melbourne-Titusville, FL",6,237,195,0.8227848101265823,"Handgun - pistol, revolver, etc",42
69869361,2,"Albuquerque, NM",6,217,175,0.8064516129032258,"Handgun - pistol, revolver, etc",42
45809382,1,"Memphis, TN-MS-AR",14,212,170,0.8018867924528302,Rifle,42
18009072,1,"Topeka, KS",6,209,167,0.7990430622009569,"Handgun - pistol, revolver, etc",42
54127524,2,"Sacramento-Roseville, CA",7,206,164,0.7961165048543689,Knife or cutting instrument,42
95839886,1,"Austin-Round Rock, TX",5,191,149,0.7801047120418848,"Firearm, type not stated",42
1202038,2,"Montgomery, AL",6,186,144,0.7741935483870968,"Handgun - pistol, revolver, etc",42
78562330,1,"Trenton-Ewing, NJ",7,185,143,0.772972972972973,Knife or cutting instrument,42
36816646,1,"Anchorage, AK",5,179,137,0.7653631284916201,"Firearm, type not stated",42
85370602,1,"Birmingham-Hoover, AL",14,171,129,0.7543859649122807,Rifle,42
79468880,2,"Memphis, TN-MS-AR",10,170,128,0.7529411764705882,Other or type unknown,42
98669059,1,Rural Oklahoma,10,137,95,0.6934306569343066,Other or type unknown,42
91246485,1,"Grand Rapids-Wyoming, MI",5,136,94,0.6911764705882353,"Firearm, type not stated",42
20714995,1,"Jacksonville, FL",1,131,89,0.6793893129770993,"Blunt object - hammer, club, etc",42
64820814,2,"Riverside-San Bernardino, CA",5,128,86,0.671875,"Firearm, type not stated",42
56679483,2,"Nashville-Davidson-Murfreesboro, TN",10,123,81,0.6585365853658537,Other or type unknown,42
17863177,1,"Macon, GA",5,116,74,0.6379310344827587,"Firearm, type not stated",42
49486580,1,"Stockton, CA",1,114,72,0.631578947368421,"Blunt object - hammer, club, etc",42
39843107,1,Rural California,5,93,51,0.5483870967741935,"Firearm, type not stated",42
48981954,1,"Yakima, WA",5,82,40,0.4878048780487805,"Firearm, type not stated",42
12898021,1,"Peoria, IL",5,70,28,0.4,"Firearm, type not stated",42
72165850,2,"Milwaukee-Waukesha-West Allis, WI",6,393,352,0.8956743002544529,"Handgun - pistol, revolver, etc",41
95094051,1,"Phoenix-Mesa-Scottsdale, AZ",11,304,263,0.8651315789473685,"Personal weapons, includes beating",41
17349933,1,"Las Vegas-Paradise, NV",11,207,166,0.8019323671497585,"Personal weapons, includes beating",41
60043262,2,"Phoenix-Mesa-Scottsdale, AZ",1,201,160,0.7960199004975125,"Blunt object - hammer, club, etc",41
11650522,2,"Cincinnati-Middletown, OH-KY-IN",7,176,135,0.7670454545454546,Knife or cutting instrument,41
96355095,2,"Toledo, OH",6,166,125,0.7530120481927711,"Handgun - pistol, revolver, etc",41
51259598,2,"New York-New Jersey-Long Island, NY-NJ",0,155,114,0.7354838709677419,Asphyxiation - includes death by gas,41
25752285,2,"Charlotte-Gastonia-Concord, NC-SC",10,149,108,0.7248322147651006,Other or type unknown,41
90879846,2,"Indianapolis, IN",10,125,84,0.672,Other or type unknown,41
91912482,2,"New Orleans-Metairie-Kenner, LA",10,113,72,0.6371681415929203,Other or type unknown,41
71452604,1,Rural Mississippi,10,107,66,0.616822429906542,Other or type unknown,41
74383809,1,"South Bend-Mishawaka, IN-MI",5,78,37,0.47435897435897434,"Firearm, type not stated",41
52553518,2,"Montgomery, AL",5,55,14,0.2545454545454545,"Firearm, type not stated",41
81494726,2,Rural Alabama,6,356,316,0.8876404494382022,"Handgun - pistol, revolver, etc",40
47452384,2,Rural Texas,7,319,279,0.8746081504702194,Knife or cutting instrument,40
41541196,1,"Rocky Mount, NC",6,284,244,0.8591549295774648,"Handgun - pistol, revolver, etc",40
18898750,2,"Minneapolis-St. Paul-Bloomington, MN-WI",7,255,215,0.8431372549019608,Knife or cutting instrument,40
66455771,2,"Phoenix-Mesa-Scottsdale, AZ",11,230,190,0.8260869565217391,"Personal weapons, includes beating",40
78034598,1,"Mobile, AL",7,221,181,0.8190045248868778,Knife or cutting instrument,40
61106375,1,"Indianapolis, IN",15,204,164,0.803921568627451,Shotgun,40
33943774,1,Rural Kentucky,5,155,115,0.7419354838709677,"Firearm, type not stated",40
20248217,1,Rural Kentucky,1,149,109,0.7315436241610739,"Blunt object - hammer, club, etc",40
4242759,1,"Portland-Vancouver-Beaverton, OR-WA",1,141,101,0.7163120567375887,"Blunt object - hammer, club, etc",40
47291346,1,Rural Alabama,10,137,97,0.708029197080292,Other or type unknown,40
68640076,1,"New York-New Jersey-Long Island, NY-NJ",0,118,78,0.6610169491525424,Asphyxiation - includes death by gas,40
48788680,1,"Charlotte-Gastonia-Concord, NC-SC",1,110,70,0.6363636363636364,"Blunt object - hammer, club, etc",40
18136969,2,"Jacksonville, FL",5,77,37,0.4805194805194805,"Firearm, type not stated",40
98986957,1,"Atlantic City, NJ",5,60,20,0.3333333333333333,"Firearm, type not stated",40
82163588,2,"Minneapolis-St. Paul-Bloomington, MN-WI",6,313,274,0.8753993610223643,"Handgun - pistol, revolver, etc",39
51602953,1,"Hickory-Lenoir-Morganton, NC",6,308,269,0.8733766233766234,"Handgun - pistol, revolver, etc",39
58189510,1,"Charleston, WV",6,287,248,0.8641114982578397,"Handgun - pistol, revolver, etc",39
36148736,1,"Corpus Christi, TX",5,189,150,0.7936507936507936,"Firearm, type not stated",39
34905116,1,"Bakersfield, CA",15,149,110,0.738255033557047,Shotgun,39
15343675,2,Rural Georgia,10,122,83,0.680327868852459,Other or type unknown,39
5256632,2,"Boston-Cambridge-Quincy, MA-NH",10,121,82,0.6776859504132231,Other or type unknown,39
52488608,2,"Birmingham-Hoover, AL",5,117,78,0.6666666666666666,"Firearm, type not stated",39
92724523,2,"Sacramento-Roseville, CA",10,104,65,0.625,Other or type unknown,39
51680978,1,"Port St. Lucie-Fort Pierce, FL",5,97,58,0.5979381443298969,"Firearm, type not stated",39
16881370,1,Rural Alabama,7,346,308,0.8901734104046243,Knife or cutting instrument,38
66575696,1,"Seattle-Tacoma-Bellevue, WA",11,288,250,0.8680555555555556,"Personal weapons, includes beating",38
36108649,2,"Little Rock-North Little Rock, AR",6,287,249,0.867595818815331,"Handgun - pistol, revolver, etc",38
53840311,2,"Greensboro-High Point, NC",6,222,184,0.8288288288288288,"Handgun - pistol, revolver, etc",38
16634632,2,"Pittsburgh, PA",7,210,172,0.819047619047619,Knife or cutting instrument,38
31795742,1,"San Antonio, TX",15,208,170,0.8173076923076923,Shotgun,38
62101851,1,"Santa Fe, NM",6,174,136,0.7816091954022989,"Handgun - pistol, revolver, etc",38
54686602,1,Rural Michigan,10,158,120,0.759493670886076,Other or type unknown,38
35361966,2,"Portland-Vancouver-Beaverton, OR-WA",10,120,82,0.6833333333333333,Other or type unknown,38
77204418,1,"Ocala, FL",5,120,82,0.6833333333333333,"Firearm, type not stated",38
74738407,2,"Louisville, KY-IN",5,84,46,0.5476190476190477,"Firearm, type not stated",38
40019709,1,"Lansing-East Lansing, MI",5,78,40,0.5128205128205128,"Firearm, type not stated",38
96764292,2,"Flint, MI",10,71,33,0.4647887323943662,Other or type unknown,38
84391353,9,"New York-New Jersey-Long Island, NY-NJ",10,45,7,0.15555555555555556,Other or type unknown,38
85882584,1,"Greenville, SC",6,694,657,0.946685878962536,"Handgun - pistol, revolver, etc",37
34434913,1,"Amarillo, TX",6,331,294,0.8882175226586103,"Handgun - pistol, revolver, etc",37
67058526,2,"Riverside-San Bernardino, CA",11,276,239,0.8659420289855072,"Personal weapons, includes beating",37
82996822,1,"Tallahassee, FL",6,238,201,0.8445378151260504,"Handgun - pistol, revolver, etc",37
3497193,1,"Kansas City, MO-KS",14,205,168,0.8195121951219512,Rifle,37
45354806,1,"Jackson, TN",6,202,165,0.8168316831683168,"Handgun - pistol, revolver, etc",37
52580742,2,"Oklahoma City, OK",7,170,133,0.7823529411764706,Knife or cutting instrument,37
61090479,1,"Modesto, CA",7,167,130,0.7784431137724551,Knife or cutting instrument,37
97204130,1,"Oklahoma City, OK",10,144,107,0.7430555555555556,Other or type unknown,37
30232754,1,"Minneapolis-St. Paul-Bloomington, MN-WI",1,141,104,0.7375886524822695,"Blunt object - hammer, club, etc",37
44303213,2,"Birmingham-Hoover, AL",11,113,76,0.672566371681416,"Personal weapons, includes beating",37
51323073,1,"Louisville, KY-IN",14,102,65,0.6372549019607843,Rifle,37
14760570,1,"Richmond, VA",1,101,64,0.6336633663366337,"Blunt object - hammer, club, etc",37
70668820,2,"San Diego-Carlsbad-San Marcos, CA",16,101,64,0.6336633663366337,Strangulation - hanging,37
68161348,1,"Fayetteville, NC",9,71,34,0.4788732394366197,Other gun,37
75246690,1,"Ocala, FL",10,64,27,0.421875,Other or type unknown,37
59613144,1,"Springfield, OH",5,42,5,0.11904761904761904,"Firearm, type not stated",37
13556962,1,Rural West Virginia,6,657,621,0.9452054794520548,"Handgun - pistol, revolver, etc",36
3087582,1,"Cincinnati-Middletown, OH-KY-IN",7,341,305,0.8944281524926686,Knife or cutting instrument,36
58346945,2,Rural Oklahoma,6,340,304,0.8941176470588236,"Handgun - pistol, revolver, etc",36
31819374,1,"Memphis, TN-MS-AR",15,292,256,0.8767123287671232,Shotgun,36
70380133,1,"McAllen-Edinburg-Mission, TX",7,167,131,0.7844311377245509,Knife or cutting instrument,36
96446460,1,"Salt Lake City, UT",5,152,116,0.7631578947368421,"Firearm, type not stated",36
1857889,2,"Bridgeport-Stamford-Norwalk, CT",6,138,102,0.7391304347826086,"Handgun - pistol, revolver, etc",36
17680813,1,"Nashville-Davidson-Murfreesboro, TN",1,135,99,0.7333333333333333,"Blunt object - hammer, club, etc",36
55350006,1,Rural South Carolina,10,119,83,0.6974789915966386,Other or type unknown,36
78437075,2,"Flint, MI",5,64,28,0.4375,"Firearm, type not stated",36
10074234,1,"Toledo, OH",5,60,24,0.4,"Firearm, type not stated",36
62723124,2,"New Orleans-Metairie-Kenner, LA",16,59,23,0.3898305084745763,Strangulation - hanging,36
9584882,1,"New Orleans-Metairie-Kenner, LA",9,55,19,0.34545454545454546,Other gun,36
85202246,1,"Detroit-Warren-Livonia, MI",17,36,0,0.0,Weapon Not Reported,36
44593847,1,"Colorado Springs, CO",6,457,422,0.9234135667396062,"Handgun - pistol, revolver, etc",35
86385329,1,"El Paso, TX",7,270,235,0.8703703703703703,Knife or cutting instrument,35
22361042,1,"Dayton, OH",7,242,207,0.8553719008264463,Knife or cutting instrument,35
12439567,1,"Lansing-East Lansing, MI",6,207,172,0.8309178743961353,"Handgun - pistol, revolver, etc",35
22959776,1,"Greenville, SC",5,198,163,0.8232323232323232,"Firearm, type not stated",35
70324304,1,Rural Virginia,10,176,141,0.8011363636363636,Other or type unknown,35
5639235,1,"Salt Lake City, UT",7,175,140,0.8,Knife or cutting instrument,35
5112171,2,"San Jose-Sunnyvale-Santa Clara, CA",7,173,138,0.7976878612716763,Knife or cutting instrument,35
938082,2,"Columbus, OH",7,162,127,0.7839506172839507,Knife or cutting instrument,35
46897936,1,Rural Oklahoma,1,138,103,0.7463768115942029,"Blunt object - hammer, club, etc",35
13540776,1,"Valdosta, GA",6,132,97,0.7348484848484849,"Handgun - pistol, revolver, etc",35
95201039,2,"Oklahoma City, OK",10,126,91,0.7222222222222222,Other or type unknown,35
18040220,1,"Columbus, OH",1,114,79,0.6929824561403509,"Blunt object - hammer, club, etc",35
79928646,2,"Bakersfield, CA",7,109,74,0.6788990825688074,Knife or cutting instrument,35
23681062,2,"Cleveland-Elyria-Mentor, OH",1,104,69,0.6634615384615384,"Blunt object - hammer, club, etc",35
31769183,2,"Portland-Vancouver-Beaverton, OR-WA",16,83,48,0.5783132530120482,Strangulation - hanging,35
20046839,1,"Riverside-San Bernardino, CA",16,81,46,0.5679012345679012,Strangulation - hanging,35
97943398,1,"Alexandria, LA",5,74,39,0.527027027027027,"Firearm, type not stated",35
82667281,1,"Baltimore-Towson, MD",16,58,23,0.39655172413793105,Strangulation - hanging,35
67006132,2,"Portland-Vancouver-Beaverton, OR-WA",6,306,272,0.8888888888888888,"Handgun - pistol, revolver, etc",34
31175218,2,"Denver-Aurora, CO",11,224,190,0.8482142857142857,"Personal weapons, includes beating",34
58153210,1,"Louisville, KY-IN",10,127,93,0.7322834645669292,Other or type unknown,34
92756240,1,"Lakeland, FL",5,121,87,0.71900826446281,"Firearm, type not stated",34
67074902,1,"Louisville, KY-IN",1,118,84,0.711864406779661,"Blunt object - hammer, club, etc",34
21545643,2,"San Diego-Carlsbad-San Marcos, CA",1,117,83,0.7094017094017094,"Blunt object - hammer, club, etc",34
47033328,1,"Florence, SC",5,106,72,0.6792452830188679,"Firearm, type not stated",34
56358265,1,"San Jose-Sunnyvale-Santa Clara, CA",1,106,72,0.6792452830188679,"Blunt object - hammer, club, etc",34
71543416,1,"Beaumont-Port Arthur, TX",5,100,66,0.66,"Firearm, type not stated",34
53709621,1,"Winston-Salem, NC",10,99,65,0.6565656565656566,Other or type unknown,34
95302493,2,"Cincinnati-Middletown, OH-KY-IN",10,98,64,0.6530612244897959,Other or type unknown,34
49050651,2,"Tulsa, OK",10,87,53,0.6091954022988506,Other or type unknown,34
51606369,2,"Pittsburgh, PA",5,76,42,0.5526315789473685,"Firearm, type not stated",34
54167845,2,"Bakersfield, CA",10,64,30,0.46875,Other or type unknown,34
90280594,1,"Buffalo-Niagara Falls, NY",10,62,28,0.45161290322580644,Other or type unknown,34
74304043,1,Rural Arizona,5,59,25,0.423728813559322,"Firearm, type not stated",34
20627575,2,Rural South Carolina,6,449,416,0.9265033407572383,"Handgun - pistol, revolver, etc",33
21158650,2,"Orlando-Kissimmee, FL",6,373,340,0.9115281501340483,"Handgun - pistol, revolver, etc",33
28765427,1,Rural Florida,7,306,273,0.8921568627450981,Knife or cutting instrument,33
35533312,1,Rural Indiana,6,301,268,0.8903654485049833,"Handgun - pistol, revolver, etc",33
16712416,1,"Alexandria, LA",6,271,238,0.8782287822878229,"Handgun - pistol, revolver, etc",33
47233069,1,Rural California,7,255,222,0.8705882352941177,Knife or cutting instrument,33
60807683,1,"Sacramento-Roseville, CA",11,254,221,0.8700787401574803,"Personal weapons, includes beating",33
40244928,1,"Monroe, LA",6,244,211,0.8647540983606558,"Handgun - pistol, revolver, etc",33
74645532,1,"Deltona-Daytona Beach-Ormond Beach, FL",6,214,181,0.8457943925233645,"Handgun - pistol, revolver, etc",33
89984736,2,"Dayton, OH",6,205,172,0.8390243902439024,"Handgun - pistol, revolver, etc",33
41522858,1,"Baltimore-Towson, MD",14,146,113,0.773972602739726,Rifle,33
15739348,1,"Roanoke, VA",5,109,76,0.6972477064220184,"Firearm, type not stated",33
92324534,1,"Sacramento-Roseville, CA",10,104,71,0.6826923076923077,Other or type unknown,33
11514809,1,"Fayetteville, NC",5,88,55,0.625,"Firearm, type not stated",33
61414395,1,"Rochester, NY",10,78,45,0.5769230769230769,Other or type unknown,33
50004407,2,"Bakersfield, CA",5,62,29,0.46774193548387094,"Firearm, type not stated",33
88798087,2,"Cleveland-Elyria-Mentor, OH",16,57,24,0.42105263157894735,Strangulation - hanging,33
10500068,2,Rural Mississippi,6,432,400,0.9259259259259259,"Handgun - pistol, revolver, etc",32
71138173,1,Rural Oklahoma,7,370,338,0.9135135135135135,Knife or cutting instrument,32
40884070,1,Rural Washington,6,329,297,0.9027355623100304,"Handgun - pistol, revolver, etc",32
75395098,1,Rural Kentucky,14,282,250,0.8865248226950354,Rifle,32
59212497,1,Rural Alaska,6,226,194,0.8584070796460177,"Handgun - pistol, revolver, etc",32
11095060,1,"Anniston-Oxford, AL",6,212,180,0.8490566037735849,"Handgun - pistol, revolver, etc",32
53639046,1,"Evansville, IN-KY",6,196,164,0.8367346938775511,"Handgun - pistol, revolver, etc",32
17307791,1,"Ocala, FL",6,193,161,0.8341968911917098,"Handgun - pistol, revolver, etc",32
939146,1,"Baton Rouge, LA",14,147,115,0.782312925170068,Rifle,32
45113497,2,"Minneapolis-St. Paul-Bloomington, MN-WI",10,131,99,0.7557251908396947,Other or type unknown,32
9923570,1,"Erie, PA",6,127,95,0.7480314960629921,"Handgun - pistol, revolver, etc",32
64943071,2,Rural South Carolina,5,123,91,0.7398373983739838,"Firearm, type not stated",32
75976608,1,"Stockton, CA",15,110,78,0.7090909090909091,Shotgun,32
79832357,2,Rural Alabama,10,102,70,0.6862745098039216,Other or type unknown,32
9703616,1,Rural Oklahoma,5,85,53,0.6235294117647059,"Firearm, type not stated",32
93086443,1,"Hickory-Lenoir-Morganton, NC",10,82,50,0.6097560975609756,Other or type unknown,32
98084791,2,"San Antonio, TX",16,66,34,0.5151515151515151,Strangulation - hanging,32
67284123,1,"Washington-Arlington-Alexandria, DC-VA-MD-WV",16,61,29,0.47540983606557374,Strangulation - hanging,32
55189238,1,"York-Hanover, PA",5,56,24,0.42857142857142855,"Firearm, type not stated",32
53313528,1,"Lubbock, TX",6,294,263,0.8945578231292517,"Handgun - pistol, revolver, etc",31
42795712,1,Rural Oklahoma,15,285,254,0.8912280701754386,Shotgun,31
49305237,1,"Tyler, TX",6,269,238,0.8847583643122676,"Handgun - pistol, revolver, etc",31
30165699,1,"Charlotte-Gastonia-Concord, NC-SC",14,227,196,0.8634361233480177,Rifle,31
10373093,1,"Odessa, TX",6,220,189,0.8590909090909091,"Handgun - pistol, revolver, etc",31
4153585,2,"St. Louis, MO-IL",11,207,176,0.8502415458937198,"Personal weapons, includes beating",31
21698422,1,"Washington-Arlington-Alexandria, DC-VA-MD-WV",14,184,153,0.8315217391304348,Rifle,31
34299523,1,"Huntington-Ashland, WV-KY-OH",6,176,145,0.8238636363636364,"Handgun - pistol, revolver, etc",31
58722210,1,Rural North Carolina,1,174,143,0.8218390804597702,"Blunt object - hammer, club, etc",31
3047578,1,"Albuquerque, NM",11,151,120,0.7947019867549668,"Personal weapons, includes beating",31
38722798,2,Rural Virginia,10,149,118,0.7919463087248322,Other or type unknown,31
2276503,2,Rural Texas,1,148,117,0.7905405405405406,"Blunt object - hammer, club, etc",31
748656,1,"Oklahoma City, OK",1,142,111,0.7816901408450704,"Blunt object - hammer, club, etc",31
90030430,1,"Flint, MI",15,135,104,0.7703703703703704,Shotgun,31
89877591,1,"Yuba City, CA",6,131,100,0.7633587786259542,"Handgun - pistol, revolver, etc",31
45410337,2,"Tampa-St. Petersburg-Clearwater, FL",1,126,95,0.753968253968254,"Blunt object - hammer, club, etc",31
51833030,1,"Little Rock-North Little Rock, AR",10,122,91,0.7459016393442623,Other or type unknown,31
15502753,1,"Clarksville, TN-KY",5,91,60,0.6593406593406593,"Firearm, type not stated",31
97295671,1,Rural California,10,86,55,0.6395348837209303,Other or type unknown,31
40211412,1,Rural Oregon,5,80,49,0.6125,"Firearm, type not stated",31
28364019,1,"Philadelphia-Camden-Wilmington, PA-NJ-DE",16,75,44,0.5866666666666667,Strangulation - hanging,31
46871598,1,"Washington-Arlington-Alexandria, DC-VA-MD-WV",9,64,33,0.515625,Other gun,31
8605320,1,"San Francisco-Oakland-Fremont, CA",4,62,31,0.5,Fire,31
99240353,1,"Durham, NC",9,61,30,0.4918032786885246,Other gun,31
50109732,9,"New York-New Jersey-Long Island, NY-NJ",6,46,15,0.32608695652173914,"Handgun - pistol, revolver, etc",31
70818073,1,"Chicago-Naperville-Joliet, IL-IN-WI",17,31,0,0.0,Weapon Not Reported,31
77453707,2,Rural Georgia,6,454,424,0.933920704845815,"Handgun - pistol, revolver, etc",30
90917298,1,"Myrtle Beach-Conway, SC",6,348,318,0.9137931034482759,"Handgun - pistol, revolver, etc",30
13025784,1,"Springfield, MO",6,225,195,0.8666666666666667,"Handgun - pistol, revolver, etc",30
60938219,1,"Pueblo, CO",6,183,153,0.8360655737704918,"Handgun - pistol, revolver, etc",30
17791393,2,"Bakersfield, CA",6,182,152,0.8351648351648352,"Handgun - pistol, revolver, etc",30
68973285,1,"Memphis, TN-MS-AR",1,173,143,0.8265895953757225,"Blunt object - hammer, club, etc",30
79838471,1,"Goldsboro, NC",6,170,140,0.8235294117647058,"Handgun - pistol, revolver, etc",30
84150232,1,"Toledo, OH",7,165,135,0.8181818181818182,Knife or cutting instrument,30
80334811,2,"Orlando-Kissimmee, FL",5,151,121,0.8013245033112583,"Firearm, type not stated",30
45290311,1,"Chico, CA",6,137,107,0.781021897810219,"Handgun - pistol, revolver, etc",30
97281399,1,Rural Kentucky,10,136,106,0.7794117647058824,Other or type unknown,30
36809892,2,"Kansas City, MO-KS",1,128,98,0.765625,"Blunt object - hammer, club, etc",30
46602017,1,"Orlando-Kissimmee, FL",1,123,93,0.7560975609756098,"Blunt object - hammer, club, etc",30
60972690,1,"Baton Rouge, LA",10,120,90,0.75,Other or type unknown,30
16622565,1,"Fresno, CA",14,113,83,0.7345132743362832,Rifle,30
82380156,1,"Decatur, AL",6,109,79,0.7247706422018348,"Handgun - pistol, revolver, etc",30
13843926,2,"Buffalo-Niagara Falls, NY",11,106,76,0.7169811320754716,"Personal weapons, includes beating",30
16533374,2,"Providence-New Bedford-Fall River, RI-MA",10,76,46,0.6052631578947368,Other or type unknown,30
20589790,2,"Mobile, AL",10,76,46,0.6052631578947368,Other or type unknown,30
48291840,2,"Dayton, OH",10,70,40,0.5714285714285714,Other or type unknown,30
80131245,2,"Buffalo-Niagara Falls, NY",5,66,36,0.5454545454545454,"Firearm, type not stated",30
28744648,2,"Montgomery, AL",10,53,23,0.4339622641509434,Other or type unknown,30
87299897,1,Rural Georgia,7,470,441,0.9382978723404255,Knife or cutting instrument,29
32528754,1,"Tulsa, OK",7,292,263,0.9006849315068494,Knife or cutting instrument,29
91486727,1,"Shreveport-Bossier City, LA",7,189,160,0.8465608465608465,Knife or cutting instrument,29
80114401,1,"Lawton, OK",6,178,149,0.8370786516853933,"Handgun - pistol, revolver, etc",29
29538132,1,"Danville, VA",6,153,124,0.8104575163398693,"Handgun - pistol, revolver, etc",29
82594554,2,"Jacksonville, FL",11,151,122,0.8079470198675497,"Personal weapons, includes beating",29
24939328,2,"Rochester, NY",7,146,117,0.8013698630136986,Knife or cutting instrument,29
61495302,1,"Wichita, KS",5,141,112,0.7943262411347518,"Firearm, type not stated",29
32183740,1,"Stockton, CA",14,120,91,0.7583333333333333,Rifle,29
48841250,1,"Battle Creek, MI",6,117,88,0.7521367521367521,"Handgun - pistol, revolver, etc",29
86693483,1,Rural California,1,98,69,0.7040816326530612,"Blunt object - hammer, club, etc",29
23580754,2,"Sacramento-Roseville, CA",1,96,67,0.6979166666666666,"Blunt object - hammer, club, etc",29
20194776,1,"Buffalo-Niagara Falls, NY",15,95,66,0.6947368421052632,Shotgun,29
38888877,2,"Albuquerque, NM",5,86,57,0.6627906976744186,"Firearm, type not stated",29
84427856,2,Rural Oklahoma,10,86,57,0.6627906976744186,Other or type unknown,29
3321888,2,Rural South Carolina,10,84,55,0.6547619047619048,Other or type unknown,29
16021431,2,"St. Louis, MO-IL",16,83,54,0.6506024096385542,Strangulation - hanging,29
56623596,1,"Kankakee-Bradley, IL",6,81,52,0.6419753086419753,"Handgun - pistol, revolver, etc",29
64513706,1,"Boston-Cambridge-Quincy, MA-NH",4,72,43,0.5972222222222222,Fire,29
62964025,2,"Fresno, CA",5,70,41,0.5857142857142857,"Firearm, type not stated",29
40384956,1,"San Diego-Carlsbad-San Marcos, CA",16,61,32,0.5245901639344263,Strangulation - hanging,29
80200397,1,"Goldsboro, NC",9,56,27,0.48214285714285715,Other gun,29
30476311,2,"Chicago-Naperville-Joliet, IL-IN-WI",9,53,24,0.4528301886792453,Other gun,29
43525252,1,"Port St. Lucie-Fort Pierce, FL",10,49,20,0.40816326530612246,Other or type unknown,29
43065680,1,"Columbus, OH",9,45,16,0.35555555555555557,Other gun,29
98328602,1,Rural Texas,14,653,625,0.9571209800918836,Rifle,28
25049181,1,"Baton Rouge, LA",7,303,275,0.9075907590759076,Knife or cutting instrument,28
51585274,1,"Nashville-Davidson-Murfreesboro, TN",15,241,213,0.8838174273858921,Shotgun,28
72945859,2,"Virginia Beach-Norfolk-Newport News, VA-NC",7,241,213,0.8838174273858921,Knife or cutting instrument,28
80676732,1,"Birmingham-Hoover, AL",15,232,204,0.8793103448275862,Shotgun,28
90172373,1,"Greenville, NC",6,212,184,0.8679245283018868,"Handgun - pistol, revolver, etc",28
2539055,2,"Dallas-Fort Worth-Arlington, TX",15,197,169,0.8578680203045685,Shotgun,28
80333282,1,"Montgomery, AL",7,182,154,0.8461538461538461,Knife or cutting instrument,28
13178325,1,"Columbus, OH",11,177,149,0.8418079096045198,"Personal weapons, includes beating",28
96980405,2,"Orlando-Kissimmee, FL",7,175,147,0.84,Knife or cutting instrument,28
95841282,2,"Nashville-Davidson-Murfreesboro, TN",7,153,125,0.8169934640522876,Knife or cutting instrument,28
5432089,1,"Virginia Beach-Norfolk-Newport News, VA-NC",1,133,105,0.7894736842105263,"Blunt object - hammer, club, etc",28
91271015,2,"Fresno, CA",7,126,98,0.7777777777777778,Knife or cutting instrument,28
42888045,2,"Louisville, KY-IN",7,122,94,0.7704918032786885,Knife or cutting instrument,28
85844218,1,"Atlantic City, NJ",7,122,94,0.7704918032786885,Knife or cutting instrument,28
49024628,1,"Bakersfield, CA",14,111,83,0.7477477477477478,Rifle,28
59065665,2,"Seattle-Tacoma-Bellevue, WA",1,104,76,0.7307692307692307,"Blunt object - hammer, club, etc",28
85736607,2,"Stockton, CA",7,103,75,0.7281553398058253,Knife or cutting instrument,28
24910205,1,"Boston-Cambridge-Quincy, MA-NH",15,101,73,0.7227722772277227,Shotgun,28
61512264,1,"Jackson, MS",1,94,66,0.7021276595744681,"Blunt object - hammer, club, etc",28
16823846,1,"Tulsa, OK",10,90,62,0.6888888888888889,Other or type unknown,28
72815596,1,"Buffalo-Niagara Falls, NY",1,87,59,0.6781609195402298,"Blunt object - hammer, club, etc",28
91265046,1,"El Paso, TX",10,83,55,0.6626506024096386,Other or type unknown,28
19652929,2,"Cincinnati-Middletown, OH-KY-IN",5,82,54,0.6585365853658537,"Firearm, type not stated",28
1371493,2,Rural North Carolina,9,81,53,0.654320987654321,Other gun,28
8699718,1,"Charleston, WV",5,79,51,0.6455696202531646,"Firearm, type not stated",28
31974053,2,"Seattle-Tacoma-Bellevue, WA",5,75,47,0.6266666666666667,"Firearm, type not stated",28
89770458,1,"Sarasota-Bradenton-Venice, FL",10,69,41,0.5942028985507246,Other or type unknown,28
83760342,1,"Detroit-Warren-Livonia, MI",9,60,32,0.5333333333333333,Other gun,28
22584331,1,"Phoenix-Mesa-Scottsdale, AZ",16,58,30,0.5172413793103449,Strangulation - hanging,28
97636936,1,"Tuscaloosa, AL",5,55,27,0.4909090909090909,"Firearm, type not stated",28
22869313,2,"Fayetteville, NC",10,54,26,0.48148148148148145,Other or type unknown,28
45426933,1,"Vallejo-Fairfield, CA",5,48,20,0.4166666666666667,"Firearm, type not stated",28
22175373,1,"Little Rock-North Little Rock, AR",7,246,219,0.8902439024390244,Knife or cutting instrument,27
73977007,1,"New Haven-Milford, CT",7,231,204,0.8831168831168831,Knife or cutting instrument,27
2711401,1,"Greensboro-High Point, NC",7,225,198,0.88,Knife or cutting instrument,27
28407005,1,"Lubbock, TX",5,172,145,0.8430232558139535,"Firearm, type not stated",27
79067274,1,"Racine, WI",6,169,142,0.8402366863905325,"Handgun - pistol, revolver, etc",27
54842297,2,"Las Vegas-Paradise, NV",11,138,111,0.8043478260869565,"Personal weapons, includes beating",27
13553200,1,"Springfield, OH",6,124,97,0.782258064516129,"Handgun - pistol, revolver, etc",27
64509138,2,"Boston-Cambridge-Quincy, MA-NH",1,121,94,0.7768595041322314,"Blunt object - hammer, club, etc",27
74818579,2,"Columbus, OH",11,116,89,0.7672413793103449,"Personal weapons, includes beating",27
65106019,2,"St. Louis, MO-IL",1,114,87,0.7631578947368421,"Blunt object - hammer, club, etc",27
96848613,2,"Omaha-Council Bluffs, NE-IA",6,108,81,0.75,"Handgun - pistol, revolver, etc",27
75186592,2,"New York-New Jersey-Long Island, NY-NJ",17,93,66,0.7096774193548387,Weapon Not Reported,27
63621781,1,"Columbia, SC",10,89,62,0.6966292134831461,Other or type unknown,27
70476244,1,"Danville, VA",5,85,58,0.6823529411764706,"Firearm, type not stated",27
89293071,1,"Jackson, TN",5,77,50,0.6493506493506493,"Firearm, type not stated",27
59014723,1,"Winston-Salem, NC",9,66,39,0.5909090909090909,Other gun,27
70621493,1,"Brownsville-Harlingen, TX",5,62,35,0.5645161290322581,"Firearm, type not stated",27
10013644,2,"Virginia Beach-Norfolk-Newport News, VA-NC",16,56,29,0.5178571428571429,Strangulation - hanging,27
11500822,1,"Naples-Marco Island, FL",5,53,26,0.49056603773584906,"Firearm, type not stated",27
63630050,2,"Buffalo-Niagara Falls, NY",10,45,18,0.4,Other or type unknown,27
41587888,1,Rural Virginia,7,276,250,0.9057971014492754,Knife or cutting instrument,26
36812083,1,"Clarksville, TN-KY",6,247,221,0.8947368421052632,"Handgun - pistol, revolver, etc",26
20911223,2,"Detroit-Warren-Livonia, MI",14,246,220,0.8943089430894309,Rifle,26
60773834,1,"Spokane, WA",6,238,212,0.8907563025210085,"Handgun - pistol, revolver, etc",26
74919686,2,"Milwaukee-Waukesha-West Allis, WI",7,213,187,0.8779342723004695,Knife or cutting instrument,26
61981038,1,"Knoxville, TN",7,197,171,0.868020304568528,Knife or cutting instrument,26
60441331,1,"Indianapolis, IN",11,176,150,0.8522727272727273,"Personal weapons, includes beating",26
39561949,1,"Springfield, IL",6,153,127,0.8300653594771242,"Handgun - pistol, revolver, etc",26
99630418,1,"Reno-Sparks, NV",5,144,118,0.8194444444444444,"Firearm, type not stated",26
47530618,2,"Indianapolis, IN",11,143,117,0.8181818181818182,"Personal weapons, includes beating",26
72410449,2,"Savannah, GA",6,140,114,0.8142857142857143,"Handgun - pistol, revolver, etc",26
82724166,2,"New Haven-Milford, CT",7,136,110,0.8088235294117647,Knife or cutting instrument,26
67392822,2,"Macon, GA",6,135,109,0.8074074074074075,"Handgun - pistol, revolver, etc",26
30475677,1,"Fresno, CA",11,132,106,0.803030303030303,"Personal weapons, includes beating",26
81725159,1,"Pittsburgh, PA",14,132,106,0.803030303030303,Rifle,26
67076727,2,"Fort Wayne, IN",6,122,96,0.7868852459016393,"Handgun - pistol, revolver, etc",26
583021,1,"Tulsa, OK",1,119,93,0.7815126050420168,"Blunt object - hammer, club, etc",26
45957096,1,"Rochester, NY",15,119,93,0.7815126050420168,Shotgun,26
22815471,1,"Shreveport-Bossier City, LA",14,112,86,0.7678571428571429,Rifle,26
12038513,1,"Worcester, MA",6,106,80,0.7547169811320755,"Handgun - pistol, revolver, etc",26
24238885,1,"Salisbury, MD",6,105,79,0.7523809523809524,"Handgun - pistol, revolver, etc",26
10478180,2,"Vallejo-Fairfield, CA",6,103,77,0.7475728155339806,"Handgun - pistol, revolver, etc",26
3759762,1,Rural Tennessee,10,102,76,0.7450980392156863,Other or type unknown,26
91050912,1,"Myrtle Beach-Conway, SC",5,99,73,0.7373737373737373,"Firearm, type not stated",26
97778009,2,"Dayton, OH",7,84,58,0.6904761904761905,Knife or cutting instrument,26
8684407,2,"San Antonio, TX",1,71,45,0.6338028169014085,"Blunt object - hammer, club, etc",26
58142752,1,"Flint, MI",1,70,44,0.6285714285714286,"Blunt object - hammer, club, etc",26
66980722,2,"Rochester, NY",10,69,43,0.6231884057971014,Other or type unknown,26
55357882,2,Rural Florida,10,68,42,0.6176470588235294,Other or type unknown,26
79368245,1,"Fresno, CA",10,68,42,0.6176470588235294,Other or type unknown,26
76954107,2,"Greensboro-High Point, NC",10,67,41,0.6119402985074627,Other or type unknown,26
84909881,2,"Baton Rouge, LA",10,67,41,0.6119402985074627,Other or type unknown,26
30621583,1,"Winston-Salem, NC",5,60,34,0.5666666666666667,"Firearm, type not stated",26
13859573,2,Rural Alabama,5,55,29,0.5272727272727272,"Firearm, type not stated",26
84069732,1,"Dallas-Fort Worth-Arlington, TX",16,54,28,0.5185185185185185,Strangulation - hanging,26
40143821,1,Rural Oregon,6,333,308,0.924924924924925,"Handgun - pistol, revolver, etc",25
1564814,2,"Augusta-Richmond County, GA-SC",6,199,174,0.8743718592964824,"Handgun - pistol, revolver, etc",25
78464065,1,"Augusta-Richmond County, GA-SC",7,179,154,0.8603351955307262,Knife or cutting instrument,25
31053602,2,"Charlotte-Gastonia-Concord, NC-SC",7,175,150,0.8571428571428571,Knife or cutting instrument,25
29911130,1,"Columbus, OH",15,143,118,0.8251748251748252,Shotgun,25
70176737,1,"Lima, OH",6,122,97,0.7950819672131147,"Handgun - pistol, revolver, etc",25
99841673,2,"Las Vegas-Paradise, NV",1,110,85,0.7727272727272727,"Blunt object - hammer, club, etc",25
73074464,2,Rural Kentucky,7,106,81,0.7641509433962265,Knife or cutting instrument,25
48128151,2,"Greensboro-High Point, NC",7,105,80,0.7619047619047619,Knife or cutting instrument,25
75967728,1,"Providence-New Bedford-Fall River, RI-MA",10,88,63,0.7159090909090909,Other or type unknown,25
19775851,1,"El Centro, CA",7,82,57,0.6951219512195121,Knife or cutting instrument,25
783052,1,"Rockford, IL",5,77,52,0.6753246753246753,"Firearm, type not stated",25
3289148,2,"Little Rock-North Little Rock, AR",5,75,50,0.6666666666666666,"Firearm, type not stated",25
6398504,1,Rural New Mexico,1,65,40,0.6153846153846154,"Blunt object - hammer, club, etc",25
14989058,1,"Topeka, KS",5,64,39,0.609375,"Firearm, type not stated",25
70791898,2,"Bakersfield, CA",1,62,37,0.5967741935483871,"Blunt object - hammer, club, etc",25
68552761,1,"Muskegon-Norton Shores, MI",5,60,35,0.5833333333333334,"Firearm, type not stated",25
12339893,1,"Cape Coral-Fort Myers, FL",10,56,31,0.5535714285714286,Other or type unknown,25
20010288,1,"Houma-Bayou Cane-Thibodaux, LA",5,52,27,0.5192307692307693,"Firearm, type not stated",25
80479935,1,"Las Vegas-Paradise, NV",16,48,23,0.4791666666666667,Strangulation - hanging,25
2246703,2,"Port St. Lucie-Fort Pierce, FL",10,38,13,0.34210526315789475,Other or type unknown,25
81555258,1,Rural Alabama,15,379,355,0.9366754617414248,Shotgun,24
2512335,2,"Detroit-Warren-Livonia, MI",15,265,241,0.909433962264151,Shotgun,24
4258100,1,"Lake Charles, LA",6,249,225,0.9036144578313253,"Handgun - pistol, revolver, etc",24
98146742,1,"Oklahoma City, OK",11,201,177,0.8805970149253731,"Personal weapons, includes beating",24
36554946,2,Rural California,6,200,176,0.88,"Handgun - pistol, revolver, etc",24
61976374,1,"Beaumont-Port Arthur, TX",7,193,169,0.8756476683937824,Knife or cutting instrument,24
13192589,2,"Memphis, TN-MS-AR",11,172,148,0.8604651162790697,"Personal weapons, includes beating",24
57554462,2,"Sacramento-Roseville, CA",11,161,137,0.8509316770186336,"Personal weapons, includes beating",24
32335202,1,Rural Arizona,7,141,117,0.8297872340425532,Knife or cutting instrument,24
9335942,2,"Killeen-Temple-Fort Hood, TX",6,138,114,0.8260869565217391,"Handgun - pistol, revolver, etc",24
40095542,2,Rural Oklahoma,7,133,109,0.8195488721804511,Knife or cutting instrument,24
92260765,1,Rural Arkansas,10,119,95,0.7983193277310925,Other or type unknown,24
96144348,2,"Pittsburgh, PA",11,118,94,0.7966101694915254,"Personal weapons, includes beating",24
36099794,1,"Orlando-Kissimmee, FL",14,111,87,0.7837837837837838,Rifle,24
4305248,1,"Albuquerque, NM",14,105,81,0.7714285714285715,Rifle,24
88242318,1,Rural Louisiana,10,103,79,0.7669902912621359,Other or type unknown,24
40236525,1,"Muncie, IN",6,98,74,0.7551020408163265,"Handgun - pistol, revolver, etc",24
53674943,2,"Tucson, AZ",7,95,71,0.7473684210526316,Knife or cutting instrument,24
73493420,1,"Elkhart-Goshen, IN",6,89,65,0.7303370786516854,"Handgun - pistol, revolver, etc",24
16746495,1,Rural Pennsylvania,5,83,59,0.7108433734939759,"Firearm, type not stated",24
16220796,1,Rural New Mexico,10,82,58,0.7073170731707317,Other or type unknown,24
15719519,2,"Sacramento-Roseville, CA",16,75,51,0.68,Strangulation - hanging,24
57229634,1,"Longview, TX",5,71,47,0.6619718309859155,"Firearm, type not stated",24
86105964,2,"Raleigh-Cary, NC",10,70,46,0.6571428571428571,Other or type unknown,24
30984360,1,"Waco, TX",5,67,43,0.6417910447761194,"Firearm, type not stated",24
32017869,2,"Tucson, AZ",10,64,40,0.625,Other or type unknown,24
38044376,1,"Deltona-Daytona Beach-Ormond Beach, FL",10,62,38,0.6129032258064516,Other or type unknown,24
7889852,2,"Baton Rouge, LA",5,61,37,0.6065573770491803,"Firearm, type not stated",24
23975556,1,"Canton-Massillon, OH",5,61,37,0.6065573770491803,"Firearm, type not stated",24
69565074,1,"Decatur, IL",5,57,33,0.5789473684210527,"Firearm, type not stated",24
12631144,1,"Augusta-Richmond County, GA-SC",10,56,32,0.5714285714285714,Other or type unknown,24
52056492,2,"Indianapolis, IN",16,54,30,0.5555555555555556,Strangulation - hanging,24
83749484,1,"Mobile, AL",11,53,29,0.5471698113207547,"Personal weapons, includes beating",24
2793034,1,"Jackson, MS",10,50,26,0.52,Other or type unknown,24
11226569,1,"Poughkeepsie-Newburgh-Middletown, NY",5,50,26,0.52,"Firearm, type not stated",24
97186207,2,"Youngstown-Warren-Boardman, OH-PA",10,46,22,0.4782608695652174,Other or type unknown,24
40833454,2,"Mobile, AL",5,40,16,0.4,"Firearm, type not stated",24
7052421,1,Rural South Carolina,7,436,413,0.9472477064220184,Knife or cutting instrument,23
38027175,1,Rural Tennessee,7,302,279,0.9238410596026491,Knife or cutting instrument,23
69003192,2,"Shreveport-Bossier City, LA",6,235,212,0.902127659574468,"Handgun - pistol, revolver, etc",23
79920321,2,"New York-New Jersey-Long Island, NY-NJ",15,213,190,0.892018779342723,Shotgun,23
16469241,1,Rural California,14,187,164,0.8770053475935828,Rifle,23
301407,1,Rural New York,7,185,162,0.8756756756756757,Knife or cutting instrument,23
35111614,1,"Memphis, TN-MS-AR",11,179,156,0.8715083798882681,"Personal weapons, includes beating",23
44389948,2,"Cincinnati-Middletown, OH-KY-IN",11,172,149,0.8662790697674418,"Personal weapons, includes beating",23
61027374,1,"Gadsden, AL",6,156,133,0.8525641025641025,"Handgun - pistol, revolver, etc",23
88756437,1,"Charlotte-Gastonia-Concord, NC-SC",11,156,133,0.8525641025641025,"Personal weapons, includes beating",23
55827659,1,"Las Vegas-Paradise, NV",14,151,128,0.847682119205298,Rifle,23
91393070,1,"Gainesville, FL",6,147,124,0.8435374149659864,"Handgun - pistol, revolver, etc",23
50017457,2,"Providence-New Bedford-Fall River, RI-MA",7,142,119,0.8380281690140845,Knife or cutting instrument,23
23612923,1,"Auburn-Opelika, AL",6,138,115,0.8333333333333334,"Handgun - pistol, revolver, etc",23
31877321,1,"Jacksonville, FL",15,124,101,0.8145161290322581,Shotgun,23
78264977,2,"Tulsa, OK",7,114,91,0.7982456140350878,Knife or cutting instrument,23
31622591,1,"Florence-Muscle Shoals, AL",6,109,86,0.7889908256880734,"Handgun - pistol, revolver, etc",23
34439868,2,"San Francisco-Oakland-Fremont, CA",14,103,80,0.7766990291262136,Rifle,23
79712665,2,Rural Kentucky,10,102,79,0.7745098039215687,Other or type unknown,23
74749349,1,"Bowling Green, KY",6,100,77,0.77,"Handgun - pistol, revolver, etc",23
56384006,1,"Worcester, MA",5,90,67,0.7444444444444445,"Firearm, type not stated",23
28680285,2,"Miami-Fort Lauderdale, FL",14,89,66,0.7415730337078652,Rifle,23
9029087,1,"Columbus, GA-AL",5,87,64,0.735632183908046,"Firearm, type not stated",23
17189443,1,"El Centro, CA",6,87,64,0.735632183908046,"Handgun - pistol, revolver, etc",23
93437576,1,"Albuquerque, NM",15,80,57,0.7125,Shotgun,23
61588582,2,"Dayton, OH",5,76,53,0.6973684210526315,"Firearm, type not stated",23
29628953,1,"Madera, CA",7,73,50,0.684931506849315,Knife or cutting instrument,23
34518508,2,"Chicago-Naperville-Joliet, IL-IN-WI",0,73,50,0.684931506849315,Asphyxiation - includes death by gas,23
51618687,2,"Grand Rapids-Wyoming, MI",10,67,44,0.6567164179104478,Other or type unknown,23
40317177,1,"Durham, NC",10,65,42,0.6461538461538462,Other or type unknown,23
47425525,1,"Nashville-Davidson-Murfreesboro, TN",9,65,42,0.6461538461538462,Other gun,23
3131052,1,"Spokane, WA",5,63,40,0.6349206349206349,"Firearm, type not stated",23
8266798,2,"El Paso, TX",10,62,39,0.6290322580645161,Other or type unknown,23
6791321,2,"Sarasota-Bradenton-Venice, FL",10,59,36,0.6101694915254238,Other or type unknown,23
40423375,2,"Washington-Arlington-Alexandria, DC-VA-MD-WV",0,57,34,0.5964912280701754,Asphyxiation - includes death by gas,23
61645902,1,"New York-New Jersey-Long Island, NY-NJ",9,53,30,0.5660377358490566,Other gun,23
76733858,1,Rural Alaska,10,50,27,0.54,Other or type unknown,23
2069764,1,"San Antonio, TX",16,46,23,0.5,Strangulation - hanging,23
18173092,1,"Tallahassee, FL",10,45,22,0.4888888888888889,Other or type unknown,23
73049165,1,"Miami-Fort Lauderdale, FL",16,44,21,0.4772727272727273,Strangulation - hanging,23
78232194,2,"Denver-Aurora, CO",16,43,20,0.46511627906976744,Strangulation - hanging,23
97027813,1,Rural Arkansas,7,326,304,0.9325153374233128,Knife or cutting instrument,22
21953439,1,Rural Oklahoma,14,271,249,0.9188191881918819,Rifle,22
14024989,1,"Reno-Sparks, NV",6,241,219,0.9087136929460581,"Handgun - pistol, revolver, etc",22
20279691,1,"Houma-Bayou Cane-Thibodaux, LA",6,234,212,0.905982905982906,"Handgun - pistol, revolver, etc",22
72667502,1,Rural Michigan,6,228,206,0.9035087719298246,"Handgun - pistol, revolver, etc",22
71042074,1,"Jackson, MS",7,216,194,0.8981481481481481,Knife or cutting instrument,22
91038048,1,"Minneapolis-St. Paul-Bloomington, MN-WI",11,216,194,0.8981481481481481,"Personal weapons, includes beating",22
22693314,1,"Lynchburg, VA",6,211,189,0.8957345971563981,"Handgun - pistol, revolver, etc",22
34260765,2,"San Jose-Sunnyvale-Santa Clara, CA",6,210,188,0.8952380952380953,"Handgun - pistol, revolver, etc",22
43909904,1,Rural Pennsylvania,7,176,154,0.875,Knife or cutting instrument,22
63614981,1,Rural Illinois,6,175,153,0.8742857142857143,"Handgun - pistol, revolver, etc",22
65791153,1,"Pittsburgh, PA",11,173,151,0.8728323699421965,"Personal weapons, includes beating",22
6313337,1,Rural Pennsylvania,10,165,143,0.8666666666666667,Other or type unknown,22
17238861,1,"Kalamazoo-Portage, MI",6,159,137,0.8616352201257862,"Handgun - pistol, revolver, etc",22
15001977,2,"Orlando-Kissimmee, FL",11,153,131,0.8562091503267973,"Personal weapons, includes beating",22
85139721,1,"Ann Arbor, MI",6,153,131,0.8562091503267973,"Handgun - pistol, revolver, etc",22
23109673,1,"Nashville-Davidson-Murfreesboro, TN",14,146,124,0.8493150684931506,Rifle,22
60621090,1,"Dothan, AL",6,129,107,0.8294573643410853,"Handgun - pistol, revolver, etc",22
35755328,2,"Denver-Aurora, CO",5,128,106,0.828125,"Firearm, type not stated",22
76659561,1,"Anchorage, AK",7,127,105,0.8267716535433071,Knife or cutting instrument,22
63525583,1,"Colorado Springs, CO",7,122,100,0.819672131147541,Knife or cutting instrument,22
25647607,1,"Pittsburgh, PA",15,121,99,0.8181818181818182,Shotgun,22
29351352,2,Rural Michigan,10,109,87,0.7981651376146789,Other or type unknown,22
92269121,1,"Athens-Clarke County, GA",6,106,84,0.7924528301886793,"Handgun - pistol, revolver, etc",22
36374161,2,Rural Pennsylvania,10,102,80,0.7843137254901961,Other or type unknown,22
7086096,2,"Bridgeport-Stamford-Norwalk, CT",7,99,77,0.7777777777777778,Knife or cutting instrument,22
93074570,1,"Visalia-Porterville, CA",14,95,73,0.7684210526315789,Rifle,22
78080408,2,"Albuquerque, NM",7,85,63,0.7411764705882353,Knife or cutting instrument,22
64532954,2,"Toledo, OH",7,77,55,0.7142857142857143,Knife or cutting instrument,22
9774400,2,"Pittsburgh, PA",1,75,53,0.7066666666666667,"Blunt object - hammer, club, etc",22
71192352,1,"Miami-Fort Lauderdale, FL",4,71,49,0.6901408450704225,Fire,22
67588181,2,"Flint, MI",7,69,47,0.6811594202898551,Knife or cutting instrument,22
31044159,1,"Baltimore-Towson, MD",4,68,46,0.6764705882352942,Fire,22
50465245,2,"Denver-Aurora, CO",1,68,46,0.6764705882352942,"Blunt object - hammer, club, etc",22
20926229,2,"Columbus, OH",1,61,39,0.639344262295082,"Blunt object - hammer, club, etc",22
91031892,1,"Philadelphia-Camden-Wilmington, PA-NJ-DE",0,59,37,0.6271186440677966,Asphyxiation - includes death by gas,22
67637191,1,"Atlanta-Sandy Springs-Marietta, GA",9,55,33,0.6,Other gun,22
69267850,1,"Oxnard-Thousand Oaks-Ventura, CA",1,55,33,0.6,"Blunt object - hammer, club, etc",22
94794461,1,"Salinas, CA",15,55,33,0.6,Shotgun,22
24499039,1,"Spokane, WA",10,54,32,0.5925925925925926,Other or type unknown,22
39055559,2,"Tucson, AZ",1,54,32,0.5925925925925926,"Blunt object - hammer, club, etc",22
70662673,9,"Houston-Sugar Land-Baytown, TX",10,22,0,0.0,Other or type unknown,22
66683212,1,Rural Mississippi,7,432,411,0.9513888888888888,Knife or cutting instrument,21
80657764,2,Rural Arkansas,6,345,324,0.9391304347826087,"Handgun - pistol, revolver, etc",21
55043901,2,Rural Louisiana,6,326,305,0.9355828220858896,"Handgun - pistol, revolver, etc",21
13261650,2,Rural North Carolina,15,256,235,0.91796875,Shotgun,21
6405279,1,"Seattle-Tacoma-Bellevue, WA",14,155,134,0.864516129032258,Rifle,21
43123862,2,"Hartford, CT",6,143,122,0.8531468531468531,"Handgun - pistol, revolver, etc",21
69916994,2,Rural Louisiana,7,131,110,0.8396946564885496,Knife or cutting instrument,21
86191880,2,Rural Florida,7,124,103,0.8306451612903226,Knife or cutting instrument,21
34134200,1,"Bakersfield, CA",11,117,96,0.8205128205128205,"Personal weapons, includes beating",21
61031978,1,Rural Georgia,1,115,94,0.8173913043478261,"Blunt object - hammer, club, etc",21
39332776,1,"Waco, TX",7,111,90,0.8108108108108109,Knife or cutting instrument,21
62492069,1,"Richmond, VA",14,107,86,0.8037383177570093,Rifle,21
99181091,1,"Merced, CA",7,104,83,0.7980769230769231,Knife or cutting instrument,21
89031390,1,"Victoria, TX",6,100,79,0.79,"Handgun - pistol, revolver, etc",21
27353059,1,"Austin-Round Rock, TX",1,95,74,0.7789473684210526,"Blunt object - hammer, club, etc",21
77617780,1,Rural Ohio,10,95,74,0.7789473684210526,Other or type unknown,21
99352419,1,"Rochester, NY",14,92,71,0.7717391304347826,Rifle,21
55706861,1,"Santa Cruz-Watsonville, CA",7,87,66,0.7586206896551724,Knife or cutting instrument,21
74956434,2,"St. Louis, MO-IL",14,87,66,0.7586206896551724,Rifle,21
61356970,2,"Dayton, OH",11,83,62,0.7469879518072289,"Personal weapons, includes beating",21
60838373,1,"Visalia-Porterville, CA",15,82,61,0.7439024390243902,Shotgun,21
23741165,2,"Philadelphia-Camden-Wilmington, PA-NJ-DE",0,80,59,0.7375,Asphyxiation - includes death by gas,21
56791004,1,"Jackson, MI",7,77,56,0.7272727272727273,Knife or cutting instrument,21
9090754,2,"Indianapolis, IN",1,76,55,0.7236842105263158,"Blunt object - hammer, club, etc",21
19123868,1,"Chattanooga, TN-GA",10,62,41,0.6612903225806451,Other or type unknown,21
28349415,1,Rural Ohio,5,62,41,0.6612903225806451,"Firearm, type not stated",21
3749998,1,"Harrisburg-Carlisle, PA",10,60,39,0.65,Other or type unknown,21
55446031,1,"Lansing-East Lansing, MI",10,60,39,0.65,Other or type unknown,21
94695805,2,"Salinas, CA",7,60,39,0.65,Knife or cutting instrument,21
32045538,1,Rural Missouri,5,59,38,0.6440677966101694,"Firearm, type not stated",21
44431760,1,"Shreveport-Bossier City, LA",1,59,38,0.6440677966101694,"Blunt object - hammer, club, etc",21
26115373,1,"El Paso, TX",5,58,37,0.6379310344827587,"Firearm, type not stated",21
2855475,1,"Toledo, OH",10,57,36,0.631578947368421,Other or type unknown,21
4507185,1,"Saginaw, MI",10,57,36,0.631578947368421,Other or type unknown,21
8578674,1,"Asheville, NC",10,57,36,0.631578947368421,Other or type unknown,21
79163124,2,"Shreveport-Bossier City, LA",5,53,32,0.6037735849056604,"Firearm, type not stated",21
18511083,2,"Mobile, AL",11,51,30,0.5882352941176471,"Personal weapons, includes beating",21
49473618,1,"Wilmington, NC",10,51,30,0.5882352941176471,Other or type unknown,21
76449759,2,"San Francisco-Oakland-Fremont, CA",4,43,22,0.5116279069767442,Fire,21
78583089,1,"Honolulu, HI",5,41,20,0.4878048780487805,"Firearm, type not stated",21
3996550,1,"New York-New Jersey-Long Island, NY-NJ",3,39,18,0.46153846153846156,Explosives,21
50157779,1,"Shreveport-Bossier City, LA",10,37,16,0.43243243243243246,Other or type unknown,21
76189112,1,"Denver-Aurora, CO",4,35,14,0.4,Fire,21
97332032,1,"Baton Rouge, LA",9,35,14,0.4,Other gun,21
63566364,1,Rural Arkansas,15,290,270,0.9310344827586207,Shotgun,20
32751043,2,"Austin-Round Rock, TX",6,258,238,0.9224806201550387,"Handgun - pistol, revolver, etc",20
42531859,2,"Durham, NC",6,161,141,0.8757763975155279,"Handgun - pistol, revolver, etc",20
52864477,2,"Fayetteville, NC",6,149,129,0.8657718120805369,"Handgun - pistol, revolver, etc",20
50556154,1,"Boston-Cambridge-Quincy, MA-NH",11,145,125,0.8620689655172413,"Personal weapons, includes beating",20
63553200,2,Rural Arkansas,7,131,111,0.8473282442748091,Knife or cutting instrument,20
5851085,1,"Brunswick, GA",6,124,104,0.8387096774193549,"Handgun - pistol, revolver, etc",20
95466172,1,Rural New York,6,119,99,0.8319327731092437,"Handgun - pistol, revolver, etc",20
95730575,1,Rural Missouri,10,115,95,0.8260869565217391,Other or type unknown,20
25309955,1,"Hagerstown-Martinsburg, MD-WV",6,110,90,0.8181818181818182,"Handgun - pistol, revolver, etc",20
56891540,1,"Dayton, OH",11,97,77,0.7938144329896907,"Personal weapons, includes beating",20
18277055,1,"Flint, MI",14,90,70,0.7777777777777778,Rifle,20
73532685,1,"Little Rock-North Little Rock, AR",1,88,68,0.7727272727272727,"Blunt object - hammer, club, etc",20
70567956,1,Rural Alabama,11,87,67,0.7701149425287356,"Personal weapons, includes beating",20
52371925,2,"South Bend-Mishawaka, IN-MI",6,84,64,0.7619047619047619,"Handgun - pistol, revolver, etc",20
64333086,1,"Washington-Arlington-Alexandria, DC-VA-MD-WV",4,69,49,0.7101449275362319,Fire,20
68906163,2,"Louisville, KY-IN",10,65,45,0.6923076923076923,Other or type unknown,20
39658756,1,Rural Arizona,1,63,43,0.6825396825396826,"Blunt object - hammer, club, etc",20
80912142,2,"New Haven-Milford, CT",10,60,40,0.6666666666666666,Other or type unknown,20
43970878,1,"Bridgeport-Stamford-Norwalk, CT",10,56,36,0.6428571428571429,Other or type unknown,20
85418343,1,"Bridgeport-Stamford-Norwalk, CT",1,56,36,0.6428571428571429,"Blunt object - hammer, club, etc",20
45279700,2,"Akron, OH",10,55,35,0.6363636363636364,Other or type unknown,20
39287388,2,"Baltimore-Towson, MD",5,50,30,0.6,"Firearm, type not stated",20
63351886,1,"Pittsburgh, PA",4,50,30,0.6,Fire,20
55064501,2,"Fresno, CA",10,45,25,0.5555555555555556,Other or type unknown,20
92590888,1,"Pensacola-Ferry Pass-Brent, FL",10,42,22,0.5238095238095238,Other or type unknown,20
33894557,1,"Allentown-Bethlehem-Easton, PA-NJ",9,41,21,0.5121951219512195,Other gun,20
24486871,1,"Hanford-Corcoran, CA",5,40,20,0.5,"Firearm, type not stated",20
1337998,1,"Boston-Cambridge-Quincy, MA-NH",16,34,14,0.4117647058823529,Strangulation - hanging,20
25298488,1,"Chico, CA",5,33,13,0.3939393939393939,"Firearm, type not stated",20
58283846,2,"Tampa-St. Petersburg-Clearwater, FL",16,33,13,0.3939393939393939,Strangulation - hanging,20
17620439,2,"Toledo, OH",16,31,11,0.3548387096774194,Strangulation - hanging,20
90316593,1,"Los Angeles-Long Beach, CA",17,20,0,0.0,Weapon Not Reported,20
70751773,1,Rural South Carolina,15,339,320,0.943952802359882,Shotgun,19
92281677,2,Rural Tennessee,6,290,271,0.9344827586206896,"Handgun - pistol, revolver, etc",19
22966718,1,Rural Tennessee,15,281,262,0.9323843416370107,Shotgun,19
15717336,2,Rural Missouri,6,230,211,0.9173913043478261,"Handgun - pistol, revolver, etc",19
84048632,1,Rural Colorado,6,211,192,0.909952606635071,"Handgun - pistol, revolver, etc",19
3914390,1,"Raleigh-Cary, NC",7,208,189,0.9086538461538461,Knife or cutting instrument,19
61806618,1,"Orlando-Kissimmee, FL",11,169,150,0.8875739644970414,"Personal weapons, includes beating",19
70723923,1,"Scranton--Wilkes-Barre, PA",6,169,150,0.8875739644970414,"Handgun - pistol, revolver, etc",19
85997704,2,"Milwaukee-Waukesha-West Allis, WI",11,160,141,0.88125,"Personal weapons, includes beating",19
28903019,1,"San Jose-Sunnyvale-Santa Clara, CA",11,149,130,0.87248322147651,"Personal weapons, includes beating",19
99914200,1,"Seattle-Tacoma-Bellevue, WA",15,139,120,0.8633093525179856,Shotgun,19
90380904,1,"Tulsa, OK",14,136,117,0.8602941176470589,Rifle,19
74106107,2,"Dallas-Fort Worth-Arlington, TX",14,131,112,0.8549618320610687,Rifle,19
78607625,2,"Boston-Cambridge-Quincy, MA-NH",11,130,111,0.8538461538461538,"Personal weapons, includes beating",19
14978849,1,Rural California,15,127,108,0.8503937007874016,Shotgun,19
69752910,1,"Warner Robins, GA",6,125,106,0.848,"Handgun - pistol, revolver, etc",19
8582669,1,"Prescott, AZ",6,117,98,0.8376068376068376,"Handgun - pistol, revolver, etc",19
70523383,2,"Baton Rouge, LA",7,111,92,0.8288288288288288,Knife or cutting instrument,19
5734138,1,"Salt Lake City, UT",10,110,91,0.8272727272727273,Other or type unknown,19
28796895,2,"Riverside-San Bernardino, CA",14,106,87,0.8207547169811321,Rifle,19
13184481,1,Rural West Virginia,10,96,77,0.8020833333333334,Other or type unknown,19
91519044,2,"Honolulu, HI",11,93,74,0.7956989247311828,"Personal weapons, includes beating",19
84693718,2,Rural Arkansas,10,90,71,0.7888888888888889,Other or type unknown,19
41255277,2,Rural Missouri,10,87,68,0.7816091954022989,Other or type unknown,19
5988952,2,"Austin-Round Rock, TX",10,86,67,0.7790697674418605,Other or type unknown,19
37492834,2,"Modesto, CA",6,86,67,0.7790697674418605,"Handgun - pistol, revolver, etc",19
10078087,2,Rural Alabama,11,85,66,0.7764705882352941,"Personal weapons, includes beating",19
86718556,1,"Raleigh-Cary, NC",10,85,66,0.7764705882352941,Other or type unknown,19
74746387,2,"Augusta-Richmond County, GA-SC",7,82,63,0.7682926829268293,Knife or cutting instrument,19
14905912,1,"San Jose-Sunnyvale-Santa Clara, CA",15,78,59,0.7564102564102564,Shotgun,19
90550677,1,"San Jose-Sunnyvale-Santa Clara, CA",10,78,59,0.7564102564102564,Other or type unknown,19
15354064,1,"Johnstown, PA",6,77,58,0.7532467532467533,"Handgun - pistol, revolver, etc",19
13464239,1,"Colorado Springs, CO",5,76,57,0.75,"Firearm, type not stated",19
93884882,1,"Joplin, MO",6,75,56,0.7466666666666667,"Handgun - pistol, revolver, etc",19
50082279,1,"Fayetteville, NC",11,72,53,0.7361111111111112,"Personal weapons, includes beating",19
92295732,1,"Chicago-Naperville-Joliet, IL-IN-WI",0,67,48,0.7164179104477612,Asphyxiation - includes death by gas,19
96222685,1,"San Francisco-Oakland-Fremont, CA",0,65,46,0.7076923076923077,Asphyxiation - includes death by gas,19
11689849,2,"Riverside-San Bernardino, CA",0,64,45,0.703125,Asphyxiation - includes death by gas,19
87704598,2,"Oxnard-Thousand Oaks-Ventura, CA",7,61,42,0.6885245901639344,Knife or cutting instrument,19
54090186,1,"Anderson, SC",5,60,41,0.6833333333333333,"Firearm, type not stated",19
92781536,1,"Hartford, CT",1,59,40,0.6779661016949152,"Blunt object - hammer, club, etc",19
7937325,1,"Knoxville, TN",1,58,39,0.6724137931034483,"Blunt object - hammer, club, etc",19
79160810,1,"Visalia-Porterville, CA",1,57,38,0.6666666666666666,"Blunt object - hammer, club, etc",19
2749558,1,"Dallas-Fort Worth-Arlington, TX",4,53,34,0.6415094339622641,Fire,19
29654499,1,"Cleveland-Elyria-Mentor, OH",4,51,32,0.6274509803921569,Fire,19
16476992,1,"Niles-Benton Harbor, MI",5,50,31,0.62,"Firearm, type not stated",19
35923291,1,"Kansas City, MO-KS",4,50,31,0.62,Fire,19
98299402,2,"St. Louis, MO-IL",4,50,31,0.62,Fire,19
1002928,2,Rural California,10,49,30,0.6122448979591837,Other or type unknown,19
11384053,2,"Augusta-Richmond County, GA-SC",5,49,30,0.6122448979591837,"Firearm, type not stated",19
17357962,2,"Youngstown-Warren-Boardman, OH-PA",5,46,27,0.5869565217391305,"Firearm, type not stated",19
53286540,2,"San Jose-Sunnyvale-Santa Clara, CA",10,44,25,0.5681818181818182,Other or type unknown,19
67481197,1,"Salinas, CA",1,44,25,0.5681818181818182,"Blunt object - hammer, club, etc",19
49031260,1,"Santa Barbara-Santa Maria, CA",5,43,24,0.5581395348837209,"Firearm, type not stated",19
13785218,2,"Deltona-Daytona Beach-Ormond Beach, FL",10,42,23,0.5476190476190477,Other or type unknown,19
97378188,1,"Riverside-San Bernardino, CA",4,40,21,0.525,Fire,19
86113100,2,"Savannah, GA",10,35,16,0.45714285714285713,Other or type unknown,19
26540274,2,"Rochester, NY",5,34,15,0.4411764705882353,"Firearm, type not stated",19
7814019,9,"Detroit-Warren-Livonia, MI",10,28,9,0.32142857142857145,Other or type unknown,19
14259047,1,"San Antonio, TX",17,19,0,0.0,Weapon Not Reported,19
90913384,1,Rural Virginia,15,263,245,0.9315589353612167,Shotgun,18
52347323,1,"Oklahoma City, OK",15,187,169,0.9037433155080213,Shotgun,18
65771480,1,"Pensacola-Ferry Pass-Brent, FL",6,184,166,0.9021739130434783,"Handgun - pistol, revolver, etc",18
16424043,1,Rural Georgia,14,175,157,0.8971428571428571,Rifle,18
33081225,2,"Beaumont-Port Arthur, TX",6,172,154,0.8953488372093024,"Handgun - pistol, revolver, etc",18
21320601,1,"Springfield, MA",7,160,142,0.8875,Knife or cutting instrument,18
64311499,1,"Durham, NC",7,147,129,0.8775510204081632,Knife or cutting instrument,18
22455606,1,"Poughkeepsie-Newburgh-Middletown, NY",7,138,120,0.8695652173913043,Knife or cutting instrument,18
70825351,2,"San Antonio, TX",11,138,120,0.8695652173913043,"Personal weapons, includes beating",18
50175541,2,"Winston-Salem, NC",6,133,115,0.8646616541353384,"Handgun - pistol, revolver, etc",18
96614371,1,"Little Rock-North Little Rock, AR",15,127,109,0.8582677165354331,Shotgun,18
70689029,1,Rural Nevada,6,121,103,0.8512396694214877,"Handgun - pistol, revolver, etc",18
10122873,1,"Omaha-Council Bluffs, NE-IA",7,119,101,0.8487394957983193,Knife or cutting instrument,18
22867424,1,"Reno-Sparks, NV",7,115,97,0.8434782608695652,Knife or cutting instrument,18
15262890,1,"Providence-New Bedford-Fall River, RI-MA",11,111,93,0.8378378378378378,"Personal weapons, includes beating",18
4225685,1,"Youngstown-Warren-Boardman, OH-PA",7,107,89,0.8317757009345794,Knife or cutting instrument,18
66090982,1,"Naples-Marco Island, FL",6,107,89,0.8317757009345794,"Handgun - pistol, revolver, etc",18
50440063,1,"Shreveport-Bossier City, LA",15,102,84,0.8235294117647058,Shotgun,18
77734115,1,"Port St. Lucie-Fort Pierce, FL",7,99,81,0.8181818181818182,Knife or cutting instrument,18
34195962,1,"Cincinnati-Middletown, OH-KY-IN",1,98,80,0.8163265306122449,"Blunt object - hammer, club, etc",18
10997204,2,"Chicago-Naperville-Joliet, IL-IN-WI",14,88,70,0.7954545454545454,Rifle,18
75206697,1,"Grand Rapids-Wyoming, MI",10,82,64,0.7804878048780488,Other or type unknown,18
30680990,1,"Birmingham-Hoover, AL",1,81,63,0.7777777777777778,"Blunt object - hammer, club, etc",18
46023009,1,"New Haven-Milford, CT",10,72,54,0.75,Other or type unknown,18
74828185,1,"Kalamazoo-Portage, MI",5,72,54,0.75,"Firearm, type not stated",18
92629013,2,"Salinas, CA",6,72,54,0.75,"Handgun - pistol, revolver, etc",18
11419926,2,"Portland-Vancouver-Beaverton, OR-WA",1,69,51,0.7391304347826086,"Blunt object - hammer, club, etc",18
18850504,1,"Knoxville, TN",10,68,50,0.7352941176470589,Other or type unknown,18
39411880,2,"Portland-Vancouver-Beaverton, OR-WA",5,68,50,0.7352941176470589,"Firearm, type not stated",18
65687622,2,"Trenton-Ewing, NJ",6,60,42,0.7,"Handgun - pistol, revolver, etc",18
473336,2,"Savannah, GA",7,59,41,0.6949152542372882,Knife or cutting instrument,18
58040753,1,"Huntsville, AL",10,59,41,0.6949152542372882,Other or type unknown,18
52208087,1,"Odessa, TX",5,58,40,0.6896551724137931,"Firearm, type not stated",18
71021992,1,"Ann Arbor, MI",5,54,36,0.6666666666666666,"Firearm, type not stated",18
22807768,1,"Savannah, GA",5,53,35,0.660377358490566,"Firearm, type not stated",18
25577391,1,"Detroit-Warren-Livonia, MI",0,51,33,0.6470588235294118,Asphyxiation - includes death by gas,18
42966252,1,"Texarkana, TX-Texarkana, AR",5,50,32,0.64,"Firearm, type not stated",18
22534784,1,"Fayetteville, NC",1,49,31,0.6326530612244898,"Blunt object - hammer, club, etc",18
32893402,2,"San Jose-Sunnyvale-Santa Clara, CA",16,48,30,0.625,Strangulation - hanging,18
19435271,1,"Goldsboro, NC",10,47,29,0.6170212765957447,Other or type unknown,18
72584159,2,"Oklahoma City, OK",16,46,28,0.6086956521739131,Strangulation - hanging,18
39540966,2,"Cape Coral-Fort Myers, FL",10,44,26,0.5909090909090909,Other or type unknown,18
61180057,2,"Fresno, CA",1,41,23,0.5609756097560976,"Blunt object - hammer, club, etc",18
96664667,2,"Knoxville, TN",10,39,21,0.5384615384615384,Other or type unknown,18
53700439,1,"Allentown-Bethlehem-Easton, PA-NJ",5,33,15,0.45454545454545453,"Firearm, type not stated",18
81559722,2,"Toledo, OH",10,33,15,0.45454545454545453,Other or type unknown,18
33092875,2,"Columbus, OH",16,30,12,0.4,Strangulation - hanging,18
89424697,2,"Chicago-Naperville-Joliet, IL-IN-WI",17,18,0,0.0,Weapon Not Reported,18
7475259,1,"Anderson, SC",6,292,275,0.9417808219178082,"Handgun - pistol, revolver, etc",17
62291202,1,"Sumter, SC",6,237,220,0.9282700421940928,"Handgun - pistol, revolver, etc",17
61755053,1,Rural Idaho,6,189,172,0.91005291005291,"Handgun - pistol, revolver, etc",17
51370844,1,Rural Missouri,7,179,162,0.9050279329608939,Knife or cutting instrument,17
93136380,2,"Virginia Beach-Norfolk-Newport News, VA-NC",11,172,155,0.9011627906976745,"Personal weapons, includes beating",17
28256450,1,"Jacksonville, FL",11,169,152,0.8994082840236687,"Personal weapons, includes beating",17
4902962,1,Rural Louisiana,14,166,149,0.8975903614457831,Rifle,17
46255618,2,"Seattle-Tacoma-Bellevue, WA",11,159,142,0.8930817610062893,"Personal weapons, includes beating",17
48569911,1,"Winston-Salem, NC",7,137,120,0.8759124087591241,Knife or cutting instrument,17
94499849,1,"Fayetteville, NC",7,131,114,0.8702290076335878,Knife or cutting instrument,17
94648402,2,"Kansas City, MO-KS",11,131,114,0.8702290076335878,"Personal weapons, includes beating",17
38454064,1,Rural Ohio,7,129,112,0.8682170542635659,Knife or cutting instrument,17
43306233,1,"Little Rock-North Little Rock, AR",14,119,102,0.8571428571428571,Rifle,17
75607976,2,"Hartford, CT",7,117,100,0.8547008547008547,Knife or cutting instrument,17
49429112,1,"Baton Rouge, LA",15,116,99,0.853448275862069,Shotgun,17
67931568,2,"Chicago-Naperville-Joliet, IL-IN-WI",15,116,99,0.853448275862069,Shotgun,17
86511638,1,"Minneapolis-St. Paul-Bloomington, MN-WI",15,116,99,0.853448275862069,Shotgun,17
90637084,1,"Vallejo-Fairfield, CA",7,111,94,0.8468468468468469,Knife or cutting instrument,17
37151183,1,"Davenport-Moline-Rock Island, IA-IL",6,110,93,0.8454545454545455,"Handgun - pistol, revolver, etc",17
61452294,2,"Honolulu, HI",7,106,89,0.839622641509434,Knife or cutting instrument,17
27604914,1,"Pittsburgh, PA",1,105,88,0.8380952380952381,"Blunt object - hammer, club, etc",17
52753010,1,"Las Cruces, NM",6,105,88,0.8380952380952381,"Handgun - pistol, revolver, etc",17
90368512,1,"Allentown-Bethlehem-Easton, PA-NJ",7,102,85,0.8333333333333334,Knife or cutting instrument,17
61254400,2,"Louisville, KY-IN",11,86,69,0.8023255813953488,"Personal weapons, includes beating",17
51719493,2,Rural North Carolina,5,85,68,0.8,"Firearm, type not stated",17
96625105,1,"Champaign-Urbana, IL",6,85,68,0.8,"Handgun - pistol, revolver, etc",17
56345964,1,Rural Florida,1,82,65,0.7926829268292683,"Blunt object - hammer, club, etc",17
84621332,2,"Salt Lake City, UT",7,81,64,0.7901234567901234,Knife or cutting instrument,17
1239024,2,Rural Arkansas,5,79,62,0.7848101265822784,"Firearm, type not stated",17
65967443,2,Rural Virginia,5,79,62,0.7848101265822784,"Firearm, type not stated",17
86841840,2,"Detroit-Warren-Livonia, MI",0,79,62,0.7848101265822784,Asphyxiation - includes death by gas,17
24042885,1,"Naples-Marco Island, FL",7,78,61,0.782051282051282,Knife or cutting instrument,17
90524389,1,"El Paso, TX",1,78,61,0.782051282051282,"Blunt object - hammer, club, etc",17
48269467,1,"Youngstown-Warren-Boardman, OH-PA",15,77,60,0.7792207792207793,Shotgun,17
66079484,2,"Virginia Beach-Norfolk-Newport News, VA-NC",1,76,59,0.7763157894736842,"Blunt object - hammer, club, etc",17
97061997,2,"Little Rock-North Little Rock, AR",10,69,52,0.7536231884057971,Other or type unknown,17
38821001,1,"Honolulu, HI",1,68,51,0.75,"Blunt object - hammer, club, etc",17
83874864,1,"San Luis Obispo-Paso Robles, CA",6,68,51,0.75,"Handgun - pistol, revolver, etc",17
42216968,1,"McAllen-Edinburg-Mission, TX",15,66,49,0.7424242424242424,Shotgun,17
68569784,1,"Davenport-Moline-Rock Island, IA-IL",5,66,49,0.7424242424242424,"Firearm, type not stated",17
17306140,1,"Weirton-Steubenville, WV-OH",6,63,46,0.7301587301587301,"Handgun - pistol, revolver, etc",17
38348685,1,"Santa Fe, NM",5,62,45,0.7258064516129032,"Firearm, type not stated",17
77912559,2,"Fresno, CA",11,58,41,0.7068965517241379,"Personal weapons, includes beating",17
34475190,2,"Sacramento-Roseville, CA",5,55,38,0.6909090909090909,"Firearm, type not stated",17
27345080,1,Rural Pennsylvania,8,54,37,0.6851851851851852,"Narcotics or drugs, sleeping pills",17
16071768,2,Rural Texas,16,53,36,0.6792452830188679,Strangulation - hanging,17
45294461,1,"San Diego-Carlsbad-San Marcos, CA",9,49,32,0.6530612244897959,Other gun,17
17886762,2,"Boston-Cambridge-Quincy, MA-NH",4,48,31,0.6458333333333334,Fire,17
99643222,2,"Cleveland-Elyria-Mentor, OH",4,48,31,0.6458333333333334,Fire,17
82302122,1,"St. Louis, MO-IL",4,47,30,0.6382978723404256,Fire,17
95397084,2,"Lakeland, FL",10,46,29,0.6304347826086957,Other or type unknown,17
74545907,1,"Oxnard-Thousand Oaks-Ventura, CA",15,44,27,0.6136363636363636,Shotgun,17
91497134,1,"Phoenix-Mesa-Scottsdale, AZ",4,44,27,0.6136363636363636,Fire,17
58656124,2,"Atlanta-Sandy Springs-Marietta, GA",0,43,26,0.6046511627906976,Asphyxiation - includes death by gas,17
76560097,2,"Pittsburgh, PA",16,41,24,0.5853658536585366,Strangulation - hanging,17
24028797,1,"Killeen-Temple-Fort Hood, TX",1,40,23,0.575,"Blunt object - hammer, club, etc",17
63558199,1,"Gulfport-Biloxi, MS",10,40,23,0.575,Other or type unknown,17
95995692,1,"Laredo, TX",10,38,21,0.5526315789473685,Other or type unknown,17
92326383,1,"Monroe, LA",10,34,17,0.5,Other or type unknown,17
762472,1,"Atlanta-Sandy Springs-Marietta, GA",0,30,13,0.43333333333333335,Asphyxiation - includes death by gas,17
20445121,1,"Trenton-Ewing, NJ",10,30,13,0.43333333333333335,Other or type unknown,17
14672579,1,"Bridgeport-Stamford-Norwalk, CT",14,29,12,0.41379310344827586,Rifle,17
49678729,1,"Atlantic City, NJ",10,24,7,0.2916666666666667,Other or type unknown,17
59687026,1,"Dallas-Fort Worth-Arlington, TX",17,17,0,0.0,Weapon Not Reported,17
13981801,2,Rural Pennsylvania,6,255,239,0.9372549019607843,"Handgun - pistol, revolver, etc",16
25315997,2,Rural Texas,11,241,225,0.9336099585062241,"Personal weapons, includes beating",16
75495292,2,Rural Florida,6,233,217,0.9313304721030042,"Handgun - pistol, revolver, etc",16
86568237,1,"Milwaukee-Waukesha-West Allis, WI",11,204,188,0.9215686274509803,"Personal weapons, includes beating",16
66021351,2,"Houston-Sugar Land-Baytown, TX",15,200,184,0.92,Shotgun,16
25557795,1,"Wichita Falls, TX",6,192,176,0.9166666666666666,"Handgun - pistol, revolver, etc",16
21318385,2,"Minneapolis-St. Paul-Bloomington, MN-WI",11,159,143,0.89937106918239,"Personal weapons, includes beating",16
70098340,1,"Lakeland, FL",7,154,138,0.8961038961038961,Knife or cutting instrument,16
22425199,1,Rural Alabama,14,150,134,0.8933333333333333,Rifle,16
49215617,1,"Mobile, AL",15,150,134,0.8933333333333333,Shotgun,16
9195183,1,"Columbus, GA-AL",7,143,127,0.8881118881118881,Knife or cutting instrument,16
15688081,2,Rural Mississippi,7,142,126,0.8873239436619719,Knife or cutting instrument,16
61307637,1,"Lubbock, TX",7,133,117,0.8796992481203008,Knife or cutting instrument,16
68316873,1,"Burlington, NC",6,132,116,0.8787878787878788,"Handgun - pistol, revolver, etc",16
89285845,1,"Tucson, AZ",14,126,110,0.873015873015873,Rifle,16
23957470,1,"Greensboro-High Point, NC",15,125,109,0.872,Shotgun,16
99126408,1,Rural Maryland,6,124,108,0.8709677419354839,"Handgun - pistol, revolver, etc",16
92213689,2,Rural Pennsylvania,7,120,104,0.8666666666666667,Knife or cutting instrument,16
15337211,1,"Tampa-St. Petersburg-Clearwater, FL",15,119,103,0.865546218487395,Shotgun,16
43259273,2,"Columbus, GA-AL",6,115,99,0.8608695652173913,"Handgun - pistol, revolver, etc",16
61005051,1,"Augusta-Richmond County, GA-SC",15,110,94,0.8545454545454545,Shotgun,16
11493667,2,"Riverside-San Bernardino, CA",15,102,86,0.8431372549019608,Shotgun,16
88400689,1,"Louisville, KY-IN",15,100,84,0.84,Shotgun,16
65106976,1,"Fayetteville, NC",15,99,83,0.8383838383838383,Shotgun,16
5277209,2,"Allentown-Bethlehem-Easton, PA-NJ",6,95,79,0.8315789473684211,"Handgun - pistol, revolver, etc",16
61749886,2,"Pittsburgh, PA",10,88,72,0.8181818181818182,Other or type unknown,16
12070575,1,"Albany, GA",5,78,62,0.7948717948717948,"Firearm, type not stated",16
32076457,1,"Montgomery, AL",11,74,58,0.7837837837837838,"Personal weapons, includes beating",16
83592094,1,"Greenville, SC",10,74,58,0.7837837837837838,Other or type unknown,16
95041565,1,"Elizabethtown, KY",6,72,56,0.7777777777777778,"Handgun - pistol, revolver, etc",16
4308850,1,"New Haven-Milford, CT",1,65,49,0.7538461538461538,"Blunt object - hammer, club, etc",16
71190474,2,"Jacksonville, FL",1,65,49,0.7538461538461538,"Blunt object - hammer, club, etc",16
4271659,2,Rural Arizona,10,64,48,0.75,Other or type unknown,16
69050399,2,"Mobile, AL",7,64,48,0.75,Knife or cutting instrument,16
57942506,2,Rural Mississippi,10,62,46,0.7419354838709677,Other or type unknown,16
21327503,2,"Minneapolis-St. Paul-Bloomington, MN-WI",5,60,44,0.7333333333333333,"Firearm, type not stated",16
33508461,2,"Grand Rapids-Wyoming, MI",7,59,43,0.7288135593220338,Knife or cutting instrument,16
73314133,1,"Palm Bay-Melbourne-Titusville, FL",10,58,42,0.7241379310344828,Other or type unknown,16
94171422,1,"Houston-Sugar Land-Baytown, TX",4,57,41,0.7192982456140351,Fire,16
38791166,2,"Youngstown-Warren-Boardman, OH-PA",7,55,39,0.7090909090909091,Knife or cutting instrument,16
16558881,1,"Lubbock, TX",10,53,37,0.6981132075471698,Other or type unknown,16
24592417,1,"Atlanta-Sandy Springs-Marietta, GA",4,50,34,0.68,Fire,16
67009692,1,"Stockton, CA",10,48,32,0.6666666666666666,Other or type unknown,16
95200427,2,"Spokane, WA",10,47,31,0.6595744680851063,Other or type unknown,16
26419946,2,"Miami-Fort Lauderdale, FL",4,46,30,0.6521739130434783,Fire,16
63515799,1,"Riverside-San Bernardino, CA",0,42,26,0.6190476190476191,Asphyxiation - includes death by gas,16
86171336,1,"Seattle-Tacoma-Bellevue, WA",16,41,25,0.6097560975609756,Strangulation - hanging,16
63611982,2,"Saginaw, MI",10,39,23,0.5897435897435898,Other or type unknown,16
77495443,1,"Gainesville, FL",5,39,23,0.5897435897435898,"Firearm, type not stated",16
99439096,2,"Saginaw, MI",5,39,23,0.5897435897435898,"Firearm, type not stated",16
16799502,1,"Youngstown-Warren-Boardman, OH-PA",14,36,20,0.5555555555555556,Rifle,16
52219333,1,"St. Louis, MO-IL",16,36,20,0.5555555555555556,Strangulation - hanging,16
51713984,1,"Elkhart-Goshen, IN",5,35,19,0.5428571428571428,"Firearm, type not stated",16
17917157,1,"Allentown-Bethlehem-Easton, PA-NJ",1,34,18,0.5294117647058824,"Blunt object - hammer, club, etc",16
98416039,2,"Bakersfield, CA",16,33,17,0.5151515151515151,Strangulation - hanging,16
55849712,2,"Ocala, FL",10,32,16,0.5,Other or type unknown,16
19629803,2,"Anchorage, AK",10,30,14,0.4666666666666667,Other or type unknown,16
44466192,1,"Scranton--Wilkes-Barre, PA",5,29,13,0.4482758620689655,"Firearm, type not stated",16
14931228,1,"Columbia, MO",5,25,9,0.36,"Firearm, type not stated",16
85886474,9,"Jacksonville, FL",10,19,3,0.15789473684210525,Other or type unknown,16
17029255,1,"Memphis, TN-MS-AR",17,16,0,0.0,Weapon Not Reported,16
35285122,1,"New Orleans-Metairie-Kenner, LA",17,16,0,0.0,Weapon Not Reported,16
66237495,1,"Houston-Sugar Land-Baytown, TX",17,16,0,0.0,Weapon Not Reported,16
46076814,2,"Columbia, SC",6,299,284,0.9498327759197325,"Handgun - pistol, revolver, etc",15
26829473,1,Rural Mississippi,15,257,242,0.9416342412451362,Shotgun,15
25959283,1,Rural Georgia,15,210,195,0.9285714285714286,Shotgun,15
35495083,1,"Virginia Beach-Norfolk-Newport News, VA-NC",11,207,192,0.927536231884058,"Personal weapons, includes beating",15
62239597,1,"Sacramento-Roseville, CA",14,188,173,0.9202127659574468,Rifle,15
85797512,1,"Virginia Beach-Norfolk-Newport News, VA-NC",15,168,153,0.9107142857142857,Shotgun,15
64775109,2,"Knoxville, TN",6,166,151,0.9096385542168675,"Handgun - pistol, revolver, etc",15
62664791,2,Rural Georgia,7,159,144,0.9056603773584906,Knife or cutting instrument,15
14610195,1,Rural Michigan,15,136,121,0.8897058823529411,Shotgun,15
62208847,1,"Albany-Schenectady-Troy, NY",7,136,121,0.8897058823529411,Knife or cutting instrument,15
87874858,1,"Niles-Benton Harbor, MI",6,128,113,0.8828125,"Handgun - pistol, revolver, etc",15
65706781,1,"Oklahoma City, OK",14,124,109,0.8790322580645161,Rifle,15
30106493,2,Rural Alabama,7,121,106,0.8760330578512396,Knife or cutting instrument,15
2446448,1,Rural Washington,7,119,104,0.8739495798319328,Knife or cutting instrument,15
3455706,1,"Austin-Round Rock, TX",10,116,101,0.8706896551724138,Other or type unknown,15
37671271,1,"Stockton, CA",11,116,101,0.8706896551724138,"Personal weapons, includes beating",15
7779116,1,"Santa Rosa-Petaluma, CA",7,110,95,0.8636363636363636,Knife or cutting instrument,15
35807345,1,"Yuma, AZ",6,104,89,0.8557692307692307,"Handgun - pistol, revolver, etc",15
67121505,1,Rural Mississippi,1,102,87,0.8529411764705882,"Blunt object - hammer, club, etc",15
9683365,2,"Oxnard-Thousand Oaks-Ventura, CA",6,98,83,0.8469387755102041,"Handgun - pistol, revolver, etc",15
3226209,2,Rural Kentucky,11,97,82,0.845360824742268,"Personal weapons, includes beating",15
95467759,2,"McAllen-Edinburg-Mission, TX",6,97,82,0.845360824742268,"Handgun - pistol, revolver, etc",15
97683286,2,"Atlanta-Sandy Springs-Marietta, GA",14,97,82,0.845360824742268,Rifle,15
76693025,2,Rural Georgia,5,95,80,0.8421052631578947,"Firearm, type not stated",15
85873164,1,"Harrisburg-Carlisle, PA",7,94,79,0.8404255319148937,Knife or cutting instrument,15
66788028,2,Rural Texas,5,91,76,0.8351648351648352,"Firearm, type not stated",15
63155048,1,"Hanford-Corcoran, CA",6,90,75,0.8333333333333334,"Handgun - pistol, revolver, etc",15
66000632,2,"Albuquerque, NM",11,88,73,0.8295454545454546,"Personal weapons, includes beating",15
88735090,2,"Rochester, NY",11,85,70,0.8235294117647058,"Personal weapons, includes beating",15
70275436,1,"South Bend-Mishawaka, IN-MI",7,78,63,0.8076923076923077,Knife or cutting instrument,15
69195215,2,"Jackson, MS",7,76,61,0.8026315789473685,Knife or cutting instrument,15
76201007,1,"Roanoke, VA",7,76,61,0.8026315789473685,Knife or cutting instrument,15
18833045,2,"Salt Lake City, UT",10,70,55,0.7857142857142857,Other or type unknown,15
7865260,2,Rural Louisiana,10,68,53,0.7794117647058824,Other or type unknown,15
97199344,1,"Buffalo-Niagara Falls, NY",14,66,51,0.7727272727272727,Rifle,15
45375391,1,Rural New York,10,64,49,0.765625,Other or type unknown,15
51907097,2,"San Diego-Carlsbad-San Marcos, CA",5,63,48,0.7619047619047619,"Firearm, type not stated",15
53893522,2,"Allentown-Bethlehem-Easton, PA-NJ",7,63,48,0.7619047619047619,Knife or cutting instrument,15
79844206,2,"Beaumont-Port Arthur, TX",7,63,48,0.7619047619047619,Knife or cutting instrument,15
96096791,2,Rural Arkansas,1,59,44,0.7457627118644068,"Blunt object - hammer, club, etc",15
82764666,2,"Milwaukee-Waukesha-West Allis, WI",1,49,34,0.6938775510204082,"Blunt object - hammer, club, etc",15
43933816,2,"Seattle-Tacoma-Bellevue, WA",0,48,33,0.6875,Asphyxiation - includes death by gas,15
72298036,1,"Williamsport, PA",6,46,31,0.6739130434782609,"Handgun - pistol, revolver, etc",15
77936539,2,"Montgomery, AL",11,44,29,0.6590909090909091,"Personal weapons, includes beating",15
73553945,2,"Jackson, MS",1,42,27,0.6428571428571429,"Blunt object - hammer, club, etc",15
15155026,2,"Honolulu, HI",10,40,25,0.625,Other or type unknown,15
50074433,1,"Honolulu, HI",10,38,23,0.6052631578947368,Other or type unknown,15
76559164,2,"McAllen-Edinburg-Mission, TX",10,37,22,0.5945945945945946,Other or type unknown,15
17073951,2,"Cincinnati-Middletown, OH-KY-IN",16,36,21,0.5833333333333334,Strangulation - hanging,15
41605001,2,"Stockton, CA",1,36,21,0.5833333333333334,"Blunt object - hammer, club, etc",15
71228829,2,"Jackson, MS",10,35,20,0.5714285714285714,Other or type unknown,15
26336360,1,"Monroe, LA",5,32,17,0.53125,"Firearm, type not stated",15
39177135,2,"Lafayette, LA",10,32,17,0.53125,Other or type unknown,15
39711791,2,"Austin-Round Rock, TX",16,32,17,0.53125,Strangulation - hanging,15
12705533,2,"Fort Wayne, IN",5,31,16,0.5161290322580645,"Firearm, type not stated",15
24828664,2,"Milwaukee-Waukesha-West Allis, WI",16,31,16,0.5161290322580645,Strangulation - hanging,15
29273897,1,"New Orleans-Metairie-Kenner, LA",16,30,15,0.5,Strangulation - hanging,15
74553799,1,"Syracuse, NY",5,29,14,0.4827586206896552,"Firearm, type not stated",15
1066451,1,"Madera, CA",5,24,9,0.375,"Firearm, type not stated",15
72736105,2,"Hartford, CT",16,23,8,0.34782608695652173,Strangulation - hanging,15
54145251,2,"Salt Lake City, UT",16,20,5,0.25,Strangulation - hanging,15
72699298,1,Rural Louisiana,7,332,318,0.9578313253012049,Knife or cutting instrument,14
56656337,2,"Charleston-North Charleston, SC",6,224,210,0.9375,"Handgun - pistol, revolver, etc",14
93132706,1,Rural Iowa,6,162,148,0.9135802469135802,"Handgun - pistol, revolver, etc",14
15455769,1,"College Station-Bryan, TX",6,150,136,0.9066666666666666,"Handgun - pistol, revolver, etc",14
87255686,1,"Kansas City, MO-KS",11,139,125,0.8992805755395683,"Personal weapons, includes beating",14
90047469,2,"Wichita, KS",6,139,125,0.8992805755395683,"Handgun - pistol, revolver, etc",14
64044160,1,"Savannah, GA",7,129,115,0.8914728682170543,Knife or cutting instrument,14
6427592,1,"Grand Rapids-Wyoming, MI",7,128,114,0.890625,Knife or cutting instrument,14
42297245,1,"Pascagoula, MS",6,126,112,0.8888888888888888,"Handgun - pistol, revolver, etc",14
37380194,1,"Louisville, KY-IN",11,119,105,0.8823529411764706,"Personal weapons, includes beating",14
38347980,1,"Cape Coral-Fort Myers, FL",7,119,105,0.8823529411764706,Knife or cutting instrument,14
84618972,1,"Santa Barbara-Santa Maria, CA",7,118,104,0.8813559322033898,Knife or cutting instrument,14
10368684,1,"Hot Springs, AR",6,116,102,0.8793103448275862,"Handgun - pistol, revolver, etc",14
94942373,1,"Sarasota-Bradenton-Venice, FL",7,115,101,0.8782608695652174,Knife or cutting instrument,14
19998169,1,"Peoria, IL",6,108,94,0.8703703703703703,"Handgun - pistol, revolver, etc",14
24025044,1,"Deltona-Daytona Beach-Ormond Beach, FL",7,103,89,0.8640776699029126,Knife or cutting instrument,14
68333715,2,"Anchorage, AK",6,100,86,0.86,"Handgun - pistol, revolver, etc",14
4725431,1,"Santa Fe, NM",7,89,75,0.8426966292134831,Knife or cutting instrument,14
82666123,1,"Providence-New Bedford-Fall River, RI-MA",1,89,75,0.8426966292134831,"Blunt object - hammer, club, etc",14
7817766,1,"Longview, TX",7,87,73,0.8390804597701149,Knife or cutting instrument,14
1301459,1,"Rochester, NY",11,82,68,0.8292682926829268,"Personal weapons, includes beating",14
93650147,1,"Fort Wayne, IN",7,81,67,0.8271604938271605,Knife or cutting instrument,14
60402350,1,"Gainesville, GA",6,80,66,0.825,"Handgun - pistol, revolver, etc",14
8458652,1,"Odessa, TX",7,77,63,0.8181818181818182,Knife or cutting instrument,14
25203942,1,Rural Kansas,10,75,61,0.8133333333333334,Other or type unknown,14
64439719,2,Rural California,7,75,61,0.8133333333333334,Knife or cutting instrument,14
73941665,2,"Memphis, TN-MS-AR",1,69,55,0.7971014492753623,"Blunt object - hammer, club, etc",14
41011852,1,Rural Oregon,1,68,54,0.7941176470588235,"Blunt object - hammer, club, etc",14
47816691,2,Rural Oregon,7,64,50,0.78125,Knife or cutting instrument,14
30356291,2,Rural Ohio,10,63,49,0.7777777777777778,Other or type unknown,14
61009581,1,"Anderson, IN",6,62,48,0.7741935483870968,"Handgun - pistol, revolver, etc",14
64138130,2,"Greenville, SC",10,62,48,0.7741935483870968,Other or type unknown,14
16375742,2,"Trenton-Ewing, NJ",7,61,47,0.7704918032786885,Knife or cutting instrument,14
7207540,2,"Nashville-Davidson-Murfreesboro, TN",1,60,46,0.7666666666666667,"Blunt object - hammer, club, etc",14
33719118,2,"Vallejo-Fairfield, CA",7,59,45,0.7627118644067796,Knife or cutting instrument,14
83272585,1,"Des Moines, IA",5,59,45,0.7627118644067796,"Firearm, type not stated",14
4611379,1,"Toledo, OH",1,58,44,0.7586206896551724,"Blunt object - hammer, club, etc",14
26805429,1,"Los Angeles-Long Beach, CA",8,58,44,0.7586206896551724,"Narcotics or drugs, sleeping pills",14
81096231,2,"Oklahoma City, OK",1,57,43,0.7543859649122807,"Blunt object - hammer, club, etc",14
8988414,1,"Cedar Rapids, IA",6,53,39,0.7358490566037735,"Handgun - pistol, revolver, etc",14
29326481,2,"Houston-Sugar Land-Baytown, TX",4,53,39,0.7358490566037735,Fire,14
47461819,2,"Louisville, KY-IN",1,53,39,0.7358490566037735,"Blunt object - hammer, club, etc",14
26930956,1,"Huntington-Ashland, WV-KY-OH",5,49,35,0.7142857142857143,"Firearm, type not stated",14
41279021,1,"Washington-Arlington-Alexandria, DC-VA-MD-WV",0,48,34,0.7083333333333334,Asphyxiation - includes death by gas,14
93819425,1,"Kalamazoo-Portage, MI",10,48,34,0.7083333333333334,Other or type unknown,14
18025641,1,Rural North Carolina,4,47,33,0.7021276595744681,Fire,14
26075316,1,"Omaha-Council Bluffs, NE-IA",5,46,32,0.6956521739130435,"Firearm, type not stated",14
31450128,2,"Richmond, VA",1,46,32,0.6956521739130435,"Blunt object - hammer, club, etc",14
38040895,2,"Oklahoma City, OK",5,46,32,0.6956521739130435,"Firearm, type not stated",14
3489483,1,"Spartanburg, SC",5,45,31,0.6888888888888889,"Firearm, type not stated",14
10030287,2,Rural New York,10,45,31,0.6888888888888889,Other or type unknown,14
20954463,2,"South Bend-Mishawaka, IN-MI",7,45,31,0.6888888888888889,Knife or cutting instrument,14
41892824,1,"Mobile, AL",1,45,31,0.6888888888888889,"Blunt object - hammer, club, etc",14
39224535,2,"Baltimore-Towson, MD",0,44,30,0.6818181818181818,Asphyxiation - includes death by gas,14
51735722,2,"San Francisco-Oakland-Fremont, CA",0,42,28,0.6666666666666666,Asphyxiation - includes death by gas,14
31010586,2,Rural Louisiana,5,41,27,0.6585365853658537,"Firearm, type not stated",14
54052374,1,"Bridgeport-Stamford-Norwalk, CT",15,38,24,0.631578947368421,Shotgun,14
17109735,2,"Kansas City, MO-KS",4,37,23,0.6216216216216216,Fire,14
5566444,1,"Killeen-Temple-Fort Hood, TX",10,36,22,0.6111111111111112,Other or type unknown,14
48584690,2,"Dayton, OH",1,36,22,0.6111111111111112,"Blunt object - hammer, club, etc",14
7683381,2,"Hartford, CT",5,35,21,0.6,"Firearm, type not stated",14
43738587,1,Rural Hawaii,10,35,21,0.6,Other or type unknown,14
24507331,1,"Sumter, SC",5,34,20,0.5882352941176471,"Firearm, type not stated",14
97246797,1,"Tampa-St. Petersburg-Clearwater, FL",4,34,20,0.5882352941176471,Fire,14
20140686,2,Rural California,16,33,19,0.5757575757575758,Strangulation - hanging,14
40358032,2,"Reno-Sparks, NV",10,32,18,0.5625,Other or type unknown,14
7014048,1,"Seattle-Tacoma-Bellevue, WA",4,31,17,0.5483870967741935,Fire,14
83847364,1,"Champaign-Urbana, IL",5,31,17,0.5483870967741935,"Firearm, type not stated",14
12356454,1,"Pine Bluff, AR",10,29,15,0.5172413793103449,Other or type unknown,14
21436037,1,"Modesto, CA",10,28,14,0.5,Other or type unknown,14
37587032,2,"Indianapolis, IN",4,23,9,0.391304347826087,Fire,14
76148068,2,"Colorado Springs, CO",16,22,8,0.36363636363636365,Strangulation - hanging,14
67587147,1,"Jacksonville, FL",9,21,7,0.3333333333333333,Other gun,14
81763319,9,"San Antonio, TX",10,18,4,0.2222222222222222,Other or type unknown,14
1461597,2,Rural North Carolina,17,14,0,0.0,Weapon Not Reported,14
87772767,1,"Riverside-San Bernardino, CA",17,14,0,0.0,Weapon Not Reported,14
51560180,2,Rural Virginia,6,345,332,0.9623188405797102,"Handgun - pistol, revolver, etc",13
31285983,1,Rural Texas,11,232,219,0.9439655172413793,"Personal weapons, includes beating",13
11560029,1,Rural South Carolina,14,186,173,0.9301075268817204,Rifle,13
43295195,1,Rural Mississippi,14,185,172,0.9297297297297298,Rifle,13
5819166,2,"Raleigh-Cary, NC",6,179,166,0.9273743016759777,"Handgun - pistol, revolver, etc",13
60078,1,Rural Michigan,7,140,127,0.9071428571428571,Knife or cutting instrument,13
9205697,2,Rural Arizona,6,137,124,0.9051094890510949,"Handgun - pistol, revolver, etc",13
4857008,2,Rural New Mexico,6,135,122,0.9037037037037037,"Handgun - pistol, revolver, etc",13
1033428,2,"Lakeland, FL",6,132,119,0.9015151515151515,"Handgun - pistol, revolver, etc",13
21408410,1,"Tulsa, OK",15,129,116,0.8992248062015504,Shotgun,13
1374646,1,Rural Ohio,15,118,105,0.8898305084745762,Shotgun,13
5636600,1,Rural Pennsylvania,15,117,104,0.8888888888888888,Shotgun,13
67337264,1,"Denver-Aurora, CO",15,116,103,0.8879310344827587,Shotgun,13
93224055,2,Rural Tennessee,7,114,101,0.8859649122807017,Knife or cutting instrument,13
81296484,1,"Worcester, MA",7,111,98,0.8828828828828829,Knife or cutting instrument,13
16448244,1,"Milwaukee-Waukesha-West Allis, WI",1,109,96,0.8807339449541285,"Blunt object - hammer, club, etc",13
50200388,1,Rural Alaska,7,106,93,0.8773584905660378,Knife or cutting instrument,13
16317148,1,"Greeley, CO",6,103,90,0.8737864077669902,"Handgun - pistol, revolver, etc",13
19170998,1,"Spokane, WA",7,102,89,0.8725490196078431,Knife or cutting instrument,13
92479891,1,"Amarillo, TX",7,100,87,0.87,Knife or cutting instrument,13
81700687,1,"Muskegon-Norton Shores, MI",6,98,85,0.8673469387755102,"Handgun - pistol, revolver, etc",13
72433143,2,"Little Rock-North Little Rock, AR",7,97,84,0.865979381443299,Knife or cutting instrument,13
18775365,1,"Tallahassee, FL",7,93,80,0.8602150537634409,Knife or cutting instrument,13
38952251,1,Rural Arkansas,1,93,80,0.8602150537634409,"Blunt object - hammer, club, etc",13
64568080,2,"Visalia-Porterville, CA",6,92,79,0.8586956521739131,"Handgun - pistol, revolver, etc",13
85046643,1,"Milwaukee-Waukesha-West Allis, WI",14,92,79,0.8586956521739131,Rifle,13
78997061,1,Rural Hawaii,6,91,78,0.8571428571428571,"Handgun - pistol, revolver, etc",13
44094063,1,"Palm Bay-Melbourne-Titusville, FL",7,89,76,0.8539325842696629,Knife or cutting instrument,13
57509281,1,Rural Kansas,5,89,76,0.8539325842696629,"Firearm, type not stated",13
66107974,2,"Saginaw, MI",6,86,73,0.8488372093023255,"Handgun - pistol, revolver, etc",13
3651974,2,"Huntsville, AL",6,85,72,0.8470588235294118,"Handgun - pistol, revolver, etc",13
99522438,2,Rural North Carolina,1,85,72,0.8470588235294118,"Blunt object - hammer, club, etc",13
15044054,1,Rural Virginia,1,82,69,0.8414634146341463,"Blunt object - hammer, club, etc",13
51725394,2,Rural Georgia,11,79,66,0.8354430379746836,"Personal weapons, includes beating",13
63338205,2,Rural Michigan,7,79,66,0.8354430379746836,Knife or cutting instrument,13
64029972,1,"Baton Rouge, LA",1,78,65,0.8333333333333334,"Blunt object - hammer, club, etc",13
40204925,2,"Albany-Schenectady-Troy, NY",7,74,61,0.8243243243243243,Knife or cutting instrument,13
58044032,2,"Corpus Christi, TX",7,72,59,0.8194444444444444,Knife or cutting instrument,13
61173973,1,"Cincinnati-Middletown, OH-KY-IN",14,68,55,0.8088235294117647,Rifle,13
55682466,1,"Jackson, MS",14,67,54,0.8059701492537313,Rifle,13
57536922,1,"Savannah, GA",15,66,53,0.803030303030303,Shotgun,13
37967553,1,"Fort Walton Beach-Destin, FL",6,64,51,0.796875,"Handgun - pistol, revolver, etc",13
91653313,1,Rural Minnesota,10,64,51,0.796875,Other or type unknown,13
27555641,2,"Indianapolis, IN",14,62,49,0.7903225806451613,Rifle,13
72152307,2,"Colorado Springs, CO",10,61,48,0.7868852459016393,Other or type unknown,13
78496031,2,"Deltona-Daytona Beach-Ormond Beach, FL",5,61,48,0.7868852459016393,"Firearm, type not stated",13
54486375,2,"New Haven-Milford, CT",11,60,47,0.7833333333333333,"Personal weapons, includes beating",13
40809782,2,"Cape Coral-Fort Myers, FL",5,58,45,0.7758620689655172,"Firearm, type not stated",13
65841045,1,"Rochester, NY",1,57,44,0.7719298245614035,"Blunt object - hammer, club, etc",13
84116873,2,"El Paso, TX",7,57,44,0.7719298245614035,Knife or cutting instrument,13
41168205,1,"Pittsburgh, PA",9,56,43,0.7678571428571429,Other gun,13
54197283,1,"Hartford, CT",10,55,42,0.7636363636363637,Other or type unknown,13
91451337,1,"Charleston, WV",10,55,42,0.7636363636363637,Other or type unknown,13
36028368,2,"Montgomery, AL",7,54,41,0.7592592592592593,Knife or cutting instrument,13
11417150,1,"Modesto, CA",1,53,40,0.7547169811320755,"Blunt object - hammer, club, etc",13
27776189,2,"Dallas-Fort Worth-Arlington, TX",4,53,40,0.7547169811320755,Fire,13
41386357,2,"Jackson, MS",11,53,40,0.7547169811320755,"Personal weapons, includes beating",13
57126292,2,"Atlantic City, NJ",7,52,39,0.75,Knife or cutting instrument,13
66340188,1,"Huntsville, AL",5,52,39,0.75,"Firearm, type not stated",13
85688682,1,Rural Pennsylvania,1,48,35,0.7291666666666666,"Blunt object - hammer, club, etc",13
55404052,2,"Killeen-Temple-Fort Hood, TX",7,45,32,0.7111111111111111,Knife or cutting instrument,13
68525209,1,"Pensacola-Ferry Pass-Brent, FL",1,45,32,0.7111111111111111,"Blunt object - hammer, club, etc",13
65058079,1,"Athens-Clarke County, GA",5,44,31,0.7045454545454546,"Firearm, type not stated",13
3925343,2,"Charlotte-Gastonia-Concord, NC-SC",5,43,30,0.6976744186046512,"Firearm, type not stated",13
30449478,1,"Rockford, IL",10,42,29,0.6904761904761905,Other or type unknown,13
54860381,1,"Portland-Vancouver-Beaverton, OR-WA",16,41,28,0.6829268292682927,Strangulation - hanging,13
37054132,1,"Seattle-Tacoma-Bellevue, WA",9,40,27,0.675,Other gun,13
78790296,1,"Greenville, NC",10,40,27,0.675,Other or type unknown,13
87356519,2,"Chattanooga, TN-GA",5,40,27,0.675,"Firearm, type not stated",13
71455374,1,"Visalia-Porterville, CA",10,39,26,0.6666666666666666,Other or type unknown,13
45615383,2,Rural Indiana,10,37,24,0.6486486486486487,Other or type unknown,13
55811185,2,"Bridgeport-Stamford-Norwalk, CT",10,37,24,0.6486486486486487,Other or type unknown,13
27803746,2,"Allentown-Bethlehem-Easton, PA-NJ",10,36,23,0.6388888888888888,Other or type unknown,13
49885814,2,"Minneapolis-St. Paul-Bloomington, MN-WI",16,36,23,0.6388888888888888,Strangulation - hanging,13
50333276,1,"Rocky Mount, NC",5,36,23,0.6388888888888888,"Firearm, type not stated",13
52875659,1,"Wilmington, NC",9,35,22,0.6285714285714286,Other gun,13
92509282,2,"Durham, NC",10,35,22,0.6285714285714286,Other or type unknown,13
45840177,2,"Minneapolis-St. Paul-Bloomington, MN-WI",4,34,21,0.6176470588235294,Fire,13
7218946,1,"Savannah, GA",1,33,20,0.6060606060606061,"Blunt object - hammer, club, etc",13
92726534,1,"Minneapolis-St. Paul-Bloomington, MN-WI",4,32,19,0.59375,Fire,13
93925537,1,"Utica-Rome, NY",5,32,19,0.59375,"Firearm, type not stated",13
85792990,1,"Philadelphia-Camden-Wilmington, PA-NJ-DE",9,30,17,0.5666666666666667,Other gun,13
94258393,2,"Stockton, CA",10,30,17,0.5666666666666667,Other or type unknown,13
12365597,2,"Lansing-East Lansing, MI",5,25,12,0.48,"Firearm, type not stated",13
29322120,1,"Phoenix-Mesa-Scottsdale, AZ",0,25,12,0.48,Asphyxiation - includes death by gas,13
58652678,2,"Tallahassee, FL",10,25,12,0.48,Other or type unknown,13
40455334,1,"Cleveland-Elyria-Mentor, OH",9,23,10,0.43478260869565216,Other gun,13
97626712,1,"Indianapolis, IN",16,23,10,0.43478260869565216,Strangulation - hanging,13
87691843,1,"Columbus, OH",4,20,7,0.35,Fire,13
91467989,2,"Nashville-Davidson-Murfreesboro, TN",16,18,5,0.2777777777777778,Strangulation - hanging,13
40945010,1,Rural West Virginia,15,222,210,0.9459459459459459,Shotgun,12
62327596,2,Rural Ohio,6,185,173,0.9351351351351351,"Handgun - pistol, revolver, etc",12
59246744,1,Rural West Virginia,14,180,168,0.9333333333333333,Rifle,12
86933856,1,Rural Virginia,14,178,166,0.9325842696629213,Rifle,12
89469328,1,"Boise City-Nampa, ID",6,167,155,0.9281437125748503,"Handgun - pistol, revolver, etc",12
20897664,2,"Salt Lake City, UT",6,166,154,0.927710843373494,"Handgun - pistol, revolver, etc",12
40209338,1,Rural West Virginia,7,164,152,0.926829268292683,Knife or cutting instrument,12
68436285,2,Rural Michigan,6,145,133,0.9172413793103448,"Handgun - pistol, revolver, etc",12
80781919,1,"Charlottesville, VA",6,142,130,0.9154929577464789,"Handgun - pistol, revolver, etc",12
5733938,1,"Panama City-Lynn Haven, FL",6,131,119,0.9083969465648855,"Handgun - pistol, revolver, etc",12
80545139,1,"Portland-Vancouver-Beaverton, OR-WA",11,126,114,0.9047619047619048,"Personal weapons, includes beating",12
91059031,1,"Kennewick-Richland-Pasco, WA",6,126,114,0.9047619047619048,"Handgun - pistol, revolver, etc",12
30409477,1,"Rome, GA",6,121,109,0.9008264462809917,"Handgun - pistol, revolver, etc",12
75539561,2,"Austin-Round Rock, TX",7,120,108,0.9,Knife or cutting instrument,12
37452404,2,"Roanoke, VA",6,119,107,0.8991596638655462,"Handgun - pistol, revolver, etc",12
17058346,1,"Akron, OH",7,113,101,0.8938053097345132,Knife or cutting instrument,12
73234713,1,"Brownsville-Harlingen, TX",7,111,99,0.8918918918918919,Knife or cutting instrument,12
84306444,1,"Jackson, MS",15,111,99,0.8918918918918919,Shotgun,12
88658191,1,"Hattiesburg, MS",6,109,97,0.8899082568807339,"Handgun - pistol, revolver, etc",12
60215242,2,"Akron, OH",6,108,96,0.8888888888888888,"Handgun - pistol, revolver, etc",12
554443,2,"St. Louis, MO-IL",15,105,93,0.8857142857142857,Shotgun,12
65125304,1,Rural Tennessee,1,99,87,0.8787878787878788,"Blunt object - hammer, club, etc",12
57122677,1,Rural Indiana,7,98,86,0.8775510204081632,Knife or cutting instrument,12
19258729,1,"Greensboro-High Point, NC",14,91,79,0.8681318681318682,Rifle,12
81576213,1,Rural California,11,91,79,0.8681318681318682,"Personal weapons, includes beating",12
1383818,1,"Cincinnati-Middletown, OH-KY-IN",15,90,78,0.8666666666666667,Shotgun,12
7273337,1,"Richmond, VA",11,89,77,0.8651685393258427,"Personal weapons, includes beating",12
89480303,1,Rural Oregon,10,88,76,0.8636363636363636,Other or type unknown,12
26292991,2,"Asheville, NC",6,84,72,0.8571428571428571,"Handgun - pistol, revolver, etc",12
1187615,2,"Grand Rapids-Wyoming, MI",6,82,70,0.8536585365853658,"Handgun - pistol, revolver, etc",12
22330930,1,"Des Moines, IA",7,81,69,0.8518518518518519,Knife or cutting instrument,12
42528783,2,"Shreveport-Bossier City, LA",7,81,69,0.8518518518518519,Knife or cutting instrument,12
33217964,2,"Portland-Vancouver-Beaverton, OR-WA",11,77,65,0.8441558441558441,"Personal weapons, includes beating",12
97156283,1,Rural Kentucky,8,76,64,0.8421052631578947,"Narcotics or drugs, sleeping pills",12
20285962,2,"Monroe, LA",6,75,63,0.84,"Handgun - pistol, revolver, etc",12
97732928,2,"Poughkeepsie-Newburgh-Middletown, NY",7,74,62,0.8378378378378378,Knife or cutting instrument,12
78122182,2,Rural Pennsylvania,11,73,61,0.8356164383561644,"Personal weapons, includes beating",12
65606329,2,"Spokane, WA",6,71,59,0.8309859154929577,"Handgun - pistol, revolver, etc",12
25147768,2,Rural Kansas,11,69,57,0.8260869565217391,"Personal weapons, includes beating",12
26110753,2,Rural Kansas,7,69,57,0.8260869565217391,Knife or cutting instrument,12
44420988,1,"Mansfield, OH",6,69,57,0.8260869565217391,"Handgun - pistol, revolver, etc",12
43767214,1,"Reading, PA",7,67,55,0.8208955223880597,Knife or cutting instrument,12
81116395,2,"Kansas City, MO-KS",15,66,54,0.8181818181818182,Shotgun,12
88369811,1,"Grand Rapids-Wyoming, MI",15,64,52,0.8125,Shotgun,12
11496779,1,"Manchester-Nashua, NH",6,63,51,0.8095238095238095,"Handgun - pistol, revolver, etc",12
68400082,1,"Flagstaff, AZ",6,60,48,0.8,"Handgun - pistol, revolver, etc",12
64705207,1,"Victoria, TX",7,59,47,0.7966101694915254,Knife or cutting instrument,12
57765972,1,"Dayton, OH",1,58,46,0.7931034482758621,"Blunt object - hammer, club, etc",12
40623224,2,Rural Kansas,10,57,45,0.7894736842105263,Other or type unknown,12
36320549,2,Rural Mississippi,5,56,44,0.7857142857142857,"Firearm, type not stated",12
7141718,2,Rural Kentucky,1,55,43,0.7818181818181819,"Blunt object - hammer, club, etc",12
47655987,2,"Orlando-Kissimmee, FL",1,55,43,0.7818181818181819,"Blunt object - hammer, club, etc",12
99969253,2,"Rockford, IL",6,53,41,0.7735849056603774,"Handgun - pistol, revolver, etc",12
12988048,2,"Lubbock, TX",7,52,40,0.7692307692307693,Knife or cutting instrument,12
38199559,2,"Wichita, KS",10,52,40,0.7692307692307693,Other or type unknown,12
78764,2,"Albuquerque, NM",1,47,35,0.7446808510638298,"Blunt object - hammer, club, etc",12
17597756,1,"Rocky Mount, NC",10,47,35,0.7446808510638298,Other or type unknown,12
17250563,1,Rural Indiana,5,46,34,0.7391304347826086,"Firearm, type not stated",12
22454384,1,"Atlantic City, NJ",1,46,34,0.7391304347826086,"Blunt object - hammer, club, etc",12
87908945,2,"Chattanooga, TN-GA",10,45,33,0.7333333333333333,Other or type unknown,12
7543820,1,"Allentown-Bethlehem-Easton, PA-NJ",10,44,32,0.7272727272727273,Other or type unknown,12
20995945,1,"Lexington-Fayette, KY",1,44,32,0.7272727272727273,"Blunt object - hammer, club, etc",12
26202709,2,"Huntsville, AL",7,44,32,0.7272727272727273,Knife or cutting instrument,12
21889744,1,"Beaumont-Port Arthur, TX",1,40,28,0.7,"Blunt object - hammer, club, etc",12
67424008,2,Rural Hawaii,7,40,28,0.7,Knife or cutting instrument,12
69520965,1,"Waterloo-Cedar Falls, IA",5,37,25,0.6756756756756757,"Firearm, type not stated",12
93635889,1,"Lexington-Fayette, KY",10,36,24,0.6666666666666666,Other or type unknown,12
34291914,1,"Oxnard-Thousand Oaks-Ventura, CA",10,32,20,0.625,Other or type unknown,12
98747915,2,"Augusta-Richmond County, GA-SC",10,32,20,0.625,Other or type unknown,12
13083398,2,"Stockton, CA",5,31,19,0.6129032258064516,"Firearm, type not stated",12
24928156,1,"Salinas, CA",10,31,19,0.6129032258064516,Other or type unknown,12
43007579,1,"Amarillo, TX",10,31,19,0.6129032258064516,Other or type unknown,12
59940955,2,"Santa Fe, NM",10,31,19,0.6129032258064516,Other or type unknown,12
23276068,1,"Detroit-Warren-Livonia, MI",3,30,18,0.6,Explosives,12
39239692,1,"Lafayette, LA",10,30,18,0.6,Other or type unknown,12
71090114,2,Rural Hawaii,10,30,18,0.6,Other or type unknown,12
19625700,1,"Poughkeepsie-Newburgh-Middletown, NY",10,29,17,0.5862068965517241,Other or type unknown,12
19988060,2,"Providence-New Bedford-Fall River, RI-MA",16,28,16,0.5714285714285714,Strangulation - hanging,12
20196495,2,"Port St. Lucie-Fort Pierce, FL",5,28,16,0.5714285714285714,"Firearm, type not stated",12
50736962,1,"Miami-Fort Lauderdale, FL",0,28,16,0.5714285714285714,Asphyxiation - includes death by gas,12
59774792,2,"Beaumont-Port Arthur, TX",10,28,16,0.5714285714285714,Other or type unknown,12
24993461,2,Rural Alaska,10,27,15,0.5555555555555556,Other or type unknown,12
14517567,2,"Seattle-Tacoma-Bellevue, WA",4,26,14,0.5384615384615384,Fire,12
33866372,1,"Evansville, IN-KY",5,26,14,0.5384615384615384,"Firearm, type not stated",12
1303202,1,"Youngstown-Warren-Boardman, OH-PA",9,24,12,0.5,Other gun,12
23443707,1,"Mansfield, OH",5,24,12,0.5,"Firearm, type not stated",12
54952064,2,"Dallas-Fort Worth-Arlington, TX",9,23,11,0.4782608695652174,Other gun,12
3313815,1,"Erie, PA",5,22,10,0.45454545454545453,"Firearm, type not stated",12
43097143,1,"Virginia Beach-Norfolk-Newport News, VA-NC",9,22,10,0.45454545454545453,Other gun,12
20860408,1,"Los Angeles-Long Beach, CA",3,21,9,0.42857142857142855,Explosives,12
64326061,1,Rural Ohio,4,21,9,0.42857142857142855,Fire,12
38158547,1,"Bakersfield, CA",16,20,8,0.4,Strangulation - hanging,12
47095007,2,"Little Rock-North Little Rock, AR",16,20,8,0.4,Strangulation - hanging,12
93682430,1,"Lexington-Fayette, KY",8,19,7,0.3684210526315789,"Narcotics or drugs, sleeping pills",12
33027860,2,"Richmond, VA",16,18,6,0.3333333333333333,Strangulation - hanging,12
4710521,1,"San Antonio, TX",4,17,5,0.29411764705882354,Fire,12
66680888,9,"Miami-Fort Lauderdale, FL",5,16,4,0.25,"Firearm, type not stated",12
51932445,1,"San Francisco-Oakland-Fremont, CA",9,14,2,0.14285714285714285,Other gun,12
1311668,1,"Atlanta-Sandy Springs-Marietta, GA",17,12,0,0.0,Weapon Not Reported,12
47626307,2,"Dallas-Fort Worth-Arlington, TX",17,12,0,0.0,Weapon Not Reported,12
92735310,1,Rural North Carolina,17,12,0,0.0,Weapon Not Reported,12
69037196,1,"Columbia, SC",7,276,265,0.9601449275362319,Knife or cutting instrument,11
56355467,1,"Salem, OR",6,176,165,0.9375,"Handgun - pistol, revolver, etc",11
58679794,1,Rural Missouri,15,171,160,0.935672514619883,Shotgun,11
78547372,1,Rural Oregon,7,145,134,0.9241379310344827,Knife or cutting instrument,11
87115276,2,"Corpus Christi, TX",6,137,126,0.9197080291970803,"Handgun - pistol, revolver, etc",11
36608900,1,Rural Florida,15,127,116,0.9133858267716536,Shotgun,11
85762763,2,"New Haven-Milford, CT",6,125,114,0.912,"Handgun - pistol, revolver, etc",11
79539456,1,"Madison, WI",6,119,108,0.907563025210084,"Handgun - pistol, revolver, etc",11
58219287,1,"Austin-Round Rock, TX",15,114,103,0.9035087719298246,Shotgun,11
82570590,2,Rural Virginia,7,113,102,0.9026548672566371,Knife or cutting instrument,11
26192962,1,"Wichita, KS",7,110,99,0.9,Knife or cutting instrument,11
64659762,2,"Charlotte-Gastonia-Concord, NC-SC",11,110,99,0.9,"Personal weapons, includes beating",11
50663864,2,Rural Kansas,6,108,97,0.8981481481481481,"Handgun - pistol, revolver, etc",11
32321197,1,Rural Michigan,11,105,94,0.8952380952380953,"Personal weapons, includes beating",11
83062478,2,Rural Tennessee,5,103,92,0.8932038834951457,"Firearm, type not stated",11
26539673,2,"Richmond, VA",11,101,90,0.8910891089108911,"Personal weapons, includes beating",11
79243530,1,Rural Illinois,7,97,86,0.8865979381443299,Knife or cutting instrument,11
9679019,2,"Baltimore-Towson, MD",15,93,82,0.8817204301075269,Shotgun,11
44425058,1,"Toledo, OH",11,92,81,0.8804347826086957,"Personal weapons, includes beating",11
60340225,1,"Lexington-Fayette, KY",7,90,79,0.8777777777777778,Knife or cutting instrument,11
67251001,1,"Tucson, AZ",11,90,79,0.8777777777777778,"Personal weapons, includes beating",11
28168754,1,Rural Wisconsin,10,88,77,0.875,Other or type unknown,11
75250652,2,Rural Ohio,7,88,77,0.875,Knife or cutting instrument,11
35036664,2,"Phoenix-Mesa-Scottsdale, AZ",14,86,75,0.872093023255814,Rifle,11
85544714,2,"San Jose-Sunnyvale-Santa Clara, CA",11,84,73,0.8690476190476191,"Personal weapons, includes beating",11
74248743,2,"Austin-Round Rock, TX",11,79,68,0.8607594936708861,"Personal weapons, includes beating",11
24026791,2,Rural Wisconsin,10,76,65,0.8552631578947368,Other or type unknown,11
35052665,2,Rural Alaska,6,75,64,0.8533333333333334,"Handgun - pistol, revolver, etc",11
90786724,2,Rural Mississippi,1,72,61,0.8472222222222222,"Blunt object - hammer, club, etc",11
51015098,1,"Rockford, IL",7,71,60,0.8450704225352113,Knife or cutting instrument,11
32295355,2,"Worcester, MA",7,68,57,0.8382352941176471,Knife or cutting instrument,11
41993324,1,"Springfield, MO",7,67,56,0.835820895522388,Knife or cutting instrument,11
56972402,2,"Akron, OH",7,67,56,0.835820895522388,Knife or cutting instrument,11
51905895,2,Rural Indiana,7,66,55,0.8333333333333334,Knife or cutting instrument,11
16592487,1,"Scranton--Wilkes-Barre, PA",7,65,54,0.8307692307692308,Knife or cutting instrument,11
23556742,2,"San Francisco-Oakland-Fremont, CA",15,65,54,0.8307692307692308,Shotgun,11
53840820,2,"Hartford, CT",11,65,54,0.8307692307692308,"Personal weapons, includes beating",11
5833363,2,"New Haven-Milford, CT",5,64,53,0.828125,"Firearm, type not stated",11
69493810,1,"Laredo, TX",7,63,52,0.8253968253968254,Knife or cutting instrument,11
79486614,2,"Knoxville, TN",7,63,52,0.8253968253968254,Knife or cutting instrument,11
97485178,1,"Mobile, AL",14,63,52,0.8253968253968254,Rifle,11
26538974,1,"Scranton--Wilkes-Barre, PA",10,62,51,0.8225806451612904,Other or type unknown,11
2373959,1,"Jacksonville, NC",6,61,50,0.819672131147541,"Handgun - pistol, revolver, etc",11
39404749,2,"Charlotte-Gastonia-Concord, NC-SC",14,61,50,0.819672131147541,Rifle,11
74729386,1,"Charleston-North Charleston, SC",10,61,50,0.819672131147541,Other or type unknown,11
62958730,1,"Jackson, MI",6,60,49,0.8166666666666667,"Handgun - pistol, revolver, etc",11
19699775,1,Rural Ohio,1,59,48,0.8135593220338984,"Blunt object - hammer, club, etc",11
66497802,1,"Hartford, CT",15,54,43,0.7962962962962963,Shotgun,11
47767462,2,Rural Georgia,1,52,41,0.7884615384615384,"Blunt object - hammer, club, etc",11
20962577,2,"Stockton, CA",11,50,39,0.78,"Personal weapons, includes beating",11
22915058,2,"Cincinnati-Middletown, OH-KY-IN",1,50,39,0.78,"Blunt object - hammer, club, etc",11
11277666,1,"Chattanooga, TN-GA",1,49,38,0.7755102040816326,"Blunt object - hammer, club, etc",11
30142244,2,Rural Oklahoma,1,49,38,0.7755102040816326,"Blunt object - hammer, club, etc",11
61572740,1,"Farmington, NM",7,49,38,0.7755102040816326,Knife or cutting instrument,11
93252632,2,"Winston-Salem, NC",10,48,37,0.7708333333333334,Other or type unknown,11
75237024,2,Rural Arizona,7,47,36,0.7659574468085106,Knife or cutting instrument,11
14695231,1,"Trenton-Ewing, NJ",1,46,35,0.7608695652173914,"Blunt object - hammer, club, etc",11
19072709,2,"Fayetteville, NC",11,46,35,0.7608695652173914,"Personal weapons, includes beating",11
31503183,1,"Anchorage, AK",10,46,35,0.7608695652173914,Other or type unknown,11
32110460,1,"Providence-New Bedford-Fall River, RI-MA",15,46,35,0.7608695652173914,Shotgun,11
39202438,2,"Fort Wayne, IN",7,46,35,0.7608695652173914,Knife or cutting instrument,11
74075432,1,"Detroit-Warren-Livonia, MI",8,46,35,0.7608695652173914,"Narcotics or drugs, sleeping pills",11
80294159,2,"Flint, MI",11,46,35,0.7608695652173914,"Personal weapons, includes beating",11
27849880,2,"Anchorage, AK",7,45,34,0.7555555555555555,Knife or cutting instrument,11
92760769,2,"Providence-New Bedford-Fall River, RI-MA",5,45,34,0.7555555555555555,"Firearm, type not stated",11
12761324,1,Rural Iowa,5,43,32,0.7441860465116279,"Firearm, type not stated",11
22671815,2,"Baton Rouge, LA",1,43,32,0.7441860465116279,"Blunt object - hammer, club, etc",11
85318798,2,"Reno-Sparks, NV",7,41,30,0.7317073170731707,Knife or cutting instrument,11
31745095,1,"Hickory-Lenoir-Morganton, NC",9,39,28,0.717948717948718,Other gun,11
66026084,1,"Tuscaloosa, AL",10,39,28,0.717948717948718,Other or type unknown,11
95958204,1,"Saginaw, MI",14,38,27,0.7105263157894737,Rifle,11
59447077,2,"Greensboro-High Point, NC",5,37,26,0.7027027027027027,"Firearm, type not stated",11
93115129,2,Rural Arizona,1,36,25,0.6944444444444444,"Blunt object - hammer, club, etc",11
80256206,1,"Memphis, TN-MS-AR",9,33,22,0.6666666666666666,Other gun,11
82852502,2,"Riverside-San Bernardino, CA",4,33,22,0.6666666666666666,Fire,11
26980336,2,"Pensacola-Ferry Pass-Brent, FL",10,32,21,0.65625,Other or type unknown,11
26984386,1,"Kansas City, MO-KS",0,32,21,0.65625,Asphyxiation - includes death by gas,11
30301443,2,"Harrisburg-Carlisle, PA",11,32,21,0.65625,"Personal weapons, includes beating",11
67006768,1,"Houston-Sugar Land-Baytown, TX",9,32,21,0.65625,Other gun,11
92504522,1,"Alexandria, LA",10,32,21,0.65625,Other or type unknown,11
26909111,1,"Myrtle Beach-Conway, SC",10,31,20,0.6451612903225806,Other or type unknown,11
50176752,2,"Wilmington, NC",10,31,20,0.6451612903225806,Other or type unknown,11
11711292,1,"Santa Rosa-Petaluma, CA",5,30,19,0.6333333333333333,"Firearm, type not stated",11
8189496,1,"Beaumont-Port Arthur, TX",10,29,18,0.6206896551724138,Other or type unknown,11
39156952,1,"Erie, PA",10,27,16,0.5925925925925926,Other or type unknown,11
62378433,2,"Toledo, OH",1,27,16,0.5925925925925926,"Blunt object - hammer, club, etc",11
80408152,2,"Fresno, CA",16,27,16,0.5925925925925926,Strangulation - hanging,11
85957116,1,"Portland-Vancouver-Beaverton, OR-WA",9,27,16,0.5925925925925926,Other gun,11
57251739,1,"Naples-Marco Island, FL",10,26,15,0.5769230769230769,Other or type unknown,11
42015523,1,"Yuba City, CA",5,25,14,0.56,"Firearm, type not stated",11
45446392,2,"Oxnard-Thousand Oaks-Ventura, CA",10,24,13,0.5416666666666666,Other or type unknown,11
19293493,1,"Bridgeport-Stamford-Norwalk, CT",4,23,12,0.5217391304347826,Fire,11
46243811,2,"New Haven-Milford, CT",0,22,11,0.5,Asphyxiation - includes death by gas,11
24799334,2,"Macon, GA",10,21,10,0.47619047619047616,Other or type unknown,11
91182523,1,"Virginia Beach-Norfolk-Newport News, VA-NC",16,21,10,0.47619047619047616,Strangulation - hanging,11
86653688,2,"Columbus, GA-AL",16,20,9,0.45,Strangulation - hanging,11
6987299,1,"Flint, MI",4,18,7,0.3888888888888889,Fire,11
18376087,2,"Rochester, NY",4,18,7,0.3888888888888889,Fire,11
38646666,1,"El Centro, CA",5,18,7,0.3888888888888889,"Firearm, type not stated",11
57205721,1,"Tyler, TX",10,18,7,0.3888888888888889,Other or type unknown,11
81941045,2,"Naples-Marco Island, FL",10,18,7,0.3888888888888889,Other or type unknown,11
60193190,2,"Rochester, NY",16,17,6,0.35294117647058826,Strangulation - hanging,11
71344543,1,"Chico, CA",10,17,6,0.35294117647058826,Other or type unknown,11
61128743,2,"Wichita, KS",16,16,5,0.3125,Strangulation - hanging,11
41613675,1,"Cleveland-Elyria-Mentor, OH",16,15,4,0.26666666666666666,Strangulation - hanging,11
4795037,9,"Seattle-Tacoma-Bellevue, WA",10,14,3,0.21428571428571427,Other or type unknown,11
2649360,2,"St. Louis, MO-IL",17,11,0,0.0,Weapon Not Reported,11
11858748,1,"Cleveland-Elyria-Mentor, OH",17,11,0,0.0,Weapon Not Reported,11
84775391,1,"Springfield, IL",17,11,0,0.0,Weapon Not Reported,11
79782148,1,Rural Louisiana,15,243,233,0.9588477366255144,Shotgun,10
27920845,1,"Texarkana, TX-Texarkana, AR",6,179,169,0.9441340782122905,"Handgun - pistol, revolver, etc",10
52128614,2,Rural Indiana,6,157,147,0.9363057324840764,"Handgun - pistol, revolver, etc",10
95995911,1,Rural Montana,6,152,142,0.9342105263157895,"Handgun - pistol, revolver, etc",10
83233561,1,Rural Pennsylvania,14,147,137,0.9319727891156463,Rifle,10
38981931,1,"Syracuse, NY",7,135,125,0.9259259259259259,Knife or cutting instrument,10
61127243,1,Rural Florida,14,130,120,0.9230769230769231,Rifle,10
60980761,1,Rural South Carolina,1,129,119,0.9224806201550387,"Blunt object - hammer, club, etc",10
73350515,1,"Austin-Round Rock, TX",11,129,119,0.9224806201550387,"Personal weapons, includes beating",10
57104517,1,"Abilene, TX",6,128,118,0.921875,"Handgun - pistol, revolver, etc",10
27508267,1,Rural Nebraska,6,111,101,0.9099099099099099,"Handgun - pistol, revolver, etc",10
26380844,1,"Milwaukee-Waukesha-West Allis, WI",15,110,100,0.9090909090909091,Shotgun,10
26830490,1,"Tampa-St. Petersburg-Clearwater, FL",14,110,100,0.9090909090909091,Rifle,10
68283720,1,"Portland-Vancouver-Beaverton, OR-WA",14,107,97,0.9065420560747663,Rifle,10
70350012,1,"Denver-Aurora, CO",14,107,97,0.9065420560747663,Rifle,10
88615073,1,"Raleigh-Cary, NC",15,107,97,0.9065420560747663,Shotgun,10
85305416,1,"Durham, NC",15,105,95,0.9047619047619048,Shotgun,10
705514,1,"Huntsville, AL",7,103,93,0.9029126213592233,Knife or cutting instrument,10
16366378,2,Rural Kentucky,15,100,90,0.9,Shotgun,10
52224172,1,"Montgomery, AL",15,93,83,0.8924731182795699,Shotgun,10
15190267,2,"Columbia, SC",7,90,80,0.8888888888888888,Knife or cutting instrument,10
50247693,1,"Orlando-Kissimmee, FL",15,89,79,0.8876404494382022,Shotgun,10
54749840,2,Rural New York,7,89,79,0.8876404494382022,Knife or cutting instrument,10
83822075,2,"Nashville-Davidson-Murfreesboro, TN",11,89,79,0.8876404494382022,"Personal weapons, includes beating",10
34730764,2,"Providence-New Bedford-Fall River, RI-MA",6,87,77,0.8850574712643678,"Handgun - pistol, revolver, etc",10
49226460,1,"Michigan City-La Porte, IN",6,85,75,0.8823529411764706,"Handgun - pistol, revolver, etc",10
36690250,1,"Killeen-Temple-Fort Hood, TX",7,83,73,0.8795180722891566,Knife or cutting instrument,10
18575927,2,"Springfield, MA",7,82,72,0.8780487804878049,Knife or cutting instrument,10
16059340,2,"Greenville, SC",7,80,70,0.875,Knife or cutting instrument,10
65115419,1,"Virginia Beach-Norfolk-Newport News, VA-NC",14,80,70,0.875,Rifle,10
88217713,2,"Lafayette, LA",6,79,69,0.8734177215189873,"Handgun - pistol, revolver, etc",10
12633204,1,"Monroe, LA",7,75,65,0.8666666666666667,Knife or cutting instrument,10
53916463,1,Rural Montana,7,75,65,0.8666666666666667,Knife or cutting instrument,10
13149420,1,"Dover, DE",6,73,63,0.863013698630137,"Handgun - pistol, revolver, etc",10
56851879,1,Rural West Virginia,5,69,59,0.855072463768116,"Firearm, type not stated",10
88094373,2,"Nashville-Davidson-Murfreesboro, TN",5,69,59,0.855072463768116,"Firearm, type not stated",10
4884558,1,"Colorado Springs, CO",10,67,57,0.8507462686567164,Other or type unknown,10
85874710,2,"Providence-New Bedford-Fall River, RI-MA",11,66,56,0.8484848484848485,"Personal weapons, includes beating",10
30848644,1,"Winston-Salem, NC",15,65,55,0.8461538461538461,Shotgun,10
33030754,2,"Minneapolis-St. Paul-Bloomington, MN-WI",1,65,55,0.8461538461538461,"Blunt object - hammer, club, etc",10
60922591,2,"Bakersfield, CA",11,65,55,0.8461538461538461,"Personal weapons, includes beating",10
78636832,1,Rural New Mexico,15,63,53,0.8412698412698413,Shotgun,10
15490681,2,"Modesto, CA",7,61,51,0.8360655737704918,Knife or cutting instrument,10
27360714,1,"Corpus Christi, TX",10,61,51,0.8360655737704918,Other or type unknown,10
33077693,2,Rural Minnesota,10,61,51,0.8360655737704918,Other or type unknown,10
45341420,2,"Pine Bluff, AR",6,60,50,0.8333333333333334,"Handgun - pistol, revolver, etc",10
47079197,1,"Flint, MI",11,57,47,0.8245614035087719,"Personal weapons, includes beating",10
93457654,1,"Toledo, OH",15,57,47,0.8245614035087719,Shotgun,10
38765879,2,"York-Hanover, PA",6,56,46,0.8214285714285714,"Handgun - pistol, revolver, etc",10
70895667,2,"Sarasota-Bradenton-Venice, FL",7,56,46,0.8214285714285714,Knife or cutting instrument,10
86345855,2,"Washington-Arlington-Alexandria, DC-VA-MD-WV",4,56,46,0.8214285714285714,Fire,10
70695149,2,Rural Kentucky,5,55,45,0.8181818181818182,"Firearm, type not stated",10
76097163,2,"Charleston-North Charleston, SC",5,55,45,0.8181818181818182,"Firearm, type not stated",10
10218692,1,"Omaha-Council Bluffs, NE-IA",14,53,43,0.8113207547169812,Rifle,10
12451121,1,"Yuma, AZ",10,53,43,0.8113207547169812,Other or type unknown,10
43473643,2,Rural New Mexico,7,50,40,0.8,Knife or cutting instrument,10
86518590,2,"Lansing-East Lansing, MI",7,50,40,0.8,Knife or cutting instrument,10
39212758,1,"Battle Creek, MI",5,49,39,0.7959183673469388,"Firearm, type not stated",10
43876614,2,Rural West Virginia,10,49,39,0.7959183673469388,Other or type unknown,10
59515276,1,"Salt Lake City, UT",1,48,38,0.7916666666666666,"Blunt object - hammer, club, etc",10
43950537,2,"Grand Rapids-Wyoming, MI",11,47,37,0.7872340425531915,"Personal weapons, includes beating",10
83788009,2,"San Jose-Sunnyvale-Santa Clara, CA",1,47,37,0.7872340425531915,"Blunt object - hammer, club, etc",10
50716667,1,"Jackson, MI",5,46,36,0.782608695652174,"Firearm, type not stated",10
58475634,2,"Phoenix-Mesa-Scottsdale, AZ",0,46,36,0.782608695652174,Asphyxiation - includes death by gas,10
96505094,2,"Palm Bay-Melbourne-Titusville, FL",10,46,36,0.782608695652174,Other or type unknown,10
22846137,2,"Spokane, WA",7,44,34,0.7727272727272727,Knife or cutting instrument,10
79857277,2,"Providence-New Bedford-Fall River, RI-MA",1,44,34,0.7727272727272727,"Blunt object - hammer, club, etc",10
60797932,2,"Springfield, MA",6,43,33,0.7674418604651163,"Handgun - pistol, revolver, etc",10
94858627,1,"Yuma, AZ",5,43,33,0.7674418604651163,"Firearm, type not stated",10
540494,2,"Omaha-Council Bluffs, NE-IA",10,42,32,0.7619047619047619,Other or type unknown,10
27090208,2,"Asheville, NC",10,42,32,0.7619047619047619,Other or type unknown,10
73211590,1,Rural Missouri,8,42,32,0.7619047619047619,"Narcotics or drugs, sleeping pills",10
32647158,2,"Yuma, AZ",10,41,31,0.7560975609756098,Other or type unknown,10
33128483,2,Rural Iowa,10,41,31,0.7560975609756098,Other or type unknown,10
61490633,1,"Boise City-Nampa, ID",5,41,31,0.7560975609756098,"Firearm, type not stated",10
91032389,2,"Salt Lake City, UT",5,41,31,0.7560975609756098,"Firearm, type not stated",10
44729212,2,"Tulsa, OK",1,39,29,0.7435897435897436,"Blunt object - hammer, club, etc",10
54614485,1,Rural Washington,10,39,29,0.7435897435897436,Other or type unknown,10
88918765,2,"Palm Bay-Melbourne-Titusville, FL",7,39,29,0.7435897435897436,Knife or cutting instrument,10
22675168,1,"Salinas, CA",14,38,28,0.7368421052631579,Rifle,10
45621720,1,Rural Iowa,10,38,28,0.7368421052631579,Other or type unknown,10
49498771,2,Rural Pennsylvania,1,38,28,0.7368421052631579,"Blunt object - hammer, club, etc",10
14104431,1,"Lebanon, PA",6,37,27,0.7297297297297297,"Handgun - pistol, revolver, etc",10
56343729,1,"Spokane, WA",1,37,27,0.7297297297297297,"Blunt object - hammer, club, etc",10
69296847,1,"York-Hanover, PA",10,37,27,0.7297297297297297,Other or type unknown,10
69796817,1,"Hartford, CT",14,37,27,0.7297297297297297,Rifle,10
16617468,2,"Chattanooga, TN-GA",7,36,26,0.7222222222222222,Knife or cutting instrument,10
25631525,1,"Lakeland, FL",1,36,26,0.7222222222222222,"Blunt object - hammer, club, etc",10
85026654,1,"Racine, WI",7,36,26,0.7222222222222222,Knife or cutting instrument,10
28705804,2,"Lansing-East Lansing, MI",10,35,25,0.7142857142857143,Other or type unknown,10
69893042,2,"Austin-Round Rock, TX",1,35,25,0.7142857142857143,"Blunt object - hammer, club, etc",10
53132672,2,"Portland-Vancouver-Beaverton, OR-WA",0,34,24,0.7058823529411765,Asphyxiation - includes death by gas,10
66490701,2,"Hickory-Lenoir-Morganton, NC",10,34,24,0.7058823529411765,Other or type unknown,10
70107424,2,"El Paso, TX",16,34,24,0.7058823529411765,Strangulation - hanging,10
71907572,1,Rural Kentucky,4,34,24,0.7058823529411765,Fire,10
97635310,1,"Madison, WI",5,34,24,0.7058823529411765,"Firearm, type not stated",10
99274124,1,"Santa Rosa-Petaluma, CA",1,34,24,0.7058823529411765,"Blunt object - hammer, club, etc",10
26531557,1,"Amarillo, TX",1,33,23,0.696969696969697,"Blunt object - hammer, club, etc",10
40590759,1,"Phoenix-Mesa-Scottsdale, AZ",9,32,22,0.6875,Other gun,10
44345744,1,"Dover, DE",5,32,22,0.6875,"Firearm, type not stated",10
56939759,2,"Kansas City, MO-KS",0,32,22,0.6875,Asphyxiation - includes death by gas,10
58196963,1,"Vallejo-Fairfield, CA",1,32,22,0.6875,"Blunt object - hammer, club, etc",10
67872784,1,Rural Hawaii,1,32,22,0.6875,"Blunt object - hammer, club, etc",10
23667749,1,"Yakima, WA",1,30,20,0.6666666666666666,"Blunt object - hammer, club, etc",10
54550061,1,"Waco, TX",1,30,20,0.6666666666666666,"Blunt object - hammer, club, etc",10
68145208,2,Rural Washington,10,30,20,0.6666666666666666,Other or type unknown,10
81507779,1,"Richmond, VA",9,30,20,0.6666666666666666,Other gun,10
66854440,2,"Florence, SC",5,29,19,0.6551724137931034,"Firearm, type not stated",10
85468507,2,"Goldsboro, NC",6,29,19,0.6551724137931034,"Handgun - pistol, revolver, etc",10
16793505,1,"New Orleans-Metairie-Kenner, LA",4,27,17,0.6296296296296297,Fire,10
69106928,2,Rural California,5,27,17,0.6296296296296297,"Firearm, type not stated",10
9226997,2,"Oxnard-Thousand Oaks-Ventura, CA",1,26,16,0.6153846153846154,"Blunt object - hammer, club, etc",10
11756972,2,"Memphis, TN-MS-AR",16,26,16,0.6153846153846154,Strangulation - hanging,10
19155775,1,"Odessa, TX",10,25,15,0.6,Other or type unknown,10
33575444,1,"Indianapolis, IN",4,25,15,0.6,Fire,10
36375475,1,"Goldsboro, NC",5,25,15,0.6,"Firearm, type not stated",10
62647916,1,"Naples-Marco Island, FL",1,25,15,0.6,"Blunt object - hammer, club, etc",10
1502002,2,"Buffalo-Niagara Falls, NY",16,24,14,0.5833333333333334,Strangulation - hanging,10
17257838,1,"Las Vegas-Paradise, NV",4,24,14,0.5833333333333334,Fire,10
27620465,1,"Florence, SC",10,24,14,0.5833333333333334,Other or type unknown,10
80128330,1,"Minneapolis-St. Paul-Bloomington, MN-WI",16,24,14,0.5833333333333334,Strangulation - hanging,10
3203566,2,Rural Ohio,4,23,13,0.5652173913043478,Fire,10
65501212,2,"Killeen-Temple-Fort Hood, TX",10,23,13,0.5652173913043478,Other or type unknown,10
86111560,1,"Sacramento-Roseville, CA",4,22,12,0.5454545454545454,Fire,10
11923616,1,"Saginaw, MI",1,21,11,0.5238095238095238,"Blunt object - hammer, club, etc",10
84411722,2,"Myrtle Beach-Conway, SC",5,21,11,0.5238095238095238,"Firearm, type not stated",10
93374810,1,"Huntington-Ashland, WV-KY-OH",10,21,11,0.5238095238095238,Other or type unknown,10
46823174,1,"Florence-Muscle Shoals, AL",5,20,10,0.5,"Firearm, type not stated",10
89753065,2,"Trenton-Ewing, NJ",10,20,10,0.5,Other or type unknown,10
56539373,2,"Albuquerque, NM",16,19,9,0.47368421052631576,Strangulation - hanging,10
66115405,1,"Pueblo, CO",10,19,9,0.47368421052631576,Other or type unknown,10
98283877,1,"Miami-Fort Lauderdale, FL",2,19,9,0.47368421052631576,Drowning,10
73038491,1,"Merced, CA",10,18,8,0.4444444444444444,Other or type unknown,10
79358451,1,"Los Angeles-Long Beach, CA",9,18,8,0.4444444444444444,Other gun,10
26653976,1,"Sherman-Denison, TX",5,17,7,0.4117647058823529,"Firearm, type not stated",10
42607892,2,Rural Indiana,16,17,7,0.4117647058823529,Strangulation - hanging,10
14540608,1,"Buffalo-Niagara Falls, NY",16,15,5,0.3333333333333333,Strangulation - hanging,10
17943457,2,"Pine Bluff, AR",5,15,5,0.3333333333333333,"Firearm, type not stated",10
96349123,1,"Boston-Cambridge-Quincy, MA-NH",9,15,5,0.3333333333333333,Other gun,10
24057619,1,"Kansas City, MO-KS",3,13,3,0.23076923076923078,Explosives,10
40183576,9,Rural North Carolina,10,11,1,0.09090909090909091,Other or type unknown,10
4362474,1,"Philadelphia-Camden-Wilmington, PA-NJ-DE",17,10,0,0.0,Weapon Not Reported,10
14103383,1,"Waco, TX",9,10,0,0.0,Other gun,10
52956363,9,"Phoenix-Mesa-Scottsdale, AZ",10,10,0,0.0,Other or type unknown,10
92524531,1,Rural Louisiana,17,10,0,0.0,Weapon Not Reported,10
99597060,2,"San Antonio, TX",17,10,0,0.0,Weapon Not Reported,10
65439039,1,Rural Arkansas,14,249,240,0.963855421686747,Rifle,9
20677163,1,Rural Missouri,14,193,184,0.9533678756476683,Rifle,9
26840497,1,"Fort Smith, AR-OK",6,177,168,0.9491525423728814,"Handgun - pistol, revolver, etc",9
75715525,1,Rural Oregon,14,148,139,0.9391891891891891,Rifle,9
17366079,1,Rural Alaska,14,144,135,0.9375,Rifle,9
37054188,1,Rural Colorado,7,128,119,0.9296875,Knife or cutting instrument,9
27946945,2,Rural Alabama,15,121,112,0.9256198347107438,Shotgun,9
16200804,1,"Chattanooga, TN-GA",7,116,107,0.9224137931034483,Knife or cutting instrument,9
17946663,1,"Redding, CA",6,113,104,0.9203539823008849,"Handgun - pistol, revolver, etc",9
68572907,1,Rural New York,15,104,95,0.9134615384615384,Shotgun,9
51224719,1,"Dayton, OH",15,93,84,0.9032258064516129,Shotgun,9
96387203,1,"Yakima, WA",7,93,84,0.9032258064516129,Knife or cutting instrument,9
32528749,1,"Columbia, MO",6,90,81,0.9,"Handgun - pistol, revolver, etc",9
25663146,1,"Asheville, NC",7,89,80,0.898876404494382,Knife or cutting instrument,9
69287108,2,"Longview, TX",6,89,80,0.898876404494382,"Handgun - pistol, revolver, etc",9
13639145,1,Rural Louisiana,1,88,79,0.8977272727272727,"Blunt object - hammer, club, etc",9
89354921,2,"Cape Coral-Fort Myers, FL",6,82,73,0.8902439024390244,"Handgun - pistol, revolver, etc",9
34969249,1,"San Jose-Sunnyvale-Santa Clara, CA",14,81,72,0.8888888888888888,Rifle,9
55139225,1,Rural Kansas,11,81,72,0.8888888888888888,"Personal weapons, includes beating",9
78260328,2,"Syracuse, NY",7,81,72,0.8888888888888888,Knife or cutting instrument,9
58407507,2,"Lubbock, TX",6,78,69,0.8846153846153846,"Handgun - pistol, revolver, etc",9
11062508,2,"Wilmington, NC",6,76,67,0.881578947368421,"Handgun - pistol, revolver, etc",9
56202192,2,"Deltona-Daytona Beach-Ormond Beach, FL",6,75,66,0.88,"Handgun - pistol, revolver, etc",9
8395761,1,"Durham, NC",14,74,65,0.8783783783783784,Rifle,9
27720963,1,"Trenton-Ewing, NJ",11,73,64,0.8767123287671232,"Personal weapons, includes beating",9
45048092,1,"Amarillo, TX",11,67,58,0.8656716417910447,"Personal weapons, includes beating",9
66670729,1,Rural New York,1,67,58,0.8656716417910447,"Blunt object - hammer, club, etc",9
84433247,1,"Anchorage, AK",11,67,58,0.8656716417910447,"Personal weapons, includes beating",9
93163373,2,"Albany, GA",6,66,57,0.8636363636363636,"Handgun - pistol, revolver, etc",9
28740233,2,"Pensacola-Ferry Pass-Brent, FL",5,65,56,0.8615384615384616,"Firearm, type not stated",9
87640917,1,"Grand Rapids-Wyoming, MI",11,65,56,0.8615384615384616,"Personal weapons, includes beating",9
49973950,2,Rural Oregon,10,63,54,0.8571428571428571,Other or type unknown,9
1260962,1,Rural Michigan,5,62,53,0.8548387096774194,"Firearm, type not stated",9
12502789,2,Rural Tennessee,10,60,51,0.85,Other or type unknown,9
9076592,1,"Wichita, KS",10,59,50,0.847457627118644,Other or type unknown,9
94445657,2,"Durham, NC",7,59,50,0.847457627118644,Knife or cutting instrument,9
23321637,2,"Lakeland, FL",7,58,49,0.8448275862068966,Knife or cutting instrument,9
69403721,1,"Greensboro-High Point, NC",1,58,49,0.8448275862068966,"Blunt object - hammer, club, etc",9
84081372,2,"Topeka, KS",6,58,49,0.8448275862068966,"Handgun - pistol, revolver, etc",9
32275461,2,"Columbus, GA-AL",7,57,48,0.8421052631578947,Knife or cutting instrument,9
97589107,1,Rural Hawaii,7,57,48,0.8421052631578947,Knife or cutting instrument,9
20370447,1,"Boston-Cambridge-Quincy, MA-NH",14,56,47,0.8392857142857143,Rifle,9
38171552,1,"Tyler, TX",15,56,47,0.8392857142857143,Shotgun,9
39448521,2,"Anniston-Oxford, AL",6,56,47,0.8392857142857143,"Handgun - pistol, revolver, etc",9
99587917,1,"Corpus Christi, TX",1,56,47,0.8392857142857143,"Blunt object - hammer, club, etc",9
9920220,1,"Kokomo, IN",6,54,45,0.8333333333333334,"Handgun - pistol, revolver, etc",9
45560419,1,"Bremerton-Silverdale, WA",6,54,45,0.8333333333333334,"Handgun - pistol, revolver, etc",9
75032422,1,"Chico, CA",7,53,44,0.8301886792452831,Knife or cutting instrument,9
31021743,1,"Raleigh-Cary, NC",1,52,43,0.8269230769230769,"Blunt object - hammer, club, etc",9
44860754,1,"San Luis Obispo-Paso Robles, CA",7,51,42,0.8235294117647058,Knife or cutting instrument,9
45361818,2,"Merced, CA",6,47,38,0.8085106382978723,"Handgun - pistol, revolver, etc",9
74635417,1,Rural Pennsylvania,4,47,38,0.8085106382978723,Fire,9
29155195,2,"Charleston-North Charleston, SC",10,46,37,0.8043478260869565,Other or type unknown,9
36670763,2,"Baltimore-Towson, MD",4,46,37,0.8043478260869565,Fire,9
43664265,1,"McAllen-Edinburg-Mission, TX",1,46,37,0.8043478260869565,"Blunt object - hammer, club, etc",9
73094056,2,"Charlotte-Gastonia-Concord, NC-SC",1,46,37,0.8043478260869565,"Blunt object - hammer, club, etc",9
88755242,1,Rural Washington,1,46,37,0.8043478260869565,"Blunt object - hammer, club, etc",9
79156363,1,"Philadelphia-Camden-Wilmington, PA-NJ-DE",8,45,36,0.8,"Narcotics or drugs, sleeping pills",9
8091122,2,"Lake Charles, LA",7,44,35,0.7954545454545454,Knife or cutting instrument,9
89501319,2,Rural New York,1,43,34,0.7906976744186046,"Blunt object - hammer, club, etc",9
22439496,1,"Lynchburg, VA",5,42,33,0.7857142857142857,"Firearm, type not stated",9
36134669,2,"Atlantic City, NJ",6,42,33,0.7857142857142857,"Handgun - pistol, revolver, etc",9
61525410,2,Rural Indiana,1,42,33,0.7857142857142857,"Blunt object - hammer, club, etc",9
76349159,1,"Milwaukee-Waukesha-West Allis, WI",4,42,33,0.7857142857142857,Fire,9
86407324,1,Rural Michigan,8,42,33,0.7857142857142857,"Narcotics or drugs, sleeping pills",9
94486070,2,"Houston-Sugar Land-Baytown, TX",0,42,33,0.7857142857142857,Asphyxiation - includes death by gas,9
99154701,2,"Sarasota-Bradenton-Venice, FL",5,42,33,0.7857142857142857,"Firearm, type not stated",9
10038559,1,"Salinas, CA",11,41,32,0.7804878048780488,"Personal weapons, includes beating",9
25401028,2,"Corpus Christi, TX",5,41,32,0.7804878048780488,"Firearm, type not stated",9
39742178,2,"New Haven-Milford, CT",1,41,32,0.7804878048780488,"Blunt object - hammer, club, etc",9
29067484,2,"Rochester, NY",1,40,31,0.775,"Blunt object - hammer, club, etc",9
38581713,1,Rural Washington,5,40,31,0.775,"Firearm, type not stated",9
54368092,1,"Lake Charles, LA",5,40,31,0.775,"Firearm, type not stated",9
72495690,1,"Deltona-Daytona Beach-Ormond Beach, FL",1,40,31,0.775,"Blunt object - hammer, club, etc",9
578460,1,"Salem, OR",5,39,30,0.7692307692307693,"Firearm, type not stated",9
32333392,2,"Harrisburg-Carlisle, PA",10,39,30,0.7692307692307693,Other or type unknown,9
8091950,1,"Albany-Schenectady-Troy, NY",1,38,29,0.7631578947368421,"Blunt object - hammer, club, etc",9
13960619,1,"Oxnard-Thousand Oaks-Ventura, CA",14,37,28,0.7567567567567568,Rifle,9
24598517,1,Rural Washington,8,37,28,0.7567567567567568,"Narcotics or drugs, sleeping pills",9
81118521,2,"Lakeland, FL",11,37,28,0.7567567567567568,"Personal weapons, includes beating",9
84169979,1,"Hot Springs, AR",5,37,28,0.7567567567567568,"Firearm, type not stated",9
21458575,2,"Birmingham-Hoover, AL",1,36,27,0.75,"Blunt object - hammer, club, etc",9
81241107,1,"Valdosta, GA",10,36,27,0.75,Other or type unknown,9
32295795,1,Rural Texas,16,35,26,0.7428571428571429,Strangulation - hanging,9
28056865,1,"Fort Smith, AR-OK",10,34,25,0.7352941176470589,Other or type unknown,9
64389910,1,"Burlington, NC",10,34,25,0.7352941176470589,Other or type unknown,9
98600845,1,"Cincinnati-Middletown, OH-KY-IN",4,34,25,0.7352941176470589,Fire,9
7904682,2,"Akron, OH",5,33,24,0.7272727272727273,"Firearm, type not stated",9
66411088,1,"Longview, TX",10,33,24,0.7272727272727273,Other or type unknown,9
38820029,1,"Sacramento-Roseville, CA",16,32,23,0.71875,Strangulation - hanging,9
47785301,2,"Salt Lake City, UT",1,32,23,0.71875,"Blunt object - hammer, club, etc",9
76900220,2,"Baton Rouge, LA",16,32,23,0.71875,Strangulation - hanging,9
23265861,1,"San Diego-Carlsbad-San Marcos, CA",0,31,22,0.7096774193548387,Asphyxiation - includes death by gas,9
64514109,2,Rural Ohio,1,31,22,0.7096774193548387,"Blunt object - hammer, club, etc",9
5471564,1,"Kansas City, MO-KS",16,30,21,0.7,Strangulation - hanging,9
62324191,1,"Macon, GA",14,30,21,0.7,Rifle,9
77583364,1,"Las Vegas-Paradise, NV",0,30,21,0.7,Asphyxiation - includes death by gas,9
80904314,1,Rural Colorado,10,30,21,0.7,Other or type unknown,9
7405183,1,Rural Illinois,5,29,20,0.6896551724137931,"Firearm, type not stated",9
23407369,1,"Brownsville-Harlingen, TX",14,29,20,0.6896551724137931,Rifle,9
64138144,1,"Grand Rapids-Wyoming, MI",1,29,20,0.6896551724137931,"Blunt object - hammer, club, etc",9
88009523,2,"Waco, TX",7,29,20,0.6896551724137931,Knife or cutting instrument,9
43886316,2,"Springfield, MA",10,28,19,0.6785714285714286,Other or type unknown,9
3762133,2,Rural Arkansas,16,27,18,0.6666666666666666,Strangulation - hanging,9
20901696,2,"Louisville, KY-IN",14,27,18,0.6666666666666666,Rifle,9
48252833,2,"Columbus, OH",4,27,18,0.6666666666666666,Fire,9
60188936,1,"Baltimore-Towson, MD",0,27,18,0.6666666666666666,Asphyxiation - includes death by gas,9
18802673,2,"Oxnard-Thousand Oaks-Ventura, CA",11,26,17,0.6538461538461539,"Personal weapons, includes beating",9
24050834,2,"Tallahassee, FL",5,26,17,0.6538461538461539,"Firearm, type not stated",9
26582233,1,"Wichita Falls, TX",1,26,17,0.6538461538461539,"Blunt object - hammer, club, etc",9
38007725,2,"Cape Coral-Fort Myers, FL",1,26,17,0.6538461538461539,"Blunt object - hammer, club, etc",9
60889785,1,"Vallejo-Fairfield, CA",10,26,17,0.6538461538461539,Other or type unknown,9
71613687,2,"Tuscaloosa, AL",10,26,17,0.6538461538461539,Other or type unknown,9
84654213,1,"Wilmington, NC",5,26,17,0.6538461538461539,"Firearm, type not stated",9
21957645,1,"Buffalo-Niagara Falls, NY",4,25,16,0.64,Fire,9
74288501,2,"Vallejo-Fairfield, CA",1,25,16,0.64,"Blunt object - hammer, club, etc",9
89569062,1,"Auburn-Opelika, AL",10,25,16,0.64,Other or type unknown,9
6468999,1,"Greenville, NC",5,23,14,0.6086956521739131,"Firearm, type not stated",9
24821820,2,"Fort Wayne, IN",1,23,14,0.6086956521739131,"Blunt object - hammer, club, etc",9
66314887,2,"Shreveport-Bossier City, LA",10,23,14,0.6086956521739131,Other or type unknown,9
39081627,2,Rural New Hampshire,10,22,13,0.5909090909090909,Other or type unknown,9
65065496,1,"Harrisburg-Carlisle, PA",8,22,13,0.5909090909090909,"Narcotics or drugs, sleeping pills",9
83042619,1,"Madera, CA",1,22,13,0.5909090909090909,"Blunt object - hammer, club, etc",9
41360730,1,"Fort Wayne, IN",10,21,12,0.5714285714285714,Other or type unknown,9
51448922,1,"South Bend-Mishawaka, IN-MI",10,21,12,0.5714285714285714,Other or type unknown,9
79865700,2,"Miami-Fort Lauderdale, FL",0,21,12,0.5714285714285714,Asphyxiation - includes death by gas,9
89688907,2,"McAllen-Edinburg-Mission, TX",5,21,12,0.5714285714285714,"Firearm, type not stated",9
93107719,2,"Albany-Schenectady-Troy, NY",10,21,12,0.5714285714285714,Other or type unknown,9
16239796,2,"Spokane, WA",16,20,11,0.55,Strangulation - hanging,9
49154579,2,"Modesto, CA",5,20,11,0.55,"Firearm, type not stated",9
91478367,1,"Niles-Benton Harbor, MI",10,20,11,0.55,Other or type unknown,9
8416598,1,"Waco, TX",10,18,9,0.5,Other or type unknown,9
40467668,2,"Gainesville, FL",10,18,9,0.5,Other or type unknown,9
67020731,2,"Waco, TX",10,18,9,0.5,Other or type unknown,9
13132201,2,"Reading, PA",5,17,8,0.47058823529411764,"Firearm, type not stated",9
62427332,2,"Harrisburg-Carlisle, PA",16,17,8,0.47058823529411764,Strangulation - hanging,9
86492757,2,"Salinas, CA",5,17,8,0.47058823529411764,"Firearm, type not stated",9
22306293,2,"Sacramento-Roseville, CA",4,16,7,0.4375,Fire,9
94640196,2,"Dayton, OH",16,15,6,0.4,Strangulation - hanging,9
13713187,1,"Birmingham-Hoover, AL",4,14,5,0.35714285714285715,Fire,9
43290642,9,"Cleveland-Elyria-Mentor, OH",10,14,5,0.35714285714285715,Other or type unknown,9
13233133,1,"Fort Wayne, IN",4,13,4,0.3076923076923077,Fire,9
50000929,1,"Little Rock-North Little Rock, AR",16,13,4,0.3076923076923077,Strangulation - hanging,9
86374478,2,"Springfield, OH",10,13,4,0.3076923076923077,Other or type unknown,9
14989530,9,"Dallas-Fort Worth-Arlington, TX",10,12,3,0.25,Other or type unknown,9
15274521,1,"Fresno, CA",4,12,3,0.25,Fire,9
67410188,9,"New York-New Jersey-Long Island, NY-NJ",11,12,3,0.25,"Personal weapons, includes beating",9
37476691,9,"Cleveland-Elyria-Mentor, OH",5,10,1,0.1,"Firearm, type not stated",9
1554033,1,"Indianapolis, IN",17,9,0,0.0,Weapon Not Reported,9
34859213,2,"Houston-Sugar Land-Baytown, TX",17,9,0,0.0,Weapon Not Reported,9
56762576,1,"St. Louis, MO-IL",17,9,0,0.0,Weapon Not Reported,9
59890786,1,"Milwaukee-Waukesha-West Allis, WI",17,9,0,0.0,Weapon Not Reported,9
87794020,2,"New Orleans-Metairie-Kenner, LA",17,9,0,0.0,Weapon Not Reported,9
88222269,1,"Seattle-Tacoma-Bellevue, WA",17,9,0,0.0,Weapon Not Reported,9
94776415,2,"Oklahoma City, OK",17,9,0,0.0,Weapon Not Reported,9
98534639,1,Rural Arkansas,17,9,0,0.0,Weapon Not Reported,9
99643352,1,"Baltimore-Towson, MD",17,9,0,0.0,Weapon Not Reported,9
23247995,1,Rural Tennessee,14,144,136,0.9444444444444444,Rifle,8
86977181,2,Rural North Carolina,14,143,135,0.9440559440559441,Rifle,8
15109537,2,"Oklahoma City, OK",11,130,122,0.9384615384615385,"Personal weapons, includes beating",8
16391861,2,"El Paso, TX",6,129,121,0.937984496124031,"Handgun - pistol, revolver, etc",8
34732659,2,"Spartanburg, SC",6,122,114,0.9344262295081968,"Handgun - pistol, revolver, etc",8
76098717,1,"Fayetteville-Springdale-Rogers, AR-MO",6,121,113,0.9338842975206612,"Handgun - pistol, revolver, etc",8
44869558,1,Rural Kentucky,11,120,112,0.9333333333333333,"Personal weapons, includes beating",8
80072027,2,"Philadelphia-Camden-Wilmington, PA-NJ-DE",15,119,111,0.9327731092436975,Shotgun,8
55598028,2,"Chattanooga, TN-GA",6,118,110,0.9322033898305084,"Handgun - pistol, revolver, etc",8
17324729,2,"Washington-Arlington-Alexandria, DC-VA-MD-WV",15,117,109,0.9316239316239316,Shotgun,8
89031246,2,"New York-New Jersey-Long Island, NY-NJ",14,117,109,0.9316239316239316,Rifle,8
35370197,1,Rural Indiana,15,111,103,0.9279279279279279,Shotgun,8
42455324,1,Rural Kansas,7,111,103,0.9279279279279279,Knife or cutting instrument,8
71258843,1,"Pensacola-Ferry Pass-Brent, FL",7,102,94,0.9215686274509803,Knife or cutting instrument,8
56805954,1,Rural Michigan,14,101,93,0.9207920792079208,Rifle,8
58526091,2,"Florence, SC",6,96,88,0.9166666666666666,"Handgun - pistol, revolver, etc",8
88728761,2,"Lexington-Fayette, KY",6,95,87,0.9157894736842105,"Handgun - pistol, revolver, etc",8
85398099,1,"Austin-Round Rock, TX",14,93,85,0.9139784946236559,Rifle,8
60115204,2,Rural Washington,6,92,84,0.9130434782608695,"Handgun - pistol, revolver, etc",8
36761770,2,"Tulsa, OK",11,91,83,0.9120879120879121,"Personal weapons, includes beating",8
72641429,1,"Macon, GA",7,91,83,0.9120879120879121,Knife or cutting instrument,8
39131062,1,Rural Mississippi,11,89,81,0.9101123595505618,"Personal weapons, includes beating",8
12107438,1,"Raleigh-Cary, NC",14,88,80,0.9090909090909091,Rifle,8
28915648,2,Rural Kentucky,14,85,77,0.9058823529411765,Rifle,8
43984668,1,"Saginaw, MI",7,84,76,0.9047619047619048,Knife or cutting instrument,8
30990223,1,"Lansing-East Lansing, MI",7,78,70,0.8974358974358975,Knife or cutting instrument,8
818629,2,"Canton-Massillon, OH",6,77,69,0.8961038961038961,"Handgun - pistol, revolver, etc",8
9062578,1,Rural Delaware,6,76,68,0.8947368421052632,"Handgun - pistol, revolver, etc",8
28686458,1,"Shreveport-Bossier City, LA",11,74,66,0.8918918918918919,"Personal weapons, includes beating",8
61250618,2,"Harrisburg-Carlisle, PA",6,73,65,0.8904109589041096,"Handgun - pistol, revolver, etc",8
71851698,2,"Pensacola-Ferry Pass-Brent, FL",6,71,63,0.8873239436619719,"Handgun - pistol, revolver, etc",8
69123538,2,Rural South Carolina,14,70,62,0.8857142857142857,Rifle,8
80010887,1,Rural Ohio,8,69,61,0.8840579710144928,"Narcotics or drugs, sleeping pills",8
82560313,1,"Lincoln, NE",6,68,60,0.8823529411764706,"Handgun - pistol, revolver, etc",8
33470576,2,Rural Tennessee,1,67,59,0.8805970149253731,"Blunt object - hammer, club, etc",8
40541463,2,Rural South Carolina,1,67,59,0.8805970149253731,"Blunt object - hammer, club, etc",8
25139297,1,"Alexandria, LA",7,66,58,0.8787878787878788,Knife or cutting instrument,8
13586583,1,"Atlantic City, NJ",11,65,57,0.8769230769230769,"Personal weapons, includes beating",8
73492254,2,Rural Wisconsin,7,65,57,0.8769230769230769,Knife or cutting instrument,8
28400204,1,Rural Wyoming,7,64,56,0.875,Knife or cutting instrument,8
43194393,2,"Ocala, FL",6,64,56,0.875,"Handgun - pistol, revolver, etc",8
21653950,1,"McAllen-Edinburg-Mission, TX",14,63,55,0.873015873015873,Rifle,8
72920520,2,"Pensacola-Ferry Pass-Brent, FL",7,62,54,0.8709677419354839,Knife or cutting instrument,8
67407208,2,Rural Louisiana,11,61,53,0.8688524590163934,"Personal weapons, includes beating",8
9033643,2,Rural Illinois,7,60,52,0.8666666666666667,Knife or cutting instrument,8
93165610,1,"Janesville, WI",6,60,52,0.8666666666666667,"Handgun - pistol, revolver, etc",8
11336666,1,"Anniston-Oxford, AL",7,59,51,0.864406779661017,Knife or cutting instrument,8
40523388,2,"Fort Smith, AR-OK",6,59,51,0.864406779661017,"Handgun - pistol, revolver, etc",8
45592063,1,"Ocala, FL",7,59,51,0.864406779661017,Knife or cutting instrument,8
21255954,2,"Winston-Salem, NC",7,58,50,0.8620689655172413,Knife or cutting instrument,8
45909314,1,"Columbus, OH",14,55,47,0.8545454545454545,Rifle,8
73008497,2,"Kansas City, MO-KS",14,55,47,0.8545454545454545,Rifle,8
55178309,2,"Wichita Falls, TX",6,54,46,0.8518518518518519,"Handgun - pistol, revolver, etc",8
82663783,2,"Columbia, SC",11,54,46,0.8518518518518519,"Personal weapons, includes beating",8
90851451,1,"Norwich-New London, CT",6,54,46,0.8518518518518519,"Handgun - pistol, revolver, etc",8
51201786,1,Rural Michigan,1,53,45,0.8490566037735849,"Blunt object - hammer, club, etc",8
51865927,2,Rural West Virginia,7,53,45,0.8490566037735849,Knife or cutting instrument,8
3125282,2,"Austin-Round Rock, TX",5,52,44,0.8461538461538461,"Firearm, type not stated",8
44985153,2,"Colorado Springs, CO",7,51,43,0.8431372549019608,Knife or cutting instrument,8
67009858,1,Rural Indiana,10,51,43,0.8431372549019608,Other or type unknown,8
78490758,1,"Pueblo, CO",7,51,43,0.8431372549019608,Knife or cutting instrument,8
96987913,1,"Lawton, OK",7,51,43,0.8431372549019608,Knife or cutting instrument,8
20659095,1,"Wichita Falls, TX",7,49,41,0.8367346938775511,Knife or cutting instrument,8
82451785,2,"Macon, GA",7,49,41,0.8367346938775511,Knife or cutting instrument,8
84011562,1,"Deltona-Daytona Beach-Ormond Beach, FL",11,48,40,0.8333333333333334,"Personal weapons, includes beating",8
12577060,2,"Palm Bay-Melbourne-Titusville, FL",5,47,39,0.8297872340425532,"Firearm, type not stated",8
44138583,1,"Los Angeles-Long Beach, CA",2,46,38,0.8260869565217391,Drowning,8
45825100,2,"Columbia, SC",10,46,38,0.8260869565217391,Other or type unknown,8
92242815,1,"Danville, IL",6,46,38,0.8260869565217391,"Handgun - pistol, revolver, etc",8
6163468,2,"Cape Coral-Fort Myers, FL",7,45,37,0.8222222222222222,Knife or cutting instrument,8
35357583,2,"Dothan, AL",6,45,37,0.8222222222222222,"Handgun - pistol, revolver, etc",8
94311722,2,"Santa Barbara-Santa Maria, CA",7,45,37,0.8222222222222222,Knife or cutting instrument,8
96601720,2,"Des Moines, IA",7,45,37,0.8222222222222222,Knife or cutting instrument,8
860323,1,"Bellingham, WA",6,43,35,0.813953488372093,"Handgun - pistol, revolver, etc",8
17371246,1,Rural Nevada,7,43,35,0.813953488372093,Knife or cutting instrument,8
26591921,2,Rural Maine,7,43,35,0.813953488372093,Knife or cutting instrument,8
59397915,1,"Redding, CA",7,43,35,0.813953488372093,Knife or cutting instrument,8
98866780,1,"Durham, NC",1,42,34,0.8095238095238095,"Blunt object - hammer, club, etc",8
4654731,2,"Jacksonville, FL",14,40,32,0.8,Rifle,8
5471068,2,"Beaumont-Port Arthur, TX",11,40,32,0.8,"Personal weapons, includes beating",8
11729317,2,"Huntsville, AL",10,40,32,0.8,Other or type unknown,8
67219092,1,"Durham, NC",11,40,32,0.8,"Personal weapons, includes beating",8
53720810,2,"Raleigh-Cary, NC",11,39,31,0.7948717948717948,"Personal weapons, includes beating",8
80763167,1,Rural Indiana,1,39,31,0.7948717948717948,"Blunt object - hammer, club, etc",8
26355346,2,Rural Oregon,1,38,30,0.7894736842105263,"Blunt object - hammer, club, etc",8
74735302,1,Rural Wisconsin,5,38,30,0.7894736842105263,"Firearm, type not stated",8
31127638,2,"Trenton-Ewing, NJ",11,37,29,0.7837837837837838,"Personal weapons, includes beating",8
62084765,1,Rural Maine,5,37,29,0.7837837837837838,"Firearm, type not stated",8
72940907,2,"Gulfport-Biloxi, MS",7,37,29,0.7837837837837838,Knife or cutting instrument,8
29146304,1,"Gulfport-Biloxi, MS",5,36,28,0.7777777777777778,"Firearm, type not stated",8
92615375,1,"Vallejo-Fairfield, CA",15,36,28,0.7777777777777778,Shotgun,8
3921446,2,"Buffalo-Niagara Falls, NY",1,35,27,0.7714285714285715,"Blunt object - hammer, club, etc",8
24382059,1,"Albany-Schenectady-Troy, NY",10,35,27,0.7714285714285715,Other or type unknown,8
35599279,1,"Waterloo-Cedar Falls, IA",6,35,27,0.7714285714285715,"Handgun - pistol, revolver, etc",8
50091794,1,"Wilmington, NC",14,35,27,0.7714285714285715,Rifle,8
52508884,1,"Savannah, GA",14,35,27,0.7714285714285715,Rifle,8
67019178,1,"Worcester, MA",10,35,27,0.7714285714285715,Other or type unknown,8
99983468,1,"Rocky Mount, NC",9,35,27,0.7714285714285715,Other gun,8
56822170,2,"Ann Arbor, MI",6,34,26,0.7647058823529411,"Handgun - pistol, revolver, etc",8
80766272,1,"Reno-Sparks, NV",10,34,26,0.7647058823529411,Other or type unknown,8
83671688,1,"Poughkeepsie-Newburgh-Middletown, NY",1,34,26,0.7647058823529411,"Blunt object - hammer, club, etc",8
41970269,2,"Pittsburgh, PA",4,33,25,0.7575757575757576,Fire,8
51383039,1,"Anchorage, AK",1,33,25,0.7575757575757576,"Blunt object - hammer, club, etc",8
15829363,1,"Napa, CA",6,32,24,0.75,"Handgun - pistol, revolver, etc",8
15947923,1,"Evansville, IN-KY",10,32,24,0.75,Other or type unknown,8
39350559,1,"Portland-South Portland-Biddeford, ME",5,32,24,0.75,"Firearm, type not stated",8
46723449,1,"Savannah, GA",10,32,24,0.75,Other or type unknown,8
58272712,1,"Ann Arbor, MI",10,32,24,0.75,Other or type unknown,8
67784799,1,Rural New York,5,32,24,0.75,"Firearm, type not stated",8
83920393,2,"Longview, TX",7,32,24,0.75,Knife or cutting instrument,8
39776208,2,"Reno-Sparks, NV",5,31,23,0.7419354838709677,"Firearm, type not stated",8
79910976,2,"Madera, CA",6,31,23,0.7419354838709677,"Handgun - pistol, revolver, etc",8
96910115,1,"Houma-Bayou Cane-Thibodaux, LA",14,30,22,0.7333333333333333,Rifle,8
97784911,2,"Charlotte-Gastonia-Concord, NC-SC",9,30,22,0.7333333333333333,Other gun,8
16109311,1,"Syracuse, NY",1,29,21,0.7241379310344828,"Blunt object - hammer, club, etc",8
24114731,1,Rural Colorado,5,29,21,0.7241379310344828,"Firearm, type not stated",8
76409096,1,"Sarasota-Bradenton-Venice, FL",14,29,21,0.7241379310344828,Rifle,8
85026729,1,"Kansas City, MO-KS",9,29,21,0.7241379310344828,Other gun,8
47986774,1,"Kalamazoo-Portage, MI",1,28,20,0.7142857142857143,"Blunt object - hammer, club, etc",8
79965086,1,Rural Texas,4,28,20,0.7142857142857143,Fire,8
15984691,1,"Albany, GA",10,27,19,0.7037037037037037,Other or type unknown,8
46697683,2,"Louisville, KY-IN",16,27,19,0.7037037037037037,Strangulation - hanging,8
53886950,1,"Fort Walton Beach-Destin, FL",5,27,19,0.7037037037037037,"Firearm, type not stated",8
65806320,2,Rural Wisconsin,1,27,19,0.7037037037037037,"Blunt object - hammer, club, etc",8
15694453,2,"Lubbock, TX",10,26,18,0.6923076923076923,Other or type unknown,8
23510236,1,"Lafayette, LA",5,26,18,0.6923076923076923,"Firearm, type not stated",8
36761328,2,"Virginia Beach-Norfolk-Newport News, VA-NC",0,26,18,0.6923076923076923,Asphyxiation - includes death by gas,8
74033802,2,"Charleston, WV",10,26,18,0.6923076923076923,Other or type unknown,8
75026369,2,"Trenton-Ewing, NJ",16,26,18,0.6923076923076923,Strangulation - hanging,8
76239076,1,"Texarkana, TX-Texarkana, AR",1,26,18,0.6923076923076923,"Blunt object - hammer, club, etc",8
80277775,1,"Yuba City, CA",1,26,18,0.6923076923076923,"Blunt object - hammer, club, etc",8
9564201,2,"Lexington-Fayette, KY",10,25,17,0.68,Other or type unknown,8
63288323,2,Rural Georgia,16,25,17,0.68,Strangulation - hanging,8
68579341,1,Rural Illinois,1,25,17,0.68,"Blunt object - hammer, club, etc",8
71671478,2,"South Bend-Mishawaka, IN-MI",5,25,17,0.68,"Firearm, type not stated",8
76571954,1,"Dayton, OH",4,25,17,0.68,Fire,8
86598111,1,"Monroe, MI",6,25,17,0.68,"Handgun - pistol, revolver, etc",8
96339203,1,Rural Colorado,1,25,17,0.68,"Blunt object - hammer, club, etc",8
5148011,1,"Macon, GA",10,24,16,0.6666666666666666,Other or type unknown,8
74736401,1,"Chico, CA",14,24,16,0.6666666666666666,Rifle,8
75324677,2,"Scranton--Wilkes-Barre, PA",10,24,16,0.6666666666666666,Other or type unknown,8
86795848,2,Rural Oklahoma,16,24,16,0.6666666666666666,Strangulation - hanging,8
486201,2,"El Centro, CA",7,23,15,0.6521739130434783,Knife or cutting instrument,8
24102109,1,"Tyler, TX",1,23,15,0.6521739130434783,"Blunt object - hammer, club, etc",8
32573317,2,"Tulsa, OK",16,23,15,0.6521739130434783,Strangulation - hanging,8
54375268,2,"Clarksville, TN-KY",10,23,15,0.6521739130434783,Other or type unknown,8
58741868,1,"Jackson, MI",10,23,15,0.6521739130434783,Other or type unknown,8
7169651,2,"Rocky Mount, NC",10,22,14,0.6363636363636364,Other or type unknown,8
28525826,1,"Wichita Falls, TX",10,22,14,0.6363636363636364,Other or type unknown,8
30185746,1,"Trenton-Ewing, NJ",4,22,14,0.6363636363636364,Fire,8
39743596,2,"Corpus Christi, TX",10,22,14,0.6363636363636364,Other or type unknown,8
42467961,1,"Anniston-Oxford, AL",5,22,14,0.6363636363636364,"Firearm, type not stated",8
54446951,1,"Portland-Vancouver-Beaverton, OR-WA",4,22,14,0.6363636363636364,Fire,8
66655658,1,"Toledo, OH",14,22,14,0.6363636363636364,Rifle,8
91713811,1,Rural Vermont,10,22,14,0.6363636363636364,Other or type unknown,8
98626086,2,Rural Mississippi,16,22,14,0.6363636363636364,Strangulation - hanging,8
7881377,1,"Odessa, TX",1,21,13,0.6190476190476191,"Blunt object - hammer, club, etc",8
18250559,2,"Pine Bluff, AR",7,21,13,0.6190476190476191,Knife or cutting instrument,8
20671618,2,"Harrisburg-Carlisle, PA",5,21,13,0.6190476190476191,"Firearm, type not stated",8
30100755,2,"Fayetteville, NC",5,21,13,0.6190476190476191,"Firearm, type not stated",8
52912192,2,"York-Hanover, PA",10,21,13,0.6190476190476191,Other or type unknown,8
97521717,2,"Las Cruces, NM",10,21,13,0.6190476190476191,Other or type unknown,8
99461655,2,"Huntington-Ashland, WV-KY-OH",7,20,12,0.6,Knife or cutting instrument,8
2599217,1,"Redding, CA",5,19,11,0.5789473684210527,"Firearm, type not stated",8
15477971,1,"Lancaster, PA",5,19,11,0.5789473684210527,"Firearm, type not stated",8
73555231,2,"Youngstown-Warren-Boardman, OH-PA",1,19,11,0.5789473684210527,"Blunt object - hammer, club, etc",8
16456630,1,"Madera, CA",10,18,10,0.5555555555555556,Other or type unknown,8
42426423,2,"Salem, OR",16,18,10,0.5555555555555556,Strangulation - hanging,8
63769799,1,"Fresno, CA",16,18,10,0.5555555555555556,Strangulation - hanging,8
63830861,2,"Grand Rapids-Wyoming, MI",4,18,10,0.5555555555555556,Fire,8
86283779,1,"Tucson, AZ",9,17,9,0.5294117647058824,Other gun,8
46531110,1,"St. Joseph, MO-KS",5,16,8,0.5,"Firearm, type not stated",8
49760341,1,"Anderson, IN",5,16,8,0.5,"Firearm, type not stated",8
76328301,1,"Denver-Aurora, CO",16,16,8,0.5,Strangulation - hanging,8
86878026,1,"Cedar Rapids, IA",5,16,8,0.5,"Firearm, type not stated",8
33730497,2,"Honolulu, HI",16,15,7,0.4666666666666667,Strangulation - hanging,8
61581205,2,"Salinas, CA",16,15,7,0.4666666666666667,Strangulation - hanging,8
63442551,2,"Fort Wayne, IN",10,15,7,0.4666666666666667,Other or type unknown,8
15994404,2,"Yakima, WA",5,14,6,0.42857142857142855,"Firearm, type not stated",8
49940179,2,"Bridgeport-Stamford-Norwalk, CT",4,14,6,0.42857142857142855,Fire,8
55668239,1,"San Diego-Carlsbad-San Marcos, CA",4,14,6,0.42857142857142855,Fire,8
55762216,2,"Amarillo, TX",1,14,6,0.42857142857142855,"Blunt object - hammer, club, etc",8
90365936,1,"Santa Cruz-Watsonville, CA",10,14,6,0.42857142857142855,Other or type unknown,8
93237265,2,"Dayton, OH",4,14,6,0.42857142857142855,Fire,8
176477,1,"Bakersfield, CA",4,13,5,0.38461538461538464,Fire,8
28032210,2,Rural North Carolina,16,13,5,0.38461538461538464,Strangulation - hanging,8
30287350,2,"Mobile, AL",1,13,5,0.38461538461538464,"Blunt object - hammer, club, etc",8
64162021,1,"Honolulu, HI",16,13,5,0.38461538461538464,Strangulation - hanging,8
73826658,1,"Albuquerque, NM",16,13,5,0.38461538461538464,Strangulation - hanging,8
4545569,2,"Worcester, MA",16,11,3,0.2727272727272727,Strangulation - hanging,8
37183686,1,"Flint, MI",9,11,3,0.2727272727272727,Other gun,8
83607765,9,"New Orleans-Metairie-Kenner, LA",6,11,3,0.2727272727272727,"Handgun - pistol, revolver, etc",8
88980275,2,"Flint, MI",16,11,3,0.2727272727272727,Strangulation - hanging,8
4723970,2,"Buffalo-Niagara Falls, NY",17,10,2,0.2,Weapon Not Reported,8
96619532,9,"Jacksonville, FL",6,10,2,0.2,"Handgun - pistol, revolver, etc",8
8738761,2,"Springfield, OH",5,9,1,0.1111111111111111,"Firearm, type not stated",8
38775004,9,"Miami-Fort Lauderdale, FL",6,9,1,0.1111111111111111,"Handgun - pistol, revolver, etc",8
9737715,1,Rural Alabama,17,8,0,0.0,Weapon Not Reported,8
15560792,1,"Columbus, OH",17,8,0,0.0,Weapon Not Reported,8
28584074,2,"Houma-Bayou Cane-Thibodaux, LA",17,8,0,0.0,Weapon Not Reported,8
74773059,2,"Atlanta-Sandy Springs-Marietta, GA",17,8,0,0.0,Weapon Not Reported,8
92707240,1,"Kankakee-Bradley, IL",5,8,0,0.0,"Firearm, type not stated",8
31618474,2,Rural Texas,15,227,220,0.9691629955947136,Shotgun,7
5275183,2,Rural West Virginia,6,220,213,0.9681818181818181,"Handgun - pistol, revolver, etc",7
89290708,2,"Greenville, SC",6,197,190,0.9644670050761421,"Handgun - pistol, revolver, etc",7
60022634,2,"Colorado Springs, CO",6,169,162,0.9585798816568047,"Handgun - pistol, revolver, etc",7
13069892,2,"Houston-Sugar Land-Baytown, TX",14,168,161,0.9583333333333334,Rifle,7
80383063,1,"Greenville, SC",7,167,160,0.9580838323353293,Knife or cutting instrument,7
68941190,1,Rural Wyoming,6,152,145,0.9539473684210527,"Handgun - pistol, revolver, etc",7
54717482,1,Rural Minnesota,6,142,135,0.9507042253521126,"Handgun - pistol, revolver, etc",7
82366654,1,Rural Oklahoma,11,141,134,0.950354609929078,"Personal weapons, includes beating",7
30682161,1,"Tulsa, OK",11,135,128,0.9481481481481482,"Personal weapons, includes beating",7
60967076,2,Rural Oregon,6,124,117,0.9435483870967742,"Handgun - pistol, revolver, etc",7
3200150,2,Rural Virginia,15,122,115,0.9426229508196722,Shotgun,7
24277630,1,"Midland, TX",6,122,115,0.9426229508196722,"Handgun - pistol, revolver, etc",7
57923495,1,"Cleveland-Elyria-Mentor, OH",14,113,106,0.9380530973451328,Rifle,7
39527717,2,Rural Oklahoma,11,110,103,0.9363636363636364,"Personal weapons, includes beating",7
67075641,1,Rural Wisconsin,7,109,102,0.9357798165137615,Knife or cutting instrument,7
66238321,2,Rural Arkansas,15,99,92,0.9292929292929293,Shotgun,7
30897775,1,Rural Vermont,6,97,90,0.9278350515463918,"Handgun - pistol, revolver, etc",7
12236344,1,Rural New York,11,95,88,0.9263157894736842,"Personal weapons, includes beating",7
44291246,2,Rural Missouri,7,95,88,0.9263157894736842,Knife or cutting instrument,7
34271345,1,"Lafayette, LA",7,94,87,0.925531914893617,Knife or cutting instrument,7
8318408,1,"Beaumont-Port Arthur, TX",15,89,82,0.9213483146067416,Shotgun,7
93155166,1,Rural Iowa,7,89,82,0.9213483146067416,Knife or cutting instrument,7
7240188,1,"Sherman-Denison, TX",6,88,81,0.9204545454545454,"Handgun - pistol, revolver, etc",7
83191624,2,Rural Illinois,6,88,81,0.9204545454545454,"Handgun - pistol, revolver, etc",7
77308474,1,"Jonesboro, AR",6,87,80,0.9195402298850575,"Handgun - pistol, revolver, etc",7
82698118,1,"Minneapolis-St. Paul-Bloomington, MN-WI",14,87,80,0.9195402298850575,Rifle,7
75637921,1,"Rocky Mount, NC",7,83,76,0.9156626506024096,Knife or cutting instrument,7
22892486,1,Rural Ohio,11,82,75,0.9146341463414634,"Personal weapons, includes beating",7
23689139,1,"Hickory-Lenoir-Morganton, NC",15,82,75,0.9146341463414634,Shotgun,7
46799926,2,"Charleston-North Charleston, SC",7,82,75,0.9146341463414634,Knife or cutting instrument,7
44833699,2,Rural Michigan,15,77,70,0.9090909090909091,Shotgun,7
51167897,1,"Modesto, CA",11,77,70,0.9090909090909091,"Personal weapons, includes beating",7
39684514,1,Rural Arizona,14,75,68,0.9066666666666666,Rifle,7
27649024,1,"Fayetteville, NC",14,74,67,0.9054054054054054,Rifle,7
29895441,2,"Washington-Arlington-Alexandria, DC-VA-MD-WV",14,73,66,0.9041095890410958,Rifle,7
73759655,1,"Fort Smith, AR-OK",7,73,66,0.9041095890410958,Knife or cutting instrument,7
8063556,1,"Terre Haute, IN",6,72,65,0.9027777777777778,"Handgun - pistol, revolver, etc",7
14884172,1,"Portland-South Portland-Biddeford, ME",6,71,64,0.9014084507042254,"Handgun - pistol, revolver, etc",7
19651946,1,"Portland-Vancouver-Beaverton, OR-WA",15,71,64,0.9014084507042254,Shotgun,7
71384120,1,"Charleston, WV",7,71,64,0.9014084507042254,Knife or cutting instrument,7
85793854,2,"Raleigh-Cary, NC",7,71,64,0.9014084507042254,Knife or cutting instrument,7
37235183,1,"Hickory-Lenoir-Morganton, NC",7,69,62,0.8985507246376812,Knife or cutting instrument,7
90905379,2,Rural Michigan,11,68,61,0.8970588235294118,"Personal weapons, includes beating",7
34164428,1,Rural Missouri,1,67,60,0.8955223880597015,"Blunt object - hammer, club, etc",7
14517290,1,Rural Washington,15,64,57,0.890625,Shotgun,7
16019526,1,"Raleigh-Cary, NC",11,64,57,0.890625,"Personal weapons, includes beating",7
42108562,1,Rural Alaska,15,64,57,0.890625,Shotgun,7
86048719,1,"Tucson, AZ",15,64,57,0.890625,Shotgun,7
89414971,2,"Lansing-East Lansing, MI",6,63,56,0.8888888888888888,"Handgun - pistol, revolver, etc",7
26745634,1,"Albany-Schenectady-Troy, NY",11,62,55,0.8870967741935484,"Personal weapons, includes beating",7
78988028,1,"Santa Fe, NM",14,62,55,0.8870967741935484,Rifle,7
83008615,1,"Gainesville, FL",7,62,55,0.8870967741935484,Knife or cutting instrument,7
3763176,1,"New Haven-Milford, CT",11,60,53,0.8833333333333333,"Personal weapons, includes beating",7
14697689,1,"Tyler, TX",7,60,53,0.8833333333333333,Knife or cutting instrument,7
32694347,1,Rural New Mexico,11,60,53,0.8833333333333333,"Personal weapons, includes beating",7
68927823,1,"Knoxville, TN",14,60,53,0.8833333333333333,Rifle,7
8962518,2,"Santa Rosa-Petaluma, CA",6,58,51,0.8793103448275862,"Handgun - pistol, revolver, etc",7
51109648,2,Rural Ohio,11,58,51,0.8793103448275862,"Personal weapons, includes beating",7
74914646,2,"San Antonio, TX",14,57,50,0.8771929824561403,Rifle,7
86698671,2,"Cape Coral-Fort Myers, FL",11,57,50,0.8771929824561403,"Personal weapons, includes beating",7
19275200,1,"Akron, OH",11,56,49,0.875,"Personal weapons, includes beating",7
3652471,1,"Winston-Salem, NC",14,55,48,0.8727272727272727,Rifle,7
10062591,1,"Augusta-Richmond County, GA-SC",1,55,48,0.8727272727272727,"Blunt object - hammer, club, etc",7
11592708,2,Rural California,14,55,48,0.8727272727272727,Rifle,7
43049074,1,"Saginaw, MI",15,55,48,0.8727272727272727,Shotgun,7
60440057,1,Rural South Dakota,10,55,48,0.8727272727272727,Other or type unknown,7
72180577,2,"Anchorage, AK",5,55,48,0.8727272727272727,"Firearm, type not stated",7
60875032,1,"Salem, OR",7,54,47,0.8703703703703703,Knife or cutting instrument,7
36356066,1,"Cheyenne, WY",6,53,46,0.8679245283018868,"Handgun - pistol, revolver, etc",7
54392377,1,"Lancaster, PA",7,53,46,0.8679245283018868,Knife or cutting instrument,7
79725163,1,"Houma-Bayou Cane-Thibodaux, LA",7,53,46,0.8679245283018868,Knife or cutting instrument,7
85479806,2,"Yakima, WA",6,53,46,0.8679245283018868,"Handgun - pistol, revolver, etc",7
66576764,2,"Los Angeles-Long Beach, CA",2,52,45,0.8653846153846154,Drowning,7
91704010,2,"Deltona-Daytona Beach-Ormond Beach, FL",7,52,45,0.8653846153846154,Knife or cutting instrument,7
98161625,1,"Lakeland, FL",15,52,45,0.8653846153846154,Shotgun,7
51110922,2,Rural California,11,51,44,0.8627450980392157,"Personal weapons, includes beating",7
72724141,2,Rural Louisiana,1,50,43,0.86,"Blunt object - hammer, club, etc",7
89031646,2,"Baton Rouge, LA",11,49,42,0.8571428571428571,"Personal weapons, includes beating",7
96947802,2,"Omaha-Council Bluffs, NE-IA",7,48,41,0.8541666666666666,Knife or cutting instrument,7
47062133,2,"Augusta-Richmond County, GA-SC",11,47,40,0.851063829787234,"Personal weapons, includes beating",7
64748461,2,"Danville, VA",6,47,40,0.851063829787234,"Handgun - pistol, revolver, etc",7
71498605,1,"New York-New Jersey-Long Island, NY-NJ",8,47,40,0.851063829787234,"Narcotics or drugs, sleeping pills",7
71661439,1,"Eugene-Springfield, OR",7,47,40,0.851063829787234,Knife or cutting instrument,7
91673586,2,"Killeen-Temple-Fort Hood, TX",11,46,39,0.8478260869565217,"Personal weapons, includes beating",7
24877436,1,"Erie, PA",7,45,38,0.8444444444444444,Knife or cutting instrument,7
30262050,2,"Syracuse, NY",6,45,38,0.8444444444444444,"Handgun - pistol, revolver, etc",7
60033553,1,"Topeka, KS",10,45,38,0.8444444444444444,Other or type unknown,7
95660604,1,"Amarillo, TX",5,44,37,0.8409090909090909,"Firearm, type not stated",7
50509483,2,Rural Ohio,8,43,36,0.8372093023255814,"Narcotics or drugs, sleeping pills",7
37298248,2,"Saginaw, MI",7,42,35,0.8333333333333334,Knife or cutting instrument,7
45559925,2,"Amarillo, TX",7,42,35,0.8333333333333334,Knife or cutting instrument,7
63414230,1,Rural Alaska,11,42,35,0.8333333333333334,"Personal weapons, includes beating",7
77702639,1,"Valdosta, GA",7,42,35,0.8333333333333334,Knife or cutting instrument,7
91887840,1,"Clarksville, TN-KY",7,42,35,0.8333333333333334,Knife or cutting instrument,7
49877685,1,"Memphis, TN-MS-AR",4,41,34,0.8292682926829268,Fire,7
11932462,2,"Kalamazoo-Portage, MI",10,40,33,0.825,Other or type unknown,7
53683108,1,"Salt Lake City, UT",14,40,33,0.825,Rifle,7
84211992,1,"Colorado Springs, CO",1,40,33,0.825,"Blunt object - hammer, club, etc",7
47260485,2,"Harrisburg-Carlisle, PA",7,39,32,0.8205128205128205,Knife or cutting instrument,7
69273167,2,"Decatur, AL",6,39,32,0.8205128205128205,"Handgun - pistol, revolver, etc",7
9345374,1,"Brownsville-Harlingen, TX",1,38,31,0.8157894736842105,"Blunt object - hammer, club, etc",7
15641612,2,"New Orleans-Metairie-Kenner, LA",14,38,31,0.8157894736842105,Rifle,7
17023112,2,Rural Kentucky,8,38,31,0.8157894736842105,"Narcotics or drugs, sleeping pills",7
8482241,1,"Wichita, KS",1,37,30,0.8108108108108109,"Blunt object - hammer, club, etc",7
32978032,2,"Yuba City, CA",6,37,30,0.8108108108108109,"Handgun - pistol, revolver, etc",7
54073037,1,"Springfield, MA",1,37,30,0.8108108108108109,"Blunt object - hammer, club, etc",7
86798129,1,"Bloomington-Normal, IL",6,37,30,0.8108108108108109,"Handgun - pistol, revolver, etc",7
13458152,1,"Merced, CA",15,35,28,0.8,Shotgun,7
32873608,2,Rural New Mexico,5,35,28,0.8,"Firearm, type not stated",7
38353169,1,"Fort Wayne, IN",1,35,28,0.8,"Blunt object - hammer, club, etc",7
64798801,2,"Lakeland, FL",5,35,28,0.8,"Firearm, type not stated",7
6826446,1,Rural Wisconsin,1,34,27,0.7941176470588235,"Blunt object - hammer, club, etc",7
46990276,1,"Sarasota-Bradenton-Venice, FL",1,34,27,0.7941176470588235,"Blunt object - hammer, club, etc",7
71337072,1,"Omaha-Council Bluffs, NE-IA",1,34,27,0.7941176470588235,"Blunt object - hammer, club, etc",7
77787369,2,"Tulsa, OK",5,34,27,0.7941176470588235,"Firearm, type not stated",7
95656297,2,"Albany-Schenectady-Troy, NY",6,34,27,0.7941176470588235,"Handgun - pistol, revolver, etc",7
88451182,2,"Chico, CA",6,33,26,0.7878787878787878,"Handgun - pistol, revolver, etc",7
64429923,2,"Fort Smith, AR-OK",7,32,25,0.78125,Knife or cutting instrument,7
70967263,1,"Kingston, NY",6,32,25,0.78125,"Handgun - pistol, revolver, etc",7
81372898,2,"Savannah, GA",11,32,25,0.78125,"Personal weapons, includes beating",7
76321637,1,"Las Cruces, NM",5,31,24,0.7741935483870968,"Firearm, type not stated",7
5080268,1,"Wichita Falls, TX",5,30,23,0.7666666666666667,"Firearm, type not stated",7
13098248,2,"Detroit-Warren-Livonia, MI",8,30,23,0.7666666666666667,"Narcotics or drugs, sleeping pills",7
14348909,2,"Clarksville, TN-KY",7,30,23,0.7666666666666667,Knife or cutting instrument,7
15242534,2,"Springfield, MO",10,30,23,0.7666666666666667,Other or type unknown,7
24946417,1,"Houston-Sugar Land-Baytown, TX",0,30,23,0.7666666666666667,Asphyxiation - includes death by gas,7
26311171,1,"Florence-Muscle Shoals, AL",7,30,23,0.7666666666666667,Knife or cutting instrument,7
52289599,2,Rural Nebraska,10,30,23,0.7666666666666667,Other or type unknown,7
62134303,2,"Roanoke, VA",7,30,23,0.7666666666666667,Knife or cutting instrument,7
15865548,2,"Hartford, CT",10,29,22,0.7586206896551724,Other or type unknown,7
62968062,2,"Wichita, KS",5,29,22,0.7586206896551724,"Firearm, type not stated",7
73870800,2,"Little Rock-North Little Rock, AR",1,29,22,0.7586206896551724,"Blunt object - hammer, club, etc",7
8926705,1,"Fort Wayne, IN",14,28,21,0.75,Rifle,7
17546615,2,"Las Vegas-Paradise, NV",0,28,21,0.75,Asphyxiation - includes death by gas,7
23865929,2,Rural Missouri,16,28,21,0.75,Strangulation - hanging,7
27622657,1,Rural Illinois,10,28,21,0.75,Other or type unknown,7
30393040,1,"Springfield, MA",10,28,21,0.75,Other or type unknown,7
41072045,1,"Yuba City, CA",15,28,21,0.75,Shotgun,7
47895252,2,"Yakima, WA",7,28,21,0.75,Knife or cutting instrument,7
60244166,1,"Youngstown-Warren-Boardman, OH-PA",1,28,21,0.75,"Blunt object - hammer, club, etc",7
64727637,1,Rural Nevada,10,28,21,0.75,Other or type unknown,7
68238815,2,"New Orleans-Metairie-Kenner, LA",4,28,21,0.75,Fire,7
91103144,1,"Raleigh-Cary, NC",9,28,21,0.75,Other gun,7
3517932,1,"Hickory-Lenoir-Morganton, NC",5,27,20,0.7407407407407407,"Firearm, type not stated",7
21837009,1,"Denver-Aurora, CO",9,27,20,0.7407407407407407,Other gun,7
95316522,1,"Macon, GA",1,27,20,0.7407407407407407,"Blunt object - hammer, club, etc",7
9215272,2,"Reno-Sparks, NV",1,26,19,0.7307692307692307,"Blunt object - hammer, club, etc",7
28385080,2,"Florence, SC",10,26,19,0.7307692307692307,Other or type unknown,7
32148734,2,"Lexington-Fayette, KY",7,26,19,0.7307692307692307,Knife or cutting instrument,7
74767754,1,"Worcester, MA",1,26,19,0.7307692307692307,"Blunt object - hammer, club, etc",7
62683,2,"Portland-South Portland-Biddeford, ME",7,25,18,0.72,Knife or cutting instrument,7
9521056,2,Rural Oklahoma,5,25,18,0.72,"Firearm, type not stated",7
50641612,1,"Santa Rosa-Petaluma, CA",14,25,18,0.72,Rifle,7
91813276,1,"Rochester, NY",4,25,18,0.72,Fire,7
12586419,2,"Bridgeport-Stamford-Norwalk, CT",5,24,17,0.7083333333333334,"Firearm, type not stated",7
25460153,2,"Seattle-Tacoma-Bellevue, WA",8,24,17,0.7083333333333334,"Narcotics or drugs, sleeping pills",7
26382059,1,"New York-New Jersey-Long Island, NY-NJ",12,24,17,0.7083333333333334,Poison - does not include gas,7
39360973,2,"Beaumont-Port Arthur, TX",5,24,17,0.7083333333333334,"Firearm, type not stated",7
40575328,1,"Battle Creek, MI",10,24,17,0.7083333333333334,Other or type unknown,7
38062777,1,"New York-New Jersey-Long Island, NY-NJ",13,23,16,0.6956521739130435,Pushed or thrown out window,7
44065672,2,"Oxnard-Thousand Oaks-Ventura, CA",16,23,16,0.6956521739130435,Strangulation - hanging,7
47114680,2,"Athens-Clarke County, GA",7,23,16,0.6956521739130435,Knife or cutting instrument,7
57831097,2,"Houston-Sugar Land-Baytown, TX",2,23,16,0.6956521739130435,Drowning,7
59748289,1,"Tyler, TX",5,23,16,0.6956521739130435,"Firearm, type not stated",7
73494924,1,"New Haven-Milford, CT",4,23,16,0.6956521739130435,Fire,7
96939409,1,Rural Oklahoma,4,23,16,0.6956521739130435,Fire,7
5392293,1,"Santa Barbara-Santa Maria, CA",1,22,15,0.6818181818181818,"Blunt object - hammer, club, etc",7
13772672,2,Rural Illinois,1,22,15,0.6818181818181818,"Blunt object - hammer, club, etc",7
23374785,1,"Anniston-Oxford, AL",10,22,15,0.6818181818181818,Other or type unknown,7
31260550,1,"Athens-Clarke County, GA",10,22,15,0.6818181818181818,Other or type unknown,7
56776093,1,"Gadsden, AL",10,22,15,0.6818181818181818,Other or type unknown,7
72743757,1,"Vero Beach, FL",5,22,15,0.6818181818181818,"Firearm, type not stated",7
90607294,2,"Lake Charles, LA",10,22,15,0.6818181818181818,Other or type unknown,7
96455665,2,"Hartford, CT",1,22,15,0.6818181818181818,"Blunt object - hammer, club, etc",7
97977104,1,"Abilene, TX",5,22,15,0.6818181818181818,"Firearm, type not stated",7
8197985,1,"Santa Fe, NM",1,21,14,0.6666666666666666,"Blunt object - hammer, club, etc",7
12085126,1,"Las Cruces, NM",10,21,14,0.6666666666666666,Other or type unknown,7
33065170,1,"Binghamton, NY",5,21,14,0.6666666666666666,"Firearm, type not stated",7
42048345,2,"Fayetteville, NC",1,21,14,0.6666666666666666,"Blunt object - hammer, club, etc",7
47285779,2,"Salinas, CA",11,21,14,0.6666666666666666,"Personal weapons, includes beating",7
66440091,2,"Saginaw, MI",11,21,14,0.6666666666666666,"Personal weapons, includes beating",7
70340927,2,"Charlotte-Gastonia-Concord, NC-SC",16,21,14,0.6666666666666666,Strangulation - hanging,7
77241749,1,"Columbus, GA-AL",14,21,14,0.6666666666666666,Rifle,7
81827387,2,"Denver-Aurora, CO",4,21,14,0.6666666666666666,Fire,7
83754610,2,"Santa Cruz-Watsonville, CA",7,21,14,0.6666666666666666,Knife or cutting instrument,7
86678904,2,"Poughkeepsie-Newburgh-Middletown, NY",10,21,14,0.6666666666666666,Other or type unknown,7
97661704,2,"Goldsboro, NC",11,21,14,0.6666666666666666,"Personal weapons, includes beating",7
9009752,1,"Reading, PA",1,20,13,0.65,"Blunt object - hammer, club, etc",7
11019922,2,"Durham, NC",5,20,13,0.65,"Firearm, type not stated",7
39207997,9,Rural Alabama,6,20,13,0.65,"Handgun - pistol, revolver, etc",7
61291145,2,"Huntington-Ashland, WV-KY-OH",10,20,13,0.65,Other or type unknown,7
62887313,2,"Brownsville-Harlingen, TX",10,20,13,0.65,Other or type unknown,7
71967707,1,Rural Michigan,4,20,13,0.65,Fire,7
73313824,1,"Santa Cruz-Watsonville, CA",1,20,13,0.65,"Blunt object - hammer, club, etc",7
92982318,2,"Tyler, TX",7,20,13,0.65,Knife or cutting instrument,7
24231140,2,"Durham, NC",1,19,12,0.631578947368421,"Blunt object - hammer, club, etc",7
77470810,1,"Hattiesburg, MS",5,19,12,0.631578947368421,"Firearm, type not stated",7
89236544,1,"Canton-Massillon, OH",1,19,12,0.631578947368421,"Blunt object - hammer, club, etc",7
90367516,1,"Boston-Cambridge-Quincy, MA-NH",0,19,12,0.631578947368421,Asphyxiation - includes death by gas,7
4265479,2,"Memphis, TN-MS-AR",0,18,11,0.6111111111111112,Asphyxiation - includes death by gas,7
22064817,2,"Toledo, OH",0,18,11,0.6111111111111112,Asphyxiation - includes death by gas,7
22746820,2,"Lakeland, FL",1,18,11,0.6111111111111112,"Blunt object - hammer, club, etc",7
32551392,1,"Nashville-Davidson-Murfreesboro, TN",4,18,11,0.6111111111111112,Fire,7
69106547,1,"Johnstown, PA",7,18,11,0.6111111111111112,Knife or cutting instrument,7
8461701,1,"Yuba City, CA",10,17,10,0.5882352941176471,Other or type unknown,7
49873218,2,"Visalia-Porterville, CA",16,17,10,0.5882352941176471,Strangulation - hanging,7
60204025,2,"Riverside-San Bernardino, CA",2,17,10,0.5882352941176471,Drowning,7
47772656,1,"Racine, WI",10,16,9,0.5625,Other or type unknown,7
50935456,2,"Visalia-Porterville, CA",1,16,9,0.5625,"Blunt object - hammer, club, etc",7
65217483,1,"Lawton, OK",5,16,9,0.5625,"Firearm, type not stated",7
65419695,2,"Bridgeport-Stamford-Norwalk, CT",16,16,9,0.5625,Strangulation - hanging,7
69973199,1,Rural Nevada,5,16,9,0.5625,"Firearm, type not stated",7
78344345,1,"Tucson, AZ",16,16,9,0.5625,Strangulation - hanging,7
98469742,1,"San Jose-Sunnyvale-Santa Clara, CA",4,16,9,0.5625,Fire,7
5025443,2,"Gadsden, AL",7,15,8,0.5333333333333333,Knife or cutting instrument,7
19999564,1,"Albany-Schenectady-Troy, NY",17,15,8,0.5333333333333333,Weapon Not Reported,7
113526,2,"South Bend-Mishawaka, IN-MI",10,14,7,0.5,Other or type unknown,7
35043593,1,"Santa Cruz-Watsonville, CA",15,14,7,0.5,Shotgun,7
58594754,2,Rural Pennsylvania,16,14,7,0.5,Strangulation - hanging,7
59835943,2,"Flint, MI",4,14,7,0.5,Fire,7
61146591,2,"Houma-Bayou Cane-Thibodaux, LA",5,14,7,0.5,"Firearm, type not stated",7
17093634,1,"Alexandria, LA",1,13,6,0.46153846153846156,"Blunt object - hammer, club, etc",7
56749194,2,"Savannah, GA",16,13,6,0.46153846153846156,Strangulation - hanging,7
80203513,1,"Altoona, PA",10,13,6,0.46153846153846156,Other or type unknown,7
89245516,1,"Pueblo, CO",5,13,6,0.46153846153846156,"Firearm, type not stated",7
96675903,1,"Stockton, CA",4,13,6,0.46153846153846156,Fire,7
39485234,1,"Jefferson City, MO",5,12,5,0.4166666666666667,"Firearm, type not stated",7
41168926,9,"Detroit-Warren-Livonia, MI",5,12,5,0.4166666666666667,"Firearm, type not stated",7
20693066,9,"Washington-Arlington-Alexandria, DC-VA-MD-WV",7,11,4,0.36363636363636365,Knife or cutting instrument,7
28535257,2,"Racine, WI",10,11,4,0.36363636363636365,Other or type unknown,7
63045115,1,"Spartanburg, SC",4,11,4,0.36363636363636365,Fire,7
66016928,2,"St. Louis, MO-IL",9,11,4,0.36363636363636365,Other gun,7
96496832,2,"Atlantic City, NJ",10,11,4,0.36363636363636365,Other or type unknown,7
10578921,1,"Gainesville, FL",10,10,3,0.3,Other or type unknown,7
15960423,1,"Las Vegas-Paradise, NV",9,10,3,0.3,Other gun,7
47184204,9,"Atlanta-Sandy Springs-Marietta, GA",10,9,2,0.2222222222222222,Other or type unknown,7
14269318,2,"Memphis, TN-MS-AR",17,7,0,0.0,Weapon Not Reported,7
19752093,1,Rural South Carolina,17,7,0,0.0,Weapon Not Reported,7
23295064,1,"Macon, GA",17,7,0,0.0,Weapon Not Reported,7
28348562,1,"St. Louis, MO-IL",3,7,0,0.0,Explosives,7
44115925,2,"Los Angeles-Long Beach, CA",17,7,0,0.0,Weapon Not Reported,7
44553863,1,"Birmingham-Hoover, AL",17,7,0,0.0,Weapon Not Reported,7
45766364,1,"El Paso, TX",17,7,0,0.0,Weapon Not Reported,7
49307978,1,"Phoenix-Mesa-Scottsdale, AZ",17,7,0,0.0,Weapon Not Reported,7
50326458,1,"Houma-Bayou Cane-Thibodaux, LA",17,7,0,0.0,Weapon Not Reported,7
50540837,9,"New York-New Jersey-Long Island, NY-NJ",7,7,0,0.0,Knife or cutting instrument,7
63903474,9,"Riverside-San Bernardino, CA",10,7,0,0.0,Other or type unknown,7
68209276,2,"Milwaukee-Waukesha-West Allis, WI",17,7,0,0.0,Weapon Not Reported,7
69793617,1,"Dayton, OH",17,7,0,0.0,Weapon Not Reported,7
73274011,2,"Phoenix-Mesa-Scottsdale, AZ",17,7,0,0.0,Weapon Not Reported,7
76126098,2,"Detroit-Warren-Livonia, MI",17,7,0,0.0,Weapon Not Reported,7
40785428,1,"Charleston-North Charleston, SC",7,212,206,0.9716981132075472,Knife or cutting instrument,6
68627874,2,Rural South Carolina,7,173,167,0.9653179190751445,Knife or cutting instrument,6
97408508,2,Rural Wisconsin,6,119,113,0.9495798319327731,"Handgun - pistol, revolver, etc",6
62215225,1,"Ogden-Clearfield, UT",6,116,110,0.9482758620689655,"Handgun - pistol, revolver, etc",6
57684912,1,Rural Maine,6,112,106,0.9464285714285714,"Handgun - pistol, revolver, etc",6
74331868,1,Rural Florida,11,109,103,0.944954128440367,"Personal weapons, includes beating",6
6067346,2,"Hickory-Lenoir-Morganton, NC",6,108,102,0.9444444444444444,"Handgun - pistol, revolver, etc",6
39177794,2,"Atlanta-Sandy Springs-Marietta, GA",15,108,102,0.9444444444444444,Shotgun,6
85518390,2,"Sarasota-Bradenton-Venice, FL",6,102,96,0.9411764705882353,"Handgun - pistol, revolver, etc",6
7863514,2,Rural Colorado,6,98,92,0.9387755102040817,"Handgun - pistol, revolver, etc",6
78874533,1,"Spartanburg, SC",7,89,83,0.9325842696629213,Knife or cutting instrument,6
95217254,1,Rural Utah,6,89,83,0.9325842696629213,"Handgun - pistol, revolver, etc",6
11839068,1,"Baton Rouge, LA",11,86,80,0.9302325581395349,"Personal weapons, includes beating",6
7516363,2,Rural Pennsylvania,14,85,79,0.9294117647058824,Rifle,6
74534622,1,"Hartford, CT",11,84,78,0.9285714285714286,"Personal weapons, includes beating",6
52904160,1,"Lake Charles, LA",7,82,76,0.926829268292683,Knife or cutting instrument,6
64385220,2,Rural Iowa,6,77,71,0.922077922077922,"Handgun - pistol, revolver, etc",6
92105844,1,"Knoxville, TN",15,76,70,0.9210526315789473,Shotgun,6
68693427,1,"Gulfport-Biloxi, MS",7,74,68,0.918918918918919,Knife or cutting instrument,6
87131165,2,"Richmond, VA",15,74,68,0.918918918918919,Shotgun,6
12814345,2,Rural Florida,11,73,67,0.9178082191780822,"Personal weapons, includes beating",6
43718786,2,"Scranton--Wilkes-Barre, PA",6,73,67,0.9178082191780822,"Handgun - pistol, revolver, etc",6
48219813,1,"Chattanooga, TN-GA",15,73,67,0.9178082191780822,Shotgun,6
69110675,1,Rural Nebraska,7,73,67,0.9178082191780822,Knife or cutting instrument,6
37836309,2,"Charleston, WV",6,72,66,0.9166666666666666,"Handgun - pistol, revolver, etc",6
56073007,1,"Wilmington, NC",7,72,66,0.9166666666666666,Knife or cutting instrument,6
79002395,2,Rural Wyoming,6,72,66,0.9166666666666666,"Handgun - pistol, revolver, etc",6
84129260,2,"Cleveland-Elyria-Mentor, OH",15,71,65,0.9154929577464789,Shotgun,6
81372330,2,"Waco, TX",6,69,63,0.9130434782608695,"Handgun - pistol, revolver, etc",6
15495234,2,"Port St. Lucie-Fort Pierce, FL",6,68,62,0.9117647058823529,"Handgun - pistol, revolver, etc",6
81467587,2,"Gulfport-Biloxi, MS",6,68,62,0.9117647058823529,"Handgun - pistol, revolver, etc",6
41119492,1,Rural New Hampshire,6,67,61,0.9104477611940298,"Handgun - pistol, revolver, etc",6
90376587,1,"Greensboro-High Point, NC",11,67,61,0.9104477611940298,"Personal weapons, includes beating",6
80587805,1,"Dalton, GA",6,65,59,0.9076923076923077,"Handgun - pistol, revolver, etc",6
21248384,2,"Columbus, OH",15,62,56,0.9032258064516129,Shotgun,6
76173067,1,Rural Idaho,7,62,56,0.9032258064516129,Knife or cutting instrument,6
71702958,2,"Las Vegas-Paradise, NV",14,61,55,0.9016393442622951,Rifle,6
47197523,1,"Charleston-North Charleston, SC",1,59,53,0.8983050847457628,"Blunt object - hammer, club, etc",6
57329502,2,"Santa Barbara-Santa Maria, CA",6,59,53,0.8983050847457628,"Handgun - pistol, revolver, etc",6
2685068,1,"Canton-Massillon, OH",7,57,51,0.8947368421052632,Knife or cutting instrument,6
18999937,1,"Wichita, KS",15,57,51,0.8947368421052632,Shotgun,6
20917305,2,"Birmingham-Hoover, AL",15,57,51,0.8947368421052632,Shotgun,6
68414672,1,"Vero Beach, FL",6,57,51,0.8947368421052632,"Handgun - pistol, revolver, etc",6
13407025,1,"Green Bay, WI",6,56,50,0.8928571428571429,"Handgun - pistol, revolver, etc",6
607179,1,"Bloomington, IN",6,55,49,0.8909090909090909,"Handgun - pistol, revolver, etc",6
22197051,2,"Nashville-Davidson-Murfreesboro, TN",15,54,48,0.8888888888888888,Shotgun,6
22630191,1,"Las Cruces, NM",7,54,48,0.8888888888888888,Knife or cutting instrument,6
11571150,1,"Greenville, SC",1,53,47,0.8867924528301887,"Blunt object - hammer, club, etc",6
1597948,1,"Fairbanks, AK",6,52,46,0.8846153846153846,"Handgun - pistol, revolver, etc",6
32623436,2,"Wichita, KS",11,52,46,0.8846153846153846,"Personal weapons, includes beating",6
48762643,2,"Indianapolis, IN",15,51,45,0.8823529411764706,Shotgun,6
97449298,1,"Wheeling, WV-OH",6,51,45,0.8823529411764706,"Handgun - pistol, revolver, etc",6
50275860,2,"Syracuse, NY",11,50,44,0.88,"Personal weapons, includes beating",6
54692716,2,"Sarasota-Bradenton-Venice, FL",11,50,44,0.88,"Personal weapons, includes beating",6
74132194,1,"Huntington-Ashland, WV-KY-OH",7,50,44,0.88,Knife or cutting instrument,6
13212360,2,"Wichita, KS",7,49,43,0.8775510204081632,Knife or cutting instrument,6
13220404,1,"Visalia-Porterville, CA",11,49,43,0.8775510204081632,"Personal weapons, includes beating",6
27090969,2,"Los Angeles-Long Beach, CA",8,49,43,0.8775510204081632,"Narcotics or drugs, sleeping pills",6
42062807,1,"Spokane, WA",11,49,43,0.8775510204081632,"Personal weapons, includes beating",6
27969667,1,"Vallejo-Fairfield, CA",11,48,42,0.875,"Personal weapons, includes beating",6
38208954,1,"Hanford-Corcoran, CA",7,48,42,0.875,Knife or cutting instrument,6
61760741,2,Rural Missouri,15,48,42,0.875,Shotgun,6
1449035,1,"Knoxville, TN",11,47,41,0.8723404255319149,"Personal weapons, includes beating",6
31675733,1,Rural Alabama,1,47,41,0.8723404255319149,"Blunt object - hammer, club, etc",6
4160559,1,"Honolulu, HI",14,45,39,0.8666666666666667,Rifle,6
17887645,2,Rural New Mexico,10,45,39,0.8666666666666667,Other or type unknown,6
97771527,2,"Charleston, WV",7,45,39,0.8666666666666667,Knife or cutting instrument,6
15904170,2,"Greenville, NC",6,44,38,0.8636363636363636,"Handgun - pistol, revolver, etc",6
16675952,2,"Fayetteville, NC",7,44,38,0.8636363636363636,Knife or cutting instrument,6
56356681,1,"Wichita Falls, TX",15,44,38,0.8636363636363636,Shotgun,6
82966587,2,"Spartanburg, SC",7,44,38,0.8636363636363636,Knife or cutting instrument,6
16256632,1,"Auburn-Opelika, AL",5,43,37,0.8604651162790697,"Firearm, type not stated",6
84736389,1,"Chattanooga, TN-GA",14,43,37,0.8604651162790697,Rifle,6
72524516,1,"Danville, VA",7,42,36,0.8571428571428571,Knife or cutting instrument,6
48151452,1,"Florence, SC",14,41,35,0.8536585365853658,Rifle,6
50369842,1,"Montgomery, AL",14,41,35,0.8536585365853658,Rifle,6
62592526,1,"Columbus, GA-AL",10,41,35,0.8536585365853658,Other or type unknown,6
85833966,2,"Memphis, TN-MS-AR",14,41,35,0.8536585365853658,Rifle,6
52624208,1,"New Haven-Milford, CT",15,40,34,0.85,Shotgun,6
32279088,2,Rural California,1,39,33,0.8461538461538461,"Blunt object - hammer, club, etc",6
40520812,2,"Lansing-East Lansing, MI",11,39,33,0.8461538461538461,"Personal weapons, includes beating",6
55483256,2,"Greensboro-High Point, NC",11,39,33,0.8461538461538461,"Personal weapons, includes beating",6
8523638,1,"Merced, CA",11,37,31,0.8378378378378378,"Personal weapons, includes beating",6
6247055,2,"Fresno, CA",15,36,30,0.8333333333333334,Shotgun,6
31255902,2,"Durham, NC",11,36,30,0.8333333333333334,"Personal weapons, includes beating",6
35400054,2,Rural Michigan,1,36,30,0.8333333333333334,"Blunt object - hammer, club, etc",6
54067123,1,"Columbus, GA-AL",1,36,30,0.8333333333333334,"Blunt object - hammer, club, etc",6
74468097,2,"Bridgeport-Stamford-Norwalk, CT",11,36,30,0.8333333333333334,"Personal weapons, includes beating",6
96249374,1,"Hickory-Lenoir-Morganton, NC",11,36,30,0.8333333333333334,"Personal weapons, includes beating",6
9499448,1,"Altoona, PA",6,35,29,0.8285714285714286,"Handgun - pistol, revolver, etc",6
30757645,1,"Akron, OH",1,35,29,0.8285714285714286,"Blunt object - hammer, club, etc",6
92536767,1,"Pine Bluff, AR",14,35,29,0.8285714285714286,Rifle,6
96650536,2,"Evansville, IN-KY",7,35,29,0.8285714285714286,Knife or cutting instrument,6
3132310,1,"Tampa-St. Petersburg-Clearwater, FL",9,34,28,0.8235294117647058,Other gun,6
39023057,2,Rural Alaska,7,34,28,0.8235294117647058,Knife or cutting instrument,6
42439277,1,"Lancaster, PA",10,34,28,0.8235294117647058,Other or type unknown,6
54399246,2,"Port St. Lucie-Fort Pierce, FL",7,34,28,0.8235294117647058,Knife or cutting instrument,6
64257637,1,"South Bend-Mishawaka, IN-MI",15,33,27,0.8181818181818182,Shotgun,6
81385835,1,"Spartanburg, SC",1,33,27,0.8181818181818182,"Blunt object - hammer, club, etc",6
85804538,1,"Reno-Sparks, NV",1,33,27,0.8181818181818182,"Blunt object - hammer, club, etc",6
92886575,1,"Gadsden, AL",7,33,27,0.8181818181818182,Knife or cutting instrument,6
842886,1,"Eugene-Springfield, OR",1,32,26,0.8125,"Blunt object - hammer, club, etc",6
1957096,1,"Longview, TX",1,32,26,0.8125,"Blunt object - hammer, club, etc",6
6987853,2,"Visalia-Porterville, CA",7,32,26,0.8125,Knife or cutting instrument,6
42835357,2,"Tallahassee, FL",11,32,26,0.8125,"Personal weapons, includes beating",6
63941176,1,"Anderson, SC",14,32,26,0.8125,Rifle,6
79433151,1,"Brownsville-Harlingen, TX",10,31,25,0.8064516129032258,Other or type unknown,6
80829862,2,"Springfield, MA",11,31,25,0.8064516129032258,"Personal weapons, includes beating",6
84599574,1,"Cape Coral-Fort Myers, FL",15,31,25,0.8064516129032258,Shotgun,6
96537401,1,"Dallas-Fort Worth-Arlington, TX",0,31,25,0.8064516129032258,Asphyxiation - includes death by gas,6
2583274,2,"Redding, CA",6,30,24,0.8,"Handgun - pistol, revolver, etc",6
6673051,1,"Virginia Beach-Norfolk-Newport News, VA-NC",4,30,24,0.8,Fire,6
23395488,2,Rural Oregon,16,30,24,0.8,Strangulation - hanging,6
33574895,2,"Springfield, IL",10,30,24,0.8,Other or type unknown,6
44219550,2,"Charleston, WV",5,30,24,0.8,"Firearm, type not stated",6
74584797,1,"Flagstaff, AZ",7,30,24,0.8,Knife or cutting instrument,6
95188505,2,"Sacramento-Roseville, CA",0,30,24,0.8,Asphyxiation - includes death by gas,6
4772434,2,"Utica-Rome, NY",7,29,23,0.7931034482758621,Knife or cutting instrument,6
5557906,2,"Kalamazoo-Portage, MI",11,29,23,0.7931034482758621,"Personal weapons, includes beating",6
17802879,2,"Flint, MI",1,29,23,0.7931034482758621,"Blunt object - hammer, club, etc",6
55177653,1,"Huntington-Ashland, WV-KY-OH",1,29,23,0.7931034482758621,"Blunt object - hammer, club, etc",6
71928368,1,"Salt Lake City, UT",15,29,23,0.7931034482758621,Shotgun,6
27411802,2,"Reading, PA",7,28,22,0.7857142857142857,Knife or cutting instrument,6
35106463,2,"Elkhart-Goshen, IN",6,28,22,0.7857142857142857,"Handgun - pistol, revolver, etc",6
36678239,2,"Ann Arbor, MI",7,28,22,0.7857142857142857,Knife or cutting instrument,6
42818898,1,"Seattle-Tacoma-Bellevue, WA",8,28,22,0.7857142857142857,"Narcotics or drugs, sleeping pills",6
64259574,2,"Scranton--Wilkes-Barre, PA",1,28,22,0.7857142857142857,"Blunt object - hammer, club, etc",6
78619702,2,"Rockford, IL",10,28,22,0.7857142857142857,Other or type unknown,6
19534657,1,"Billings, MT",5,27,21,0.7777777777777778,"Firearm, type not stated",6
36362918,2,"Winston-Salem, NC",11,27,21,0.7777777777777778,"Personal weapons, includes beating",6
39841141,2,"Pittsburgh, PA",0,27,21,0.7777777777777778,Asphyxiation - includes death by gas,6
79270430,2,Rural Ohio,5,27,21,0.7777777777777778,"Firearm, type not stated",6
94930617,2,Rural Michigan,0,27,21,0.7777777777777778,Asphyxiation - includes death by gas,6
28404918,2,Rural Pennsylvania,5,26,20,0.7692307692307693,"Firearm, type not stated",6
32656324,2,"El Centro, CA",6,26,20,0.7692307692307693,"Handgun - pistol, revolver, etc",6
78312178,1,"Cape Coral-Fort Myers, FL",14,26,20,0.7692307692307693,Rifle,6
95204733,1,"Merced, CA",14,26,20,0.7692307692307693,Rifle,6
96411206,2,Rural Colorado,10,26,20,0.7692307692307693,Other or type unknown,6
96997528,1,"Lansing-East Lansing, MI",1,26,20,0.7692307692307693,"Blunt object - hammer, club, etc",6
3928366,2,"Columbus, GA-AL",10,25,19,0.76,Other or type unknown,6
4273472,2,"El Paso, TX",1,25,19,0.76,"Blunt object - hammer, club, etc",6
6733458,2,Rural Pennsylvania,8,25,19,0.76,"Narcotics or drugs, sleeping pills",6
39231242,2,"Jacksonville, NC",6,25,19,0.76,"Handgun - pistol, revolver, etc",6
62974050,2,"Lexington-Fayette, KY",5,25,19,0.76,"Firearm, type not stated",6
63943260,2,"San Diego-Carlsbad-San Marcos, CA",0,25,19,0.76,Asphyxiation - includes death by gas,6
20753454,1,"Laredo, TX",14,24,18,0.75,Rifle,6
32725189,1,"Des Moines, IA",1,24,18,0.75,"Blunt object - hammer, club, etc",6
54809931,2,"Battle Creek, MI",7,24,18,0.75,Knife or cutting instrument,6
94969838,2,"Springfield, MO",7,24,18,0.75,Knife or cutting instrument,6
31365038,2,"Albany-Schenectady-Troy, NY",1,23,17,0.7391304347826086,"Blunt object - hammer, club, etc",6
32157307,1,"Charlottesville, VA",5,23,17,0.7391304347826086,"Firearm, type not stated",6
32227660,2,"Eugene-Springfield, OR",7,23,17,0.7391304347826086,Knife or cutting instrument,6
42757833,2,Rural Iowa,1,23,17,0.7391304347826086,"Blunt object - hammer, club, etc",6
48774424,1,"Roanoke, VA",1,23,17,0.7391304347826086,"Blunt object - hammer, club, etc",6
51498877,2,"Des Moines, IA",5,23,17,0.7391304347826086,"Firearm, type not stated",6
96065268,1,"Yakima, WA",11,23,17,0.7391304347826086,"Personal weapons, includes beating",6
7298992,2,"San Antonio, TX",0,22,16,0.7272727272727273,Asphyxiation - includes death by gas,6
20095218,1,"Elmira, NY",6,22,16,0.7272727272727273,"Handgun - pistol, revolver, etc",6
28086044,2,"Albany, GA",10,22,16,0.7272727272727273,Other or type unknown,6
32535942,1,Rural Alaska,1,22,16,0.7272727272727273,"Blunt object - hammer, club, etc",6
40495049,1,Rural Idaho,1,22,16,0.7272727272727273,"Blunt object - hammer, club, etc",6
46464671,2,"Ann Arbor, MI",10,22,16,0.7272727272727273,Other or type unknown,6
68292760,2,"Knoxville, TN",5,22,16,0.7272727272727273,"Firearm, type not stated",6
74973223,1,"Pascagoula, MS",5,22,16,0.7272727272727273,"Firearm, type not stated",6
85814462,1,Rural Vermont,5,22,16,0.7272727272727273,"Firearm, type not stated",6
88801893,2,"Battle Creek, MI",6,22,16,0.7272727272727273,"Handgun - pistol, revolver, etc",6
54939703,1,"Greenville, NC",9,21,15,0.7142857142857143,Other gun,6
62449916,1,"San Angelo, TX",5,21,15,0.7142857142857143,"Firearm, type not stated",6
71300623,1,"Elkhart-Goshen, IN",10,21,15,0.7142857142857143,Other or type unknown,6
72401275,2,"Grand Rapids-Wyoming, MI",5,21,15,0.7142857142857143,"Firearm, type not stated",6
79167578,2,"Killeen-Temple-Fort Hood, TX",5,21,15,0.7142857142857143,"Firearm, type not stated",6
85140229,1,"San Francisco-Oakland-Fremont, CA",8,21,15,0.7142857142857143,"Narcotics or drugs, sleeping pills",6
97378115,2,"Wichita Falls, TX",7,21,15,0.7142857142857143,Knife or cutting instrument,6
2843438,2,"Janesville, WI",7,20,14,0.7,Knife or cutting instrument,6
37975450,2,"Fort Smith, AR-OK",10,20,14,0.7,Other or type unknown,6
38051288,2,"Akron, OH",4,20,14,0.7,Fire,6
43556151,2,"Detroit-Warren-Livonia, MI",3,20,14,0.7,Explosives,6
57143612,1,"Richmond, VA",4,20,14,0.7,Fire,6
71017972,2,"Spokane, WA",5,20,14,0.7,"Firearm, type not stated",6
73147386,2,Rural Maine,10,20,14,0.7,Other or type unknown,6
99469682,2,"Stockton, CA",16,20,14,0.7,Strangulation - hanging,6
6152922,1,"Racine, WI",5,19,13,0.6842105263157895,"Firearm, type not stated",6
20176913,2,"Lawton, OK",10,19,13,0.6842105263157895,Other or type unknown,6
20336082,2,"Wichita, KS",1,19,13,0.6842105263157895,"Blunt object - hammer, club, etc",6
27424546,1,"Montgomery, AL",1,19,13,0.6842105263157895,"Blunt object - hammer, club, etc",6
31277655,2,"Gulfport-Biloxi, MS",10,19,13,0.6842105263157895,Other or type unknown,6
37753188,2,"Salinas, CA",1,19,13,0.6842105263157895,"Blunt object - hammer, club, etc",6
39510123,2,"Salinas, CA",10,19,13,0.6842105263157895,Other or type unknown,6
58811746,1,"Bridgeport-Stamford-Norwalk, CT",8,19,13,0.6842105263157895,"Narcotics or drugs, sleeping pills",6
60120949,2,"Allentown-Bethlehem-Easton, PA-NJ",0,19,13,0.6842105263157895,Asphyxiation - includes death by gas,6
75359422,1,"Asheville, NC",9,19,13,0.6842105263157895,Other gun,6
77978011,2,"Fort Walton Beach-Destin, FL",7,19,13,0.6842105263157895,Knife or cutting instrument,6
45763373,2,"Saginaw, MI",1,18,12,0.6666666666666666,"Blunt object - hammer, club, etc",6
62319973,2,"Harrisburg-Carlisle, PA",1,18,12,0.6666666666666666,"Blunt object - hammer, club, etc",6
72872823,2,"Deltona-Daytona Beach-Ormond Beach, FL",1,18,12,0.6666666666666666,"Blunt object - hammer, club, etc",6
10738324,2,"Bridgeport-Stamford-Norwalk, CT",1,17,11,0.6470588235294118,"Blunt object - hammer, club, etc",6
16281749,1,"Dalton, GA",10,17,11,0.6470588235294118,Other or type unknown,6
59626720,1,"Deltona-Daytona Beach-Ormond Beach, FL",9,17,11,0.6470588235294118,Other gun,6
62089359,1,"Baltimore-Towson, MD",9,17,11,0.6470588235294118,Other gun,6
93417880,2,"Sacramento-Roseville, CA",2,17,11,0.6470588235294118,Drowning,6
12663245,1,"Gadsden, AL",5,16,10,0.625,"Firearm, type not stated",6
16036048,1,"Elizabethtown, KY",5,16,10,0.625,"Firearm, type not stated",6
46833808,2,"Savannah, GA",1,16,10,0.625,"Blunt object - hammer, club, etc",6
48690513,2,"Bowling Green, KY",7,16,10,0.625,Knife or cutting instrument,6
87583647,1,"Spartanburg, SC",10,16,10,0.625,Other or type unknown,6
7751030,2,"Santa Rosa-Petaluma, CA",10,15,9,0.6,Other or type unknown,6
21636728,1,"Tulsa, OK",16,15,9,0.6,Strangulation - hanging,6
33732738,2,"New Haven-Milford, CT",16,15,9,0.6,Strangulation - hanging,6
43357612,2,"Niles-Benton Harbor, MI",10,15,9,0.6,Other or type unknown,6
56672479,2,"Battle Creek, MI",10,15,9,0.6,Other or type unknown,6
64572052,2,"Alexandria, LA",10,15,9,0.6,Other or type unknown,6
98287969,1,"San Jose-Sunnyvale-Santa Clara, CA",16,15,9,0.6,Strangulation - hanging,6
98483961,2,"Atlantic City, NJ",16,15,9,0.6,Strangulation - hanging,6
11248222,1,"Burlington, NC",9,14,8,0.5714285714285714,Other gun,6
67484328,2,"Vallejo-Fairfield, CA",10,14,8,0.5714285714285714,Other or type unknown,6
96841820,2,"Goldsboro, NC",9,14,8,0.5714285714285714,Other gun,6
97772180,2,"Santa Fe, NM",1,14,8,0.5714285714285714,"Blunt object - hammer, club, etc",6
3169954,1,"Augusta-Richmond County, GA-SC",9,13,7,0.5384615384615384,Other gun,6
18940063,1,"Victoria, TX",10,13,7,0.5384615384615384,Other or type unknown,6
34752654,2,"Grand Rapids-Wyoming, MI",16,13,7,0.5384615384615384,Strangulation - hanging,6
36074444,9,"Birmingham-Hoover, AL",6,13,7,0.5384615384615384,"Handgun - pistol, revolver, etc",6
53543893,2,"Visalia-Porterville, CA",5,13,7,0.5384615384615384,"Firearm, type not stated",6
89971982,1,"Jackson, MI",1,13,7,0.5384615384615384,"Blunt object - hammer, club, etc",6
52401068,2,"Fort Walton Beach-Destin, FL",10,12,6,0.5,Other or type unknown,6
54988952,2,"Roanoke, VA",1,12,6,0.5,"Blunt object - hammer, club, etc",6
66382981,1,"Vero Beach, FL",10,12,6,0.5,Other or type unknown,6
91731688,2,"Fayetteville, NC",9,12,6,0.5,Other gun,6
2579905,1,"Dayton, OH",9,11,5,0.45454545454545453,Other gun,6
63365532,1,"Bakersfield, CA",0,11,5,0.45454545454545453,Asphyxiation - includes death by gas,6
77755780,2,"Santa Rosa-Petaluma, CA",16,11,5,0.45454545454545453,Strangulation - hanging,6
27224221,2,"Albany, GA",16,10,4,0.4,Strangulation - hanging,6
64653556,2,"Killeen-Temple-Fort Hood, TX",1,10,4,0.4,"Blunt object - hammer, club, etc",6
71900015,1,"Michigan City-La Porte, IN",5,10,4,0.4,"Firearm, type not stated",6
76439146,1,Rural Hawaii,5,10,4,0.4,"Firearm, type not stated",6
92109044,2,"Merced, CA",1,10,4,0.4,"Blunt object - hammer, club, etc",6
95561220,1,"Sacramento-Roseville, CA",9,10,4,0.4,Other gun,6
12517625,9,"Detroit-Warren-Livonia, MI",6,9,3,0.3333333333333333,"Handgun - pistol, revolver, etc",6
64703921,2,"Lakeland, FL",16,9,3,0.3333333333333333,Strangulation - hanging,6
66415327,1,"Oxnard-Thousand Oaks-Ventura, CA",16,9,3,0.3333333333333333,Strangulation - hanging,6
74781083,1,"Johnstown, PA",5,9,3,0.3333333333333333,"Firearm, type not stated",6
90941500,1,"Bowling Green, KY",10,9,3,0.3333333333333333,Other or type unknown,6
47201304,1,"Reading, PA",4,8,2,0.25,Fire,6
60921000,2,Rural Florida,16,8,2,0.25,Strangulation - hanging,6
68731376,9,"Chicago-Naperville-Joliet, IL-IN-WI",10,8,2,0.25,Other or type unknown,6
87647319,2,"Anchorage, AK",4,8,2,0.25,Fire,6
97133300,1,"Fairbanks, AK",10,8,2,0.25,Other or type unknown,6
52024902,1,"Allentown-Bethlehem-Easton, PA-NJ",16,7,1,0.14285714285714285,Strangulation - hanging,6
67616871,2,"Knoxville, TN",16,7,1,0.14285714285714285,Strangulation - hanging,6
77331993,9,"San Antonio, TX",5,7,1,0.14285714285714285,"Firearm, type not stated",6
83553050,9,"Mobile, AL",5,7,1,0.14285714285714285,"Firearm, type not stated",6
90809778,2,"Canton-Massillon, OH",10,7,1,0.14285714285714285,Other or type unknown,6
7958397,1,"Kansas City, MO-KS",17,6,0,0.0,Weapon Not Reported,6
17588785,2,"Vallejo-Fairfield, CA",17,6,0,0.0,Weapon Not Reported,6
24442019,2,"Riverside-San Bernardino, CA",17,6,0,0.0,Weapon Not Reported,6
42398821,2,"Muncie, IN",17,6,0,0.0,Weapon Not Reported,6
51774616,2,"Springfield, IL",17,6,0,0.0,Weapon Not Reported,6
70446124,1,"Denver-Aurora, CO",17,6,0,0.0,Weapon Not Reported,6
78741607,1,"Oklahoma City, OK",17,6,0,0.0,Weapon Not Reported,6
93533629,2,Rural Arkansas,17,6,0,0.0,Weapon Not Reported,6
94217239,1,"Charlotte-Gastonia-Concord, NC-SC",17,6,0,0.0,Weapon Not Reported,6
15220472,2,Rural South Carolina,11,129,124,0.9612403100775194,"Personal weapons, includes beating",5
92890567,1,Rural South Carolina,11,119,114,0.957983193277311,"Personal weapons, includes beating",5
1793657,1,"Eugene-Springfield, OR",6,101,96,0.9504950495049505,"Handgun - pistol, revolver, etc",5
37422599,1,"Johnson City, TN",6,96,91,0.9479166666666666,"Handgun - pistol, revolver, etc",5
61510177,2,Rural Louisiana,15,96,91,0.9479166666666666,Shotgun,5
68949973,1,Rural Wisconsin,15,87,82,0.9425287356321839,Shotgun,5
50397535,2,"Honolulu, HI",6,85,80,0.9411764705882353,"Handgun - pistol, revolver, etc",5
45620338,1,"Corpus Christi, TX",11,84,79,0.9404761904761905,"Personal weapons, includes beating",5
35467657,2,Rural Nebraska,6,79,74,0.9367088607594937,"Handgun - pistol, revolver, etc",5
57052771,1,Rural Oregon,15,77,72,0.935064935064935,Shotgun,5
17740189,2,"Alexandria, LA",6,76,71,0.9342105263157895,"Handgun - pistol, revolver, etc",5
31477123,2,Rural Florida,5,76,71,0.9342105263157895,"Firearm, type not stated",5
73403767,1,"Boulder, CO",6,74,69,0.9324324324324325,"Handgun - pistol, revolver, etc",5
52556397,1,"Farmington, NM",6,70,65,0.9285714285714286,"Handgun - pistol, revolver, etc",5
21528732,2,"Reno-Sparks, NV",6,69,64,0.927536231884058,"Handgun - pistol, revolver, etc",5
49398712,2,"McAllen-Edinburg-Mission, TX",7,69,64,0.927536231884058,Knife or cutting instrument,5
98713688,2,"Toledo, OH",11,69,64,0.927536231884058,"Personal weapons, includes beating",5
18817899,2,Rural Nevada,6,67,62,0.9253731343283582,"Handgun - pistol, revolver, etc",5
74825224,1,"Huntsville, AL",15,66,61,0.9242424242424242,Shotgun,5
896243,2,"Tucson, AZ",11,65,60,0.9230769230769231,"Personal weapons, includes beating",5
20450366,2,"Springfield, MO",6,64,59,0.921875,"Handgun - pistol, revolver, etc",5
55762084,2,"Amarillo, TX",6,64,59,0.921875,"Handgun - pistol, revolver, etc",5
72208610,1,Rural North Dakota,6,64,59,0.921875,"Handgun - pistol, revolver, etc",5
38550451,1,"Jefferson City, MO",6,63,58,0.9206349206349206,"Handgun - pistol, revolver, etc",5
7655416,2,"Miami-Fort Lauderdale, FL",15,62,57,0.9193548387096774,Shotgun,5
89698761,1,"Reno-Sparks, NV",11,62,57,0.9193548387096774,"Personal weapons, includes beating",5
13382719,1,"Dothan, AL",7,61,56,0.9180327868852459,Knife or cutting instrument,5
23356597,2,"Tyler, TX",6,61,56,0.9180327868852459,"Handgun - pistol, revolver, etc",5
25518032,2,"Pueblo, CO",6,61,56,0.9180327868852459,"Handgun - pistol, revolver, etc",5
63019446,1,"Modesto, CA",15,61,56,0.9180327868852459,Shotgun,5
57777079,1,"Billings, MT",6,60,55,0.9166666666666666,"Handgun - pistol, revolver, etc",5
33038433,1,"Hinesville-Fort Stewart, GA",6,59,54,0.9152542372881356,"Handgun - pistol, revolver, etc",5
42520417,2,"San Diego-Carlsbad-San Marcos, CA",14,59,54,0.9152542372881356,Rifle,5
18159791,2,"Rochester, NY",15,57,52,0.9122807017543859,Shotgun,5
18255702,1,"Niles-Benton Harbor, MI",7,57,52,0.9122807017543859,Knife or cutting instrument,5
24563783,2,"Reading, PA",6,54,49,0.9074074074074074,"Handgun - pistol, revolver, etc",5
80731379,2,"Dallas-Fort Worth-Arlington, TX",0,54,49,0.9074074074074074,Asphyxiation - includes death by gas,5
89427099,1,Rural Wyoming,14,54,49,0.9074074074074074,Rifle,5
13624963,1,"Texarkana, TX-Texarkana, AR",7,53,48,0.9056603773584906,Knife or cutting instrument,5
90189738,1,Rural Arizona,15,53,48,0.9056603773584906,Shotgun,5
499667,1,"Beaumont-Port Arthur, TX",11,52,47,0.9038461538461539,"Personal weapons, includes beating",5
90844833,1,"York-Hanover, PA",7,52,47,0.9038461538461539,Knife or cutting instrument,5
91220947,1,"Greenville, NC",7,52,47,0.9038461538461539,Knife or cutting instrument,5
93240711,2,Rural Ohio,15,52,47,0.9038461538461539,Shotgun,5
69216131,1,"Mount Vernon-Anacortes, WA",6,51,46,0.9019607843137255,"Handgun - pistol, revolver, etc",5
72492812,2,"Clarksville, TN-KY",6,51,46,0.9019607843137255,"Handgun - pistol, revolver, etc",5
16647328,1,"Boise City-Nampa, ID",7,50,45,0.9,Knife or cutting instrument,5
52619551,1,"Oxnard-Thousand Oaks-Ventura, CA",11,50,45,0.9,"Personal weapons, includes beating",5
10690531,2,"Baltimore-Towson, MD",14,49,44,0.8979591836734694,Rifle,5
42494753,1,"Columbus, GA-AL",15,49,44,0.8979591836734694,Shotgun,5
86787055,1,"Tuscaloosa, AL",7,49,44,0.8979591836734694,Knife or cutting instrument,5
2282217,1,"Omaha-Council Bluffs, NE-IA",10,48,43,0.8958333333333334,Other or type unknown,5
17385657,1,"Wichita, KS",11,48,43,0.8958333333333334,"Personal weapons, includes beating",5
19709731,1,"Syracuse, NY",11,48,43,0.8958333333333334,"Personal weapons, includes beating",5
24653975,1,"Yuba City, CA",7,48,43,0.8958333333333334,Knife or cutting instrument,5
22535833,2,"Florence, SC",7,47,42,0.8936170212765957,Knife or cutting instrument,5
41608953,1,"Cape Coral-Fort Myers, FL",11,47,42,0.8936170212765957,"Personal weapons, includes beating",5
19805451,2,"Springfield, IL",6,46,41,0.8913043478260869,"Handgun - pistol, revolver, etc",5
30465031,1,"Rapid City, SD",6,46,41,0.8913043478260869,"Handgun - pistol, revolver, etc",5
64041140,1,"Manchester-Nashua, NH",7,46,41,0.8913043478260869,Knife or cutting instrument,5
94202363,2,"Poughkeepsie-Newburgh-Middletown, NY",6,46,41,0.8913043478260869,"Handgun - pistol, revolver, etc",5
9518311,2,"Denver-Aurora, CO",0,45,40,0.8888888888888888,Asphyxiation - includes death by gas,5
64251934,2,"Greenville, SC",5,45,40,0.8888888888888888,"Firearm, type not stated",5
69228461,1,Rural Arizona,11,45,40,0.8888888888888888,"Personal weapons, includes beating",5
87484452,2,"Valdosta, GA",6,45,40,0.8888888888888888,"Handgun - pistol, revolver, etc",5
35193280,2,"Lawton, OK",6,44,39,0.8863636363636364,"Handgun - pistol, revolver, etc",5
35980795,2,Rural Tennessee,14,44,39,0.8863636363636364,Rifle,5
18136857,1,"Winston-Salem, NC",11,43,38,0.8837209302325582,"Personal weapons, includes beating",5
93249078,1,Rural Wisconsin,8,43,38,0.8837209302325582,"Narcotics or drugs, sleeping pills",5
99765331,2,Rural Alabama,14,43,38,0.8837209302325582,Rifle,5
26972379,1,"Lubbock, TX",1,42,37,0.8809523809523809,"Blunt object - hammer, club, etc",5
50198166,2,"Jackson, TN",6,42,37,0.8809523809523809,"Handgun - pistol, revolver, etc",5
78181310,2,"Burlington, NC",6,40,35,0.875,"Handgun - pistol, revolver, etc",5
53342347,2,"Lancaster, PA",7,39,34,0.8717948717948718,Knife or cutting instrument,5
61005464,1,"Lake Charles, LA",15,39,34,0.8717948717948718,Shotgun,5
34284953,1,"Pine Bluff, AR",7,38,33,0.868421052631579,Knife or cutting instrument,5
40141791,2,"Racine, WI",6,38,33,0.868421052631579,"Handgun - pistol, revolver, etc",5
66797518,1,"Grand Rapids-Wyoming, MI",14,38,33,0.868421052631579,Rifle,5
98262775,1,"Michigan City-La Porte, IN",7,38,33,0.868421052631579,Knife or cutting instrument,5
88639522,2,"Gadsden, AL",6,37,32,0.8648648648648649,"Handgun - pistol, revolver, etc",5
12263749,2,"Scranton--Wilkes-Barre, PA",7,36,31,0.8611111111111112,Knife or cutting instrument,5
35013391,2,"Augusta-Richmond County, GA-SC",15,36,31,0.8611111111111112,Shotgun,5
64877954,2,"Madison, WI",7,36,31,0.8611111111111112,Knife or cutting instrument,5
65132797,2,"Jacksonville, FL",15,36,31,0.8611111111111112,Shotgun,5
87197347,2,Rural Illinois,11,36,31,0.8611111111111112,"Personal weapons, includes beating",5
3879809,2,"Boise City-Nampa, ID",10,35,30,0.8571428571428571,Other or type unknown,5
15102340,1,"Fayetteville-Springdale-Rogers, AR-MO",5,35,30,0.8571428571428571,"Firearm, type not stated",5
22501184,1,"Lubbock, TX",14,35,30,0.8571428571428571,Rifle,5
43457644,2,Rural Missouri,1,35,30,0.8571428571428571,"Blunt object - hammer, club, etc",5
52862624,1,"Springfield, MO",10,35,30,0.8571428571428571,Other or type unknown,5
69957089,2,"Shreveport-Bossier City, LA",11,35,30,0.8571428571428571,"Personal weapons, includes beating",5
8864362,1,"Springfield, IL",10,34,29,0.8529411764705882,Other or type unknown,5
21576682,1,"Lincoln, NE",7,34,29,0.8529411764705882,Knife or cutting instrument,5
29723153,1,"Fort Smith, AR-OK",5,34,29,0.8529411764705882,"Firearm, type not stated",5
33200498,1,"Trenton-Ewing, NJ",15,34,29,0.8529411764705882,Shotgun,5
54265929,2,"Auburn-Opelika, AL",6,34,29,0.8529411764705882,"Handgun - pistol, revolver, etc",5
81113957,2,"Milwaukee-Waukesha-West Allis, WI",0,34,29,0.8529411764705882,Asphyxiation - includes death by gas,5
14133605,1,"Winston-Salem, NC",1,33,28,0.8484848484848485,"Blunt object - hammer, club, etc",5
14400166,2,"Ocala, FL",11,33,28,0.8484848484848485,"Personal weapons, includes beating",5
38195560,1,Rural Vermont,7,33,28,0.8484848484848485,Knife or cutting instrument,5
74307909,1,"Canton-Massillon, OH",15,33,28,0.8484848484848485,Shotgun,5
76003148,2,"Monroe, LA",7,33,28,0.8484848484848485,Knife or cutting instrument,5
39071670,1,"Gainesville, FL",15,32,27,0.84375,Shotgun,5
48649295,1,"Clarksville, TN-KY",15,32,27,0.84375,Shotgun,5
65806429,2,"Rockford, IL",7,32,27,0.84375,Knife or cutting instrument,5
36519109,1,"Washington-Arlington-Alexandria, DC-VA-MD-WV",8,31,26,0.8387096774193549,"Narcotics or drugs, sleeping pills",5
42686577,2,"Boston-Cambridge-Quincy, MA-NH",0,31,26,0.8387096774193549,Asphyxiation - includes death by gas,5
4375569,2,Rural South Dakota,10,30,25,0.8333333333333334,Other or type unknown,5
25345441,2,"Jacksonville, FL",17,30,25,0.8333333333333334,Weapon Not Reported,5
29461047,2,"Salem, OR",10,30,25,0.8333333333333334,Other or type unknown,5
41383237,2,Rural Florida,1,30,25,0.8333333333333334,"Blunt object - hammer, club, etc",5
90645882,1,"Decatur, AL",7,30,25,0.8333333333333334,Knife or cutting instrument,5
98217737,2,"Provo-Orem, UT",6,30,25,0.8333333333333334,"Handgun - pistol, revolver, etc",5
2014397,2,Rural Oregon,5,29,24,0.8275862068965517,"Firearm, type not stated",5
5995889,2,"Anchorage, AK",1,29,24,0.8275862068965517,"Blunt object - hammer, club, etc",5
13722116,1,Rural Idaho,5,29,24,0.8275862068965517,"Firearm, type not stated",5
21207395,2,"Topeka, KS",10,29,24,0.8275862068965517,Other or type unknown,5
49509802,2,"Greenville, SC",1,29,24,0.8275862068965517,"Blunt object - hammer, club, etc",5
94997288,2,"Des Moines, IA",10,29,24,0.8275862068965517,Other or type unknown,5
6636788,1,"Santa Rosa-Petaluma, CA",15,28,23,0.8214285714285714,Shotgun,5
21306704,1,"Jacksonville, NC",10,28,23,0.8214285714285714,Other or type unknown,5
31303144,1,"Topeka, KS",11,28,23,0.8214285714285714,"Personal weapons, includes beating",5
47600672,2,"Greensboro-High Point, NC",14,28,23,0.8214285714285714,Rifle,5
50109336,2,"Worcester, MA",10,28,23,0.8214285714285714,Other or type unknown,5
70571629,2,"Florence-Muscle Shoals, AL",6,28,23,0.8214285714285714,"Handgun - pistol, revolver, etc",5
82230634,2,"Hagerstown-Martinsburg, MD-WV",7,28,23,0.8214285714285714,Knife or cutting instrument,5
84548797,1,"Columbus, OH",8,28,23,0.8214285714285714,"Narcotics or drugs, sleeping pills",5
92989229,2,"Charlotte-Gastonia-Concord, NC-SC",0,28,23,0.8214285714285714,Asphyxiation - includes death by gas,5
98165518,1,Rural West Virginia,8,28,23,0.8214285714285714,"Narcotics or drugs, sleeping pills",5
31969814,2,"Lafayette, LA",7,27,22,0.8148148148148148,Knife or cutting instrument,5
46849457,1,"Kalamazoo-Portage, MI",11,27,22,0.8148148148148148,"Personal weapons, includes beating",5
49510719,2,"Flint, MI",15,27,22,0.8148148148148148,Shotgun,5
58302414,2,"Philadelphia-Camden-Wilmington, PA-NJ-DE",8,27,22,0.8148148148148148,"Narcotics or drugs, sleeping pills",5
62856020,2,"Fayetteville-Springdale-Rogers, AR-MO",10,27,22,0.8148148148148148,Other or type unknown,5
66128791,1,Rural Utah,10,27,22,0.8148148148148148,Other or type unknown,5
67964667,2,"Atlantic City, NJ",11,27,22,0.8148148148148148,"Personal weapons, includes beating",5
96668564,2,"Baton Rouge, LA",14,27,22,0.8148148148148148,Rifle,5
98322236,2,"Racine, WI",7,27,22,0.8148148148148148,Knife or cutting instrument,5
2426754,1,"Scranton--Wilkes-Barre, PA",11,26,21,0.8076923076923077,"Personal weapons, includes beating",5
14342045,1,"Bellingham, WA",7,26,21,0.8076923076923077,Knife or cutting instrument,5
40301461,1,Rural Montana,5,26,21,0.8076923076923077,"Firearm, type not stated",5
72909820,1,"Sherman-Denison, TX",7,26,21,0.8076923076923077,Knife or cutting instrument,5
95275756,2,"Allentown-Bethlehem-Easton, PA-NJ",1,26,21,0.8076923076923077,"Blunt object - hammer, club, etc",5
99328883,2,"Pueblo, CO",7,26,21,0.8076923076923077,Knife or cutting instrument,5
35403563,1,"Battle Creek, MI",15,25,20,0.8,Shotgun,5
40985796,1,"Houston-Sugar Land-Baytown, TX",2,25,20,0.8,Drowning,5
47602625,2,Rural Washington,1,25,20,0.8,"Blunt object - hammer, club, etc",5
52830138,2,"Bakersfield, CA",15,25,20,0.8,Shotgun,5
85992291,1,"Columbia, MO",7,25,20,0.8,Knife or cutting instrument,5
369987,1,"Utica-Rome, NY",15,24,19,0.7916666666666666,Shotgun,5
4905814,2,"Greensboro-High Point, NC",1,24,19,0.7916666666666666,"Blunt object - hammer, club, etc",5
6262295,2,"Pensacola-Ferry Pass-Brent, FL",1,24,19,0.7916666666666666,"Blunt object - hammer, club, etc",5
7930874,1,"Terre Haute, IN",7,24,19,0.7916666666666666,Knife or cutting instrument,5
26560714,1,"Holland-Grand Haven, MI",6,24,19,0.7916666666666666,"Handgun - pistol, revolver, etc",5
48985282,2,"Gainesville, FL",7,24,19,0.7916666666666666,Knife or cutting instrument,5
55615424,2,"Muncie, IN",6,24,19,0.7916666666666666,"Handgun - pistol, revolver, etc",5
72506227,2,"Vallejo-Fairfield, CA",11,24,19,0.7916666666666666,"Personal weapons, includes beating",5
82722620,2,Rural Iowa,5,24,19,0.7916666666666666,"Firearm, type not stated",5
27863050,1,"Hagerstown-Martinsburg, MD-WV",5,23,18,0.782608695652174,"Firearm, type not stated",5
30677552,2,"Honolulu, HI",1,23,18,0.782608695652174,"Blunt object - hammer, club, etc",5
50438968,2,"Eugene-Springfield, OR",10,23,18,0.782608695652174,Other or type unknown,5
61121042,2,"Texarkana, TX-Texarkana, AR",7,23,18,0.782608695652174,Knife or cutting instrument,5
67021850,2,"Dover, DE",7,23,18,0.782608695652174,Knife or cutting instrument,5
82752974,1,"South Bend-Mishawaka, IN-MI",14,23,18,0.782608695652174,Rifle,5
86504198,2,"San Jose-Sunnyvale-Santa Clara, CA",5,23,18,0.782608695652174,"Firearm, type not stated",5
90016608,2,"Springfield, MA",5,23,18,0.782608695652174,"Firearm, type not stated",5
91762563,2,"Phoenix-Mesa-Scottsdale, AZ",8,23,18,0.782608695652174,"Narcotics or drugs, sleeping pills",5
92902023,2,"Visalia-Porterville, CA",10,23,18,0.782608695652174,Other or type unknown,5
10522058,2,"Macon, GA",11,22,17,0.7727272727272727,"Personal weapons, includes beating",5
19715061,2,"Kingsport-Bristol-Bristol, TN-VA",10,22,17,0.7727272727272727,Other or type unknown,5
26670197,1,"Redding, CA",14,22,17,0.7727272727272727,Rifle,5
41347670,1,"Miami-Fort Lauderdale, FL",8,22,17,0.7727272727272727,"Narcotics or drugs, sleeping pills",5
54472821,1,"Salem, OR",1,22,17,0.7727272727272727,"Blunt object - hammer, club, etc",5
75996925,1,"Albany, GA",1,22,17,0.7727272727272727,"Blunt object - hammer, club, etc",5
260300,1,"Scranton--Wilkes-Barre, PA",1,21,16,0.7619047619047619,"Blunt object - hammer, club, etc",5
10766610,2,Rural Wyoming,7,21,16,0.7619047619047619,Knife or cutting instrument,5
11730371,1,"Reading, PA",11,21,16,0.7619047619047619,"Personal weapons, includes beating",5
19999637,1,"Dothan, AL",14,21,16,0.7619047619047619,Rifle,5
26243451,1,Rural Oklahoma,8,21,16,0.7619047619047619,"Narcotics or drugs, sleeping pills",5
27266779,2,"San Luis Obispo-Paso Robles, CA",7,21,16,0.7619047619047619,Knife or cutting instrument,5
42361051,1,"Laredo, TX",1,21,16,0.7619047619047619,"Blunt object - hammer, club, etc",5
55008295,2,"Salem, OR",7,21,16,0.7619047619047619,Knife or cutting instrument,5
56639974,2,"Panama City-Lynn Haven, FL",7,21,16,0.7619047619047619,Knife or cutting instrument,5
59097602,2,"Sarasota-Bradenton-Venice, FL",1,21,16,0.7619047619047619,"Blunt object - hammer, club, etc",5
60414845,2,"Chicago-Naperville-Joliet, IL-IN-WI",2,21,16,0.7619047619047619,Drowning,5
64626435,1,"Santa Fe, NM",15,21,16,0.7619047619047619,Shotgun,5
84947790,1,Rural Maryland,1,21,16,0.7619047619047619,"Blunt object - hammer, club, etc",5
89529773,1,"Tulsa, OK",4,21,16,0.7619047619047619,Fire,5
12709887,2,"Corpus Christi, TX",1,20,15,0.75,"Blunt object - hammer, club, etc",5
29009642,2,"Trenton-Ewing, NJ",1,20,15,0.75,"Blunt object - hammer, club, etc",5
36330443,1,Rural New Hampshire,5,20,15,0.75,"Firearm, type not stated",5
54305397,1,"Chico, CA",1,20,15,0.75,"Blunt object - hammer, club, etc",5
55361288,1,"Greeley, CO",15,20,15,0.75,Shotgun,5
57882644,1,"Riverside-San Bernardino, CA",8,20,15,0.75,"Narcotics or drugs, sleeping pills",5
66745737,1,"Sacramento-Roseville, CA",8,20,15,0.75,"Narcotics or drugs, sleeping pills",5
76834255,1,"Punta Gorda, FL",5,20,15,0.75,"Firearm, type not stated",5
77607516,1,"Bowling Green, KY",5,20,15,0.75,"Firearm, type not stated",5
80984318,2,"Bremerton-Silverdale, WA",7,20,15,0.75,Knife or cutting instrument,5
84058520,1,"Palm Bay-Melbourne-Titusville, FL",1,20,15,0.75,"Blunt object - hammer, club, etc",5
6814149,2,"Poughkeepsie-Newburgh-Middletown, NY",1,19,14,0.7368421052631579,"Blunt object - hammer, club, etc",5
22219549,1,Rural Virginia,4,19,14,0.7368421052631579,Fire,5
28375482,2,"Monroe, MI",10,19,14,0.7368421052631579,Other or type unknown,5
33134289,2,Rural Oklahoma,8,19,14,0.7368421052631579,"Narcotics or drugs, sleeping pills",5
38953994,2,"San Jose-Sunnyvale-Santa Clara, CA",0,19,14,0.7368421052631579,Asphyxiation - includes death by gas,5
46349867,2,"Reading, PA",10,19,14,0.7368421052631579,Other or type unknown,5
46485491,2,"Tucson, AZ",16,19,14,0.7368421052631579,Strangulation - hanging,5
49915269,2,"Clarksville, TN-KY",5,19,14,0.7368421052631579,"Firearm, type not stated",5
56079175,1,Rural Delaware,5,19,14,0.7368421052631579,"Firearm, type not stated",5
60409572,1,"Palm Bay-Melbourne-Titusville, FL",15,19,14,0.7368421052631579,Shotgun,5
75150660,2,"Spokane, WA",1,19,14,0.7368421052631579,"Blunt object - hammer, club, etc",5
1282384,1,"Port St. Lucie-Fort Pierce, FL",1,18,13,0.7222222222222222,"Blunt object - hammer, club, etc",5
10318907,2,"Tyler, TX",10,18,13,0.7222222222222222,Other or type unknown,5
11260746,2,"Niles-Benton Harbor, MI",7,18,13,0.7222222222222222,Knife or cutting instrument,5
26107001,2,"Santa Rosa-Petaluma, CA",1,18,13,0.7222222222222222,"Blunt object - hammer, club, etc",5
37078320,1,"Madera, CA",14,18,13,0.7222222222222222,Rifle,5
52030425,1,"Farmington, NM",10,18,13,0.7222222222222222,Other or type unknown,5
66999697,1,"Gainesville, FL",1,18,13,0.7222222222222222,"Blunt object - hammer, club, etc",5
94781433,1,"Kennewick-Richland-Pasco, WA",1,18,13,0.7222222222222222,"Blunt object - hammer, club, etc",5
96346645,1,"Kalamazoo-Portage, MI",14,18,13,0.7222222222222222,Rifle,5
10575445,2,"Greenville, NC",10,17,12,0.7058823529411765,Other or type unknown,5
23739030,2,"Cleveland-Elyria-Mentor, OH",0,17,12,0.7058823529411765,Asphyxiation - includes death by gas,5
37338380,2,"Jackson, MI",10,17,12,0.7058823529411765,Other or type unknown,5
43372227,2,Rural North Dakota,10,17,12,0.7058823529411765,Other or type unknown,5
47852464,1,"Tulsa, OK",8,17,12,0.7058823529411765,"Narcotics or drugs, sleeping pills",5
48352058,2,"Redding, CA",7,17,12,0.7058823529411765,Knife or cutting instrument,5
48482315,2,"Odessa, TX",7,17,12,0.7058823529411765,Knife or cutting instrument,5
49943278,1,"Merced, CA",1,17,12,0.7058823529411765,"Blunt object - hammer, club, etc",5
66177323,1,"Houma-Bayou Cane-Thibodaux, LA",10,17,12,0.7058823529411765,Other or type unknown,5
69086152,1,"Blacksburg-Christiansburg, VA",5,17,12,0.7058823529411765,"Firearm, type not stated",5
69106829,2,"Yakima, WA",1,17,12,0.7058823529411765,"Blunt object - hammer, club, etc",5
83583818,1,"Pueblo, CO",1,17,12,0.7058823529411765,"Blunt object - hammer, club, etc",5
88851398,2,"Ann Arbor, MI",11,17,12,0.7058823529411765,"Personal weapons, includes beating",5
88989675,2,"Colorado Springs, CO",1,17,12,0.7058823529411765,"Blunt object - hammer, club, etc",5
89991267,2,"Joplin, MO",7,17,12,0.7058823529411765,Knife or cutting instrument,5
5844537,1,"Tucson, AZ",0,16,11,0.6875,Asphyxiation - includes death by gas,5
18378253,2,"Merced, CA",5,16,11,0.6875,"Firearm, type not stated",5
19465539,1,"Dothan, AL",11,16,11,0.6875,"Personal weapons, includes beating",5
26356343,1,"Charleston, WV",4,16,11,0.6875,Fire,5
33214931,2,"Omaha-Council Bluffs, NE-IA",16,16,11,0.6875,Strangulation - hanging,5
37136099,2,"Valdosta, GA",10,16,11,0.6875,Other or type unknown,5
38256758,1,"Reading, PA",10,16,11,0.6875,Other or type unknown,5
83145937,2,"Oklahoma City, OK",4,16,11,0.6875,Fire,5
86928121,1,"Medford, OR",1,16,11,0.6875,"Blunt object - hammer, club, etc",5
88275275,1,"Providence-New Bedford-Fall River, RI-MA",16,16,11,0.6875,Strangulation - hanging,5
93319713,1,Rural Louisiana,9,16,11,0.6875,Other gun,5
31789659,2,"New Orleans-Metairie-Kenner, LA",2,15,10,0.6666666666666666,Drowning,5
33356821,9,"Birmingham-Hoover, AL",5,15,10,0.6666666666666666,"Firearm, type not stated",5
33723748,1,"Billings, MT",10,15,10,0.6666666666666666,Other or type unknown,5
34320681,1,"Charlotte-Gastonia-Concord, NC-SC",0,15,10,0.6666666666666666,Asphyxiation - includes death by gas,5
38904809,2,"Miami-Fort Lauderdale, FL",9,15,10,0.6666666666666666,Other gun,5
42781873,1,"Dothan, AL",10,15,10,0.6666666666666666,Other or type unknown,5
48061128,2,"Modesto, CA",16,15,10,0.6666666666666666,Strangulation - hanging,5
53414510,2,"Salisbury, MD",7,15,10,0.6666666666666666,Knife or cutting instrument,5
55756689,2,"South Bend-Mishawaka, IN-MI",1,15,10,0.6666666666666666,"Blunt object - hammer, club, etc",5
57604712,1,"Madera, CA",15,15,10,0.6666666666666666,Shotgun,5
63952087,2,"Pittsburgh, PA",8,15,10,0.6666666666666666,"Narcotics or drugs, sleeping pills",5
66974871,1,"Greeley, CO",5,15,10,0.6666666666666666,"Firearm, type not stated",5
72003993,2,"Syracuse, NY",16,15,10,0.6666666666666666,Strangulation - hanging,5
72991369,1,"Redding, CA",10,15,10,0.6666666666666666,Other or type unknown,5
82993491,2,"Amarillo, TX",10,15,10,0.6666666666666666,Other or type unknown,5
94566137,2,"Hot Springs, AR",7,15,10,0.6666666666666666,Knife or cutting instrument,5
95297180,2,"Merced, CA",10,15,10,0.6666666666666666,Other or type unknown,5
97296480,2,"Grand Rapids-Wyoming, MI",1,15,10,0.6666666666666666,"Blunt object - hammer, club, etc",5
2639737,1,Rural Maryland,10,14,9,0.6428571428571429,Other or type unknown,5
24993027,2,Rural Alaska,16,14,9,0.6428571428571429,Strangulation - hanging,5
37888890,2,"Providence-New Bedford-Fall River, RI-MA",0,14,9,0.6428571428571429,Asphyxiation - includes death by gas,5
56380438,2,"Toledo, OH",5,14,9,0.6428571428571429,"Firearm, type not stated",5
58127309,2,Rural Illinois,16,14,9,0.6428571428571429,Strangulation - hanging,5
63009654,1,"Florence-Muscle Shoals, AL",10,14,9,0.6428571428571429,Other or type unknown,5
75183329,2,"Kokomo, IN",6,14,9,0.6428571428571429,"Handgun - pistol, revolver, etc",5
76748687,1,"Springfield, MO",5,14,9,0.6428571428571429,"Firearm, type not stated",5
77431482,1,"Flagstaff, AZ",1,14,9,0.6428571428571429,"Blunt object - hammer, club, etc",5
78374726,1,"Danville, VA",10,14,9,0.6428571428571429,Other or type unknown,5
87242217,1,"Eugene-Springfield, OR",5,14,9,0.6428571428571429,"Firearm, type not stated",5
98934628,2,"Anderson, SC",5,14,9,0.6428571428571429,"Firearm, type not stated",5
3133051,1,"Jacksonville, NC",9,13,8,0.6153846153846154,Other gun,5
9076846,2,"Holland-Grand Haven, MI",7,13,8,0.6153846153846154,Knife or cutting instrument,5
11751537,1,"Lancaster, PA",8,13,8,0.6153846153846154,"Narcotics or drugs, sleeping pills",5
12826686,1,"Greenville, NC",1,13,8,0.6153846153846154,"Blunt object - hammer, club, etc",5
14768256,1,"Greenville, NC",11,13,8,0.6153846153846154,"Personal weapons, includes beating",5
19197670,2,"Parkersburg-Marietta-Vienna, WV-OH",10,13,8,0.6153846153846154,Other or type unknown,5
35112419,1,Rural Mississippi,9,13,8,0.6153846153846154,Other gun,5
40245107,1,Rural Vermont,1,13,8,0.6153846153846154,"Blunt object - hammer, club, etc",5
49214488,2,"Miami-Fort Lauderdale, FL",2,13,8,0.6153846153846154,Drowning,5
50036035,1,"Barnstable Town, MA",5,13,8,0.6153846153846154,"Firearm, type not stated",5
50773861,2,"Springfield, MO",1,13,8,0.6153846153846154,"Blunt object - hammer, club, etc",5
64867681,1,"Yakima, WA",10,13,8,0.6153846153846154,Other or type unknown,5
67205592,2,"Harrisburg-Carlisle, PA",8,13,8,0.6153846153846154,"Narcotics or drugs, sleeping pills",5
70804364,2,"Redding, CA",10,13,8,0.6153846153846154,Other or type unknown,5
93650437,2,"Tallahassee, FL",1,13,8,0.6153846153846154,"Blunt object - hammer, club, etc",5
3393615,2,"Ocala, FL",7,12,7,0.5833333333333334,Knife or cutting instrument,5
6636641,2,"Fort Wayne, IN",16,12,7,0.5833333333333334,Strangulation - hanging,5
16510039,1,"Albuquerque, NM",0,12,7,0.5833333333333334,Asphyxiation - includes death by gas,5
20524323,2,"Shreveport-Bossier City, LA",1,12,7,0.5833333333333334,"Blunt object - hammer, club, etc",5
28190137,2,"San Luis Obispo-Paso Robles, CA",16,12,7,0.5833333333333334,Strangulation - hanging,5
41747675,1,"San Luis Obispo-Paso Robles, CA",1,12,7,0.5833333333333334,"Blunt object - hammer, club, etc",5
42923599,1,"Vineland-Millville-Bridgeton, NJ",10,12,7,0.5833333333333334,Other or type unknown,5
48148899,1,"Providence-New Bedford-Fall River, RI-MA",0,12,7,0.5833333333333334,Asphyxiation - includes death by gas,5
49868818,2,"Holland-Grand Haven, MI",6,12,7,0.5833333333333334,"Handgun - pistol, revolver, etc",5
52287325,1,Rural Oklahoma,16,12,7,0.5833333333333334,Strangulation - hanging,5
58152233,2,Rural West Virginia,16,12,7,0.5833333333333334,Strangulation - hanging,5
58159906,2,"Santa Fe, NM",5,12,7,0.5833333333333334,"Firearm, type not stated",5
63285047,1,"Charlottesville, VA",1,12,7,0.5833333333333334,"Blunt object - hammer, club, etc",5
73432284,2,Rural Tennessee,4,12,7,0.5833333333333334,Fire,5
77964375,2,Rural Alaska,5,12,7,0.5833333333333334,"Firearm, type not stated",5
95854693,2,"Abilene, TX",10,12,7,0.5833333333333334,Other or type unknown,5
99049373,2,"Duluth, MN-WI",1,12,7,0.5833333333333334,"Blunt object - hammer, club, etc",5
5176784,1,Rural Pennsylvania,9,11,6,0.5454545454545454,Other gun,5
24280446,2,"Honolulu, HI",5,11,6,0.5454545454545454,"Firearm, type not stated",5
27645207,2,"Topeka, KS",5,11,6,0.5454545454545454,"Firearm, type not stated",5
29454128,2,"New York-New Jersey-Long Island, NY-NJ",3,11,6,0.5454545454545454,Explosives,5
39696770,2,"Trenton-Ewing, NJ",4,11,6,0.5454545454545454,Fire,5
63084115,2,"Brunswick, GA",10,11,6,0.5454545454545454,Other or type unknown,5
73642796,1,"York-Hanover, PA",1,11,6,0.5454545454545454,"Blunt object - hammer, club, etc",5
80947703,1,"Salisbury, MD",5,11,6,0.5454545454545454,"Firearm, type not stated",5
87445779,2,"Bakersfield, CA",0,11,6,0.5454545454545454,Asphyxiation - includes death by gas,5
97067997,1,"Michigan City-La Porte, IN",1,11,6,0.5454545454545454,"Blunt object - hammer, club, etc",5
99197834,2,"Stockton, CA",0,11,6,0.5454545454545454,Asphyxiation - includes death by gas,5
89945,1,"Orlando-Kissimmee, FL",9,10,5,0.5,Other gun,5
9377429,1,"Decatur, AL",10,10,5,0.5,Other or type unknown,5
18611360,2,"Rockford, IL",16,10,5,0.5,Strangulation - hanging,5
19714656,1,"Kankakee-Bradley, IL",15,10,5,0.5,Shotgun,5
8065913,1,"Cheyenne, WY",8,9,4,0.4444444444444444,"Narcotics or drugs, sleeping pills",5
12535850,2,"Detroit-Warren-Livonia, MI",9,9,4,0.4444444444444444,Other gun,5
35353628,2,"Lexington-Fayette, KY",16,9,4,0.4444444444444444,Strangulation - hanging,5
45262388,2,"Tampa-St. Petersburg-Clearwater, FL",0,9,4,0.4444444444444444,Asphyxiation - includes death by gas,5
49822074,2,"Santa Barbara-Santa Maria, CA",5,9,4,0.4444444444444444,"Firearm, type not stated",5
51889634,2,"Washington-Arlington-Alexandria, DC-VA-MD-WV",9,9,4,0.4444444444444444,Other gun,5
57582611,2,"Cheyenne, WY",8,9,4,0.4444444444444444,"Narcotics or drugs, sleeping pills",5
62892400,1,"Peoria, IL",8,9,4,0.4444444444444444,"Narcotics or drugs, sleeping pills",5
63723259,1,"Scranton--Wilkes-Barre, PA",8,9,4,0.4444444444444444,"Narcotics or drugs, sleeping pills",5
70091265,1,"San Luis Obispo-Paso Robles, CA",5,9,4,0.4444444444444444,"Firearm, type not stated",5
80539426,1,"Santa Cruz-Watsonville, CA",5,9,4,0.4444444444444444,"Firearm, type not stated",5
81473248,1,"Alexandria, LA",8,9,4,0.4444444444444444,"Narcotics or drugs, sleeping pills",5
97356915,9,"Little Rock-North Little Rock, AR",5,9,4,0.4444444444444444,"Firearm, type not stated",5
99248613,1,"Gainesville, GA",10,9,4,0.4444444444444444,Other or type unknown,5
4714293,9,Rural Alabama,10,8,3,0.375,Other or type unknown,5
31131080,9,Rural Texas,10,8,3,0.375,Other or type unknown,5
35955533,1,"Dayton, OH",16,8,3,0.375,Strangulation - hanging,5
43186790,2,"Harrisburg-Carlisle, PA",0,8,3,0.375,Asphyxiation - includes death by gas,5
49618141,1,"Youngstown-Warren-Boardman, OH-PA",4,8,3,0.375,Fire,5
58241130,2,"Youngstown-Warren-Boardman, OH-PA",16,8,3,0.375,Strangulation - hanging,5
68286502,2,Rural Michigan,16,8,3,0.375,Strangulation - hanging,5
85364266,2,"Bay City, MI",6,8,3,0.375,"Handgun - pistol, revolver, etc",5
10730263,2,"Abilene, TX",16,7,2,0.2857142857142857,Strangulation - hanging,5
17274828,9,Rural Oklahoma,10,7,2,0.2857142857142857,Other or type unknown,5
18037726,1,"Danville, IL",5,7,2,0.2857142857142857,"Firearm, type not stated",5
32130581,2,"Atlantic City, NJ",0,7,2,0.2857142857142857,Asphyxiation - includes death by gas,5
87690793,1,"Jacksonville, FL",16,7,2,0.2857142857142857,Strangulation - hanging,5
12922814,1,"Cumberland, MD-WV",10,6,1,0.16666666666666666,Other or type unknown,5
19770043,2,"Rome, GA",10,6,1,0.16666666666666666,Other or type unknown,5
27318884,1,"Fairbanks, AK",5,6,1,0.16666666666666666,"Firearm, type not stated",5
38608796,2,"Fayetteville, NC",16,6,1,0.16666666666666666,Strangulation - hanging,5
40148180,1,"Yakima, WA",4,6,1,0.16666666666666666,Fire,5
62210760,2,"Gulfport-Biloxi, MS",16,6,1,0.16666666666666666,Strangulation - hanging,5
65418177,1,"Tallahassee, FL",9,6,1,0.16666666666666666,Other gun,5
1807406,1,"Muncie, IN",17,5,0,0.0,Weapon Not Reported,5
12900137,1,"Fresno, CA",17,5,0,0.0,Weapon Not Reported,5
13263511,2,"Indianapolis, IN",17,5,0,0.0,Weapon Not Reported,5
19174593,1,"Washington-Arlington-Alexandria, DC-VA-MD-WV",17,5,0,0.0,Weapon Not Reported,5
19327263,9,"Chicago-Naperville-Joliet, IL-IN-WI",6,5,0,0.0,"Handgun - pistol, revolver, etc",5
29655524,2,"Columbus, IN",10,5,0,0.0,Other or type unknown,5
33277951,1,"Austin-Round Rock, TX",17,5,0,0.0,Weapon Not Reported,5
49785557,2,"Baton Rouge, LA",17,5,0,0.0,Weapon Not Reported,5
49793100,1,"Greensboro-High Point, NC",17,5,0,0.0,Weapon Not Reported,5
53679711,1,"Texarkana, TX-Texarkana, AR",17,5,0,0.0,Weapon Not Reported,5
54961956,1,"Baton Rouge, LA",17,5,0,0.0,Weapon Not Reported,5
56860093,9,"Jacksonville, FL",5,5,0,0.0,"Firearm, type not stated",5
61509899,9,"Boston-Cambridge-Quincy, MA-NH",5,5,0,0.0,"Firearm, type not stated",5
62542269,1,"Boston-Cambridge-Quincy, MA-NH",17,5,0,0.0,Weapon Not Reported,5
75752322,1,"Grand Rapids-Wyoming, MI",17,5,0,0.0,Weapon Not Reported,5
75793685,9,"Huntsville, AL",5,5,0,0.0,"Firearm, type not stated",5
80644807,1,"Lafayette, LA",17,5,0,0.0,Weapon Not Reported,5
82383789,1,"Des Moines, IA",17,5,0,0.0,Weapon Not Reported,5
88129767,2,"Tulsa, OK",17,5,0,0.0,Weapon Not Reported,5
97371314,1,"Monroe, LA",17,5,0,0.0,Weapon Not Reported,5
16591881,1,"Kingsport-Bristol-Bristol, TN-VA",6,135,131,0.9703703703703703,"Handgun - pistol, revolver, etc",4
89144732,1,"Salt Lake City, UT",11,106,102,0.9622641509433962,"Personal weapons, includes beating",4
29418705,2,Rural South Carolina,15,104,100,0.9615384615384616,Shotgun,4
78958352,1,Rural Wisconsin,14,99,95,0.9595959595959596,Rifle,4
22688110,1,"Charleston-North Charleston, SC",15,94,90,0.9574468085106383,Shotgun,4
62642119,2,"Philadelphia-Camden-Wilmington, PA-NJ-DE",14,93,89,0.956989247311828,Rifle,4
93483007,1,Rural Washington,14,93,89,0.956989247311828,Rifle,4
27928709,2,"Myrtle Beach-Conway, SC",6,89,85,0.9550561797752809,"Handgun - pistol, revolver, etc",4
69849371,1,"Florence, SC",7,89,85,0.9550561797752809,Knife or cutting instrument,4
76949476,1,Rural Pennsylvania,11,86,82,0.9534883720930233,"Personal weapons, includes beating",4
31138109,2,Rural Montana,6,83,79,0.9518072289156626,"Handgun - pistol, revolver, etc",4
61720056,1,"Myrtle Beach-Conway, SC",7,81,77,0.9506172839506173,Knife or cutting instrument,4
97831411,2,Rural Tennessee,15,80,76,0.95,Shotgun,4
23788226,2,Rural Pennsylvania,15,77,73,0.948051948051948,Shotgun,4
51364441,2,"Evansville, IN-KY",6,77,73,0.948051948051948,"Handgun - pistol, revolver, etc",4
17424780,1,"Longview, TX",15,76,72,0.9473684210526315,Shotgun,4
80802133,2,Rural Minnesota,6,74,70,0.9459459459459459,"Handgun - pistol, revolver, etc",4
15915376,1,"Columbia, SC",1,73,69,0.9452054794520548,"Blunt object - hammer, club, etc",4
85637857,1,Rural Colorado,14,73,69,0.9452054794520548,Rifle,4
68942139,1,Rural West Virginia,1,71,67,0.9436619718309859,"Blunt object - hammer, club, etc",4
70139791,2,"Phoenix-Mesa-Scottsdale, AZ",15,71,67,0.9436619718309859,Shotgun,4
87057747,1,Rural Illinois,15,71,67,0.9436619718309859,Shotgun,4
31358178,2,"Houma-Bayou Cane-Thibodaux, LA",6,70,66,0.9428571428571428,"Handgun - pistol, revolver, etc",4
48128498,2,"Salt Lake City, UT",11,69,65,0.9420289855072463,"Personal weapons, includes beating",4
55568232,1,Rural Maryland,7,69,65,0.9420289855072463,Knife or cutting instrument,4
31462170,2,"Pittsburgh, PA",14,68,64,0.9411764705882353,Rifle,4
67138163,2,"Charlotte-Gastonia-Concord, NC-SC",15,68,64,0.9411764705882353,Shotgun,4
9165605,1,"Charleston-North Charleston, SC",14,67,63,0.9402985074626866,Rifle,4
4430902,1,"Vineland-Millville-Bridgeton, NJ",7,66,62,0.9393939393939394,Knife or cutting instrument,4
99412806,1,"Jackson, MS",11,66,62,0.9393939393939394,"Personal weapons, includes beating",4
76248277,2,Rural Arkansas,11,65,61,0.9384615384615385,"Personal weapons, includes beating",4
83822644,1,"College Station-Bryan, TX",7,65,61,0.9384615384615385,Knife or cutting instrument,4
91976736,2,Rural New York,11,64,60,0.9375,"Personal weapons, includes beating",4
92829615,1,Rural New Mexico,14,64,60,0.9375,Rifle,4
94874518,1,"Charleston-North Charleston, SC",11,64,60,0.9375,"Personal weapons, includes beating",4
18775464,1,"Fort Collins-Loveland, CO",6,63,59,0.9365079365079365,"Handgun - pistol, revolver, etc",4
33873141,1,"St. Joseph, MO-KS",6,62,58,0.9354838709677419,"Handgun - pistol, revolver, etc",4
41683898,2,Rural Virginia,11,62,58,0.9354838709677419,"Personal weapons, includes beating",4
73125773,1,"Beaumont-Port Arthur, TX",14,61,57,0.9344262295081968,Rifle,4
40147277,2,"Salem, OR",6,60,56,0.9333333333333333,"Handgun - pistol, revolver, etc",4
81184902,1,"Provo-Orem, UT",6,60,56,0.9333333333333333,"Handgun - pistol, revolver, etc",4
22023724,2,"New Orleans-Metairie-Kenner, LA",15,57,53,0.9298245614035088,Shotgun,4
83391494,1,"Olympia, WA",6,55,51,0.9272727272727272,"Handgun - pistol, revolver, etc",4
90314537,1,"Ogden-Clearfield, UT",7,55,51,0.9272727272727272,Knife or cutting instrument,4
16596458,2,"Ogden-Clearfield, UT",6,54,50,0.9259259259259259,"Handgun - pistol, revolver, etc",4
65209730,1,"Owensboro, KY",6,54,50,0.9259259259259259,"Handgun - pistol, revolver, etc",4
60609702,1,"Modesto, CA",14,53,49,0.9245283018867925,Rifle,4
73001884,2,"Buffalo-Niagara Falls, NY",15,53,49,0.9245283018867925,Shotgun,4
50971374,2,"Pensacola-Ferry Pass-Brent, FL",11,52,48,0.9230769230769231,"Personal weapons, includes beating",4
70179369,1,"Salem, OR",10,52,48,0.9230769230769231,Other or type unknown,4
78332504,2,Rural Georgia,14,52,48,0.9230769230769231,Rifle,4
37098769,2,"Kalamazoo-Portage, MI",6,51,47,0.9215686274509803,"Handgun - pistol, revolver, etc",4
52084765,1,"Abilene, TX",7,50,46,0.92,Knife or cutting instrument,4
62489912,1,Rural Washington,11,50,46,0.92,"Personal weapons, includes beating",4
76162199,1,"Lubbock, TX",11,50,46,0.92,"Personal weapons, includes beating",4
85858844,1,"Madison, WI",7,50,46,0.92,Knife or cutting instrument,4
91978746,1,"Yakima, WA",14,50,46,0.92,Rifle,4
94917056,1,"Augusta-Richmond County, GA-SC",11,50,46,0.92,"Personal weapons, includes beating",4
3321688,1,"Hagerstown-Martinsburg, MD-WV",7,49,45,0.9183673469387755,Knife or cutting instrument,4
33688886,1,"Pensacola-Ferry Pass-Brent, FL",15,49,45,0.9183673469387755,Shotgun,4
44663252,2,"San Diego-Carlsbad-San Marcos, CA",15,49,45,0.9183673469387755,Shotgun,4
67902508,1,"Fort Wayne, IN",15,49,45,0.9183673469387755,Shotgun,4
76061296,2,"Santa Fe, NM",6,49,45,0.9183673469387755,"Handgun - pistol, revolver, etc",4
57163575,1,"Jonesboro, AR",5,48,44,0.9166666666666666,"Firearm, type not stated",4
77195280,2,Rural Washington,7,48,44,0.9166666666666666,Knife or cutting instrument,4
83833226,2,"Tuscaloosa, AL",6,47,43,0.9148936170212766,"Handgun - pistol, revolver, etc",4
85070081,1,Rural Nebraska,10,46,42,0.9130434782608695,Other or type unknown,4
95631959,1,"Rocky Mount, NC",14,46,42,0.9130434782608695,Rifle,4
6697340,2,"Madison, WI",6,45,41,0.9111111111111111,"Handgun - pistol, revolver, etc",4
47732219,2,"Akron, OH",11,45,41,0.9111111111111111,"Personal weapons, includes beating",4
92788578,1,"Corpus Christi, TX",15,45,41,0.9111111111111111,Shotgun,4
93956489,1,"Jacksonville, NC",7,45,41,0.9111111111111111,Knife or cutting instrument,4
4942855,1,"Lafayette, IN",6,44,40,0.9090909090909091,"Handgun - pistol, revolver, etc",4
13774829,1,"Springfield, IL",7,44,40,0.9090909090909091,Knife or cutting instrument,4
19275617,2,"Albany-Schenectady-Troy, NY",11,44,40,0.9090909090909091,"Personal weapons, includes beating",4
90342711,1,"Cape Coral-Fort Myers, FL",1,44,40,0.9090909090909091,"Blunt object - hammer, club, etc",4
75029671,1,Rural Wyoming,11,43,39,0.9069767441860465,"Personal weapons, includes beating",4
81086719,2,Rural Iowa,7,43,39,0.9069767441860465,Knife or cutting instrument,4
87196179,1,"Albany-Schenectady-Troy, NY",15,43,39,0.9069767441860465,Shotgun,4
8877122,1,"Fort Smith, AR-OK",14,42,38,0.9047619047619048,Rifle,4
22002003,1,"Salisbury, MD",7,42,38,0.9047619047619048,Knife or cutting instrument,4
37615658,1,"Killeen-Temple-Fort Hood, TX",11,42,38,0.9047619047619048,"Personal weapons, includes beating",4
50560441,1,"St. Louis, MO-IL",8,42,38,0.9047619047619048,"Narcotics or drugs, sleeping pills",4
55149075,2,"St. Louis, MO-IL",0,42,38,0.9047619047619048,Asphyxiation - includes death by gas,4
73819618,2,"Deltona-Daytona Beach-Ormond Beach, FL",11,42,38,0.9047619047619048,"Personal weapons, includes beating",4
74045714,2,"Tampa-St. Petersburg-Clearwater, FL",15,42,38,0.9047619047619048,Shotgun,4
22501658,2,Rural Alabama,1,41,37,0.9024390243902439,"Blunt object - hammer, club, etc",4
56762858,1,"Macon, GA",15,41,37,0.9024390243902439,Shotgun,4
13258149,1,"Morgantown, WV",6,40,36,0.9,"Handgun - pistol, revolver, etc",4
4828039,2,"Columbia, SC",5,39,35,0.8974358974358975,"Firearm, type not stated",4
36557161,1,Rural New Hampshire,7,39,35,0.8974358974358975,Knife or cutting instrument,4
37635716,1,"Boise City-Nampa, ID",10,39,35,0.8974358974358975,Other or type unknown,4
67419048,1,"Decatur, IL",6,39,35,0.8974358974358975,"Handgun - pistol, revolver, etc",4
72876994,1,Rural Vermont,14,39,35,0.8974358974358975,Rifle,4
80685587,2,"Virginia Beach-Norfolk-Newport News, VA-NC",14,39,35,0.8974358974358975,Rifle,4
83370843,2,"Little Rock-North Little Rock, AR",15,39,35,0.8974358974358975,Shotgun,4
54525729,1,"Augusta-Richmond County, GA-SC",14,38,34,0.8947368421052632,Rifle,4
1778887,1,"Syracuse, NY",15,37,33,0.8918918918918919,Shotgun,4
29642912,2,"Nashville-Davidson-Murfreesboro, TN",14,37,33,0.8918918918918919,Rifle,4
60411192,1,"Poughkeepsie-Newburgh-Middletown, NY",15,37,33,0.8918918918918919,Shotgun,4
79989678,1,"Port St. Lucie-Fort Pierce, FL",11,37,33,0.8918918918918919,"Personal weapons, includes beating",4
88690379,1,"Pascagoula, MS",7,37,33,0.8918918918918919,Knife or cutting instrument,4
89999300,1,"Myrtle Beach-Conway, SC",15,37,33,0.8918918918918919,Shotgun,4
93055934,2,"Asheville, NC",7,37,33,0.8918918918918919,Knife or cutting instrument,4
11668780,2,"Anchorage, AK",11,36,32,0.8888888888888888,"Personal weapons, includes beating",4
75715177,1,"Wichita, KS",14,36,32,0.8888888888888888,Rifle,4
86116690,2,Rural Michigan,5,35,31,0.8857142857142857,"Firearm, type not stated",4
19578874,2,"Laredo, TX",6,34,30,0.8823529411764706,"Handgun - pistol, revolver, etc",4
47615697,1,"Brunswick, GA",7,34,30,0.8823529411764706,Knife or cutting instrument,4
49740660,2,Rural North Carolina,4,34,30,0.8823529411764706,Fire,4
59797683,1,Rural Alaska,5,34,30,0.8823529411764706,"Firearm, type not stated",4
72204564,2,Rural Colorado,11,34,30,0.8823529411764706,"Personal weapons, includes beating",4
83728706,2,"Greeley, CO",6,34,30,0.8823529411764706,"Handgun - pistol, revolver, etc",4
84036861,1,"Roanoke, VA",15,34,30,0.8823529411764706,Shotgun,4
13415094,1,Rural Montana,11,33,29,0.8787878787878788,"Personal weapons, includes beating",4
15492996,1,Rural Kansas,1,33,29,0.8787878787878788,"Blunt object - hammer, club, etc",4
24111344,2,"Milwaukee-Waukesha-West Allis, WI",4,33,29,0.8787878787878788,Fire,4
958004,1,"Athens-Clarke County, GA",7,32,28,0.875,Knife or cutting instrument,4
27368851,2,Rural West Virginia,1,32,28,0.875,"Blunt object - hammer, club, etc",4
34768876,2,"Milwaukee-Waukesha-West Allis, WI",15,32,28,0.875,Shotgun,4
59190324,1,"New Haven-Milford, CT",14,32,28,0.875,Rifle,4
89934215,1,"Ann Arbor, MI",15,32,28,0.875,Shotgun,4
473963,1,"Monroe, LA",15,31,27,0.8709677419354839,Shotgun,4
3627753,2,"Houma-Bayou Cane-Thibodaux, LA",7,31,27,0.8709677419354839,Knife or cutting instrument,4
23645578,1,"Hot Springs, AR",7,31,27,0.8709677419354839,Knife or cutting instrument,4
28832222,1,"Lakeland, FL",14,31,27,0.8709677419354839,Rifle,4
53825253,2,"Muskegon-Norton Shores, MI",6,31,27,0.8709677419354839,"Handgun - pistol, revolver, etc",4
60431195,2,"Atlanta-Sandy Springs-Marietta, GA",4,31,27,0.8709677419354839,Fire,4
74578383,2,"Modesto, CA",11,31,27,0.8709677419354839,"Personal weapons, includes beating",4
85099043,1,"Des Moines, IA",15,31,27,0.8709677419354839,Shotgun,4
92441885,2,"Tallahassee, FL",7,31,27,0.8709677419354839,Knife or cutting instrument,4
8899148,1,"Wilmington, NC",11,30,26,0.8666666666666667,"Personal weapons, includes beating",4
23823783,2,"Bakersfield, CA",14,30,26,0.8666666666666667,Rifle,4
46384540,2,"Kalamazoo-Portage, MI",7,30,26,0.8666666666666667,Knife or cutting instrument,4
60026242,2,Rural Pennsylvania,4,30,26,0.8666666666666667,Fire,4
66414243,1,"Burlington-South Burlington, VT",6,30,26,0.8666666666666667,"Handgun - pistol, revolver, etc",4
90545695,2,"Victoria, TX",6,30,26,0.8666666666666667,"Handgun - pistol, revolver, etc",4
93708312,1,"York-Hanover, PA",11,30,26,0.8666666666666667,"Personal weapons, includes beating",4
12495673,1,"Ocala, FL",11,29,25,0.8620689655172413,"Personal weapons, includes beating",4
39073349,2,"Elizabethtown, KY",6,29,25,0.8620689655172413,"Handgun - pistol, revolver, etc",4
78747315,1,"Clarksville, TN-KY",10,29,25,0.8620689655172413,Other or type unknown,4
10252860,1,"Youngstown-Warren-Boardman, OH-PA",11,28,24,0.8571428571428571,"Personal weapons, includes beating",4
19675027,1,"Lubbock, TX",15,28,24,0.8571428571428571,Shotgun,4
76970000,2,"Des Moines, IA",11,28,24,0.8571428571428571,"Personal weapons, includes beating",4
91969868,2,"Canton-Massillon, OH",7,28,24,0.8571428571428571,Knife or cutting instrument,4
92762160,2,"Hickory-Lenoir-Morganton, NC",7,28,24,0.8571428571428571,Knife or cutting instrument,4
95572236,1,"Goldsboro, NC",15,28,24,0.8571428571428571,Shotgun,4
27281535,2,"Cincinnati-Middletown, OH-KY-IN",0,27,23,0.8518518518518519,Asphyxiation - includes death by gas,4
31146676,1,"Santa Fe, NM",11,27,23,0.8518518518518519,"Personal weapons, includes beating",4
45945047,2,"Beaumont-Port Arthur, TX",1,27,23,0.8518518518518519,"Blunt object - hammer, club, etc",4
47344159,2,"Myrtle Beach-Conway, SC",10,27,23,0.8518518518518519,Other or type unknown,4
56247340,1,"Springfield, MO",1,27,23,0.8518518518518519,"Blunt object - hammer, club, etc",4
77883510,2,"Virginia Beach-Norfolk-Newport News, VA-NC",4,27,23,0.8518518518518519,Fire,4
94052418,1,Rural Iowa,1,27,23,0.8518518518518519,"Blunt object - hammer, club, etc",4
4389709,1,Rural Tennessee,4,26,22,0.8461538461538461,Fire,4
26312146,1,"Ogden-Clearfield, UT",5,26,22,0.8461538461538461,"Firearm, type not stated",4
38891257,1,"Harrisburg-Carlisle, PA",1,26,22,0.8461538461538461,"Blunt object - hammer, club, etc",4
56474205,1,Rural Maine,10,26,22,0.8461538461538461,Other or type unknown,4
66120209,1,Rural Iowa,14,26,22,0.8461538461538461,Rifle,4
67113617,1,"Milwaukee-Waukesha-West Allis, WI",16,26,22,0.8461538461538461,Strangulation - hanging,4
80353966,1,"Pittsburgh, PA",8,26,22,0.8461538461538461,"Narcotics or drugs, sleeping pills",4
8368245,2,"Terre Haute, IN",6,25,21,0.84,"Handgun - pistol, revolver, etc",4
35949895,2,"Oxnard-Thousand Oaks-Ventura, CA",5,25,21,0.84,"Firearm, type not stated",4
50601703,1,"Brownsville-Harlingen, TX",15,25,21,0.84,Shotgun,4
50740774,2,"Wilmington, NC",7,25,21,0.84,Knife or cutting instrument,4
54127674,2,"Lancaster, PA",10,25,21,0.84,Other or type unknown,4
67724414,1,"Decatur, IL",7,25,21,0.84,Knife or cutting instrument,4
79521964,1,Rural Idaho,10,25,21,0.84,Other or type unknown,4
82833597,1,"Waco, TX",14,25,21,0.84,Rifle,4
83419957,1,"Yuba City, CA",14,25,21,0.84,Rifle,4
99290078,2,"Visalia-Porterville, CA",11,25,21,0.84,"Personal weapons, includes beating",4
1867682,2,Rural Nevada,10,24,20,0.8333333333333334,Other or type unknown,4
2263279,1,"Joplin, MO",7,24,20,0.8333333333333334,Knife or cutting instrument,4
14174280,1,"Wenatchee, WA",7,24,20,0.8333333333333334,Knife or cutting instrument,4
46141469,2,Rural Vermont,7,24,20,0.8333333333333334,Knife or cutting instrument,4
51289123,2,Rural Vermont,10,24,20,0.8333333333333334,Other or type unknown,4
54307680,2,"Elkhart-Goshen, IN",7,24,20,0.8333333333333334,Knife or cutting instrument,4
66126313,1,"Elkhart-Goshen, IN",7,24,20,0.8333333333333334,Knife or cutting instrument,4
80918842,1,"Punta Gorda, FL",6,24,20,0.8333333333333334,"Handgun - pistol, revolver, etc",4
87977395,2,"Augusta-Richmond County, GA-SC",1,24,20,0.8333333333333334,"Blunt object - hammer, club, etc",4
1514996,1,"Gulfport-Biloxi, MS",1,23,19,0.8260869565217391,"Blunt object - hammer, club, etc",4
7368863,2,"El Paso, TX",5,23,19,0.8260869565217391,"Firearm, type not stated",4
9833220,2,"Jacksonville, NC",11,23,19,0.8260869565217391,"Personal weapons, includes beating",4
20691389,2,"Kennewick-Richland-Pasco, WA",7,23,19,0.8260869565217391,Knife or cutting instrument,4
24793508,1,Rural Pennsylvania,0,23,19,0.8260869565217391,Asphyxiation - includes death by gas,4
30885461,2,Rural Montana,11,23,19,0.8260869565217391,"Personal weapons, includes beating",4
38810000,1,"Savannah, GA",11,23,19,0.8260869565217391,"Personal weapons, includes beating",4
42052174,1,"Longview, WA",7,23,19,0.8260869565217391,Knife or cutting instrument,4
55814054,2,"Erie, PA",10,23,19,0.8260869565217391,Other or type unknown,4
72311424,2,"Evansville, IN-KY",10,23,19,0.8260869565217391,Other or type unknown,4
74573764,2,"New Haven-Milford, CT",4,23,19,0.8260869565217391,Fire,4
75391176,1,"Anderson, SC",1,23,19,0.8260869565217391,"Blunt object - hammer, club, etc",4
81209445,1,"Kankakee-Bradley, IL",7,23,19,0.8260869565217391,Knife or cutting instrument,4
87295644,2,"New York-New Jersey-Long Island, NY-NJ",2,23,19,0.8260869565217391,Drowning,4
2892363,2,"Goldsboro, NC",10,22,18,0.8181818181818182,Other or type unknown,4
9950475,1,"Sacramento-Roseville, CA",0,22,18,0.8181818181818182,Asphyxiation - includes death by gas,4
12777750,1,"Davenport-Moline-Rock Island, IA-IL",1,22,18,0.8181818181818182,"Blunt object - hammer, club, etc",4
20621088,2,Rural New Hampshire,7,22,18,0.8181818181818182,Knife or cutting instrument,4
27963029,2,"Santa Fe, NM",7,22,18,0.8181818181818182,Knife or cutting instrument,4
47698303,1,"Waco, TX",15,22,18,0.8181818181818182,Shotgun,4
55399407,2,"Cincinnati-Middletown, OH-KY-IN",14,22,18,0.8181818181818182,Rifle,4
80145547,1,"Prescott, AZ",1,22,18,0.8181818181818182,"Blunt object - hammer, club, etc",4
82502182,2,"New York-New Jersey-Long Island, NY-NJ",12,22,18,0.8181818181818182,Poison - does not include gas,4
83753182,1,Rural Texas,0,22,18,0.8181818181818182,Asphyxiation - includes death by gas,4
91062136,2,"San Jose-Sunnyvale-Santa Clara, CA",15,22,18,0.8181818181818182,Shotgun,4
9476620,2,"Danville, VA",10,21,17,0.8095238095238095,Other or type unknown,4
9648867,2,"Huntsville, AL",11,21,17,0.8095238095238095,"Personal weapons, includes beating",4
16326127,1,"Cleveland, TN",5,21,17,0.8095238095238095,"Firearm, type not stated",4
46008587,1,"Santa Barbara-Santa Maria, CA",14,21,17,0.8095238095238095,Rifle,4
50218544,1,"Battle Creek, MI",1,21,17,0.8095238095238095,"Blunt object - hammer, club, etc",4
59724589,2,Rural New Mexico,1,21,17,0.8095238095238095,"Blunt object - hammer, club, etc",4
63022418,2,"Chattanooga, TN-GA",1,21,17,0.8095238095238095,"Blunt object - hammer, club, etc",4
66118621,2,Rural Texas,0,21,17,0.8095238095238095,Asphyxiation - includes death by gas,4
13610599,1,"Lansing-East Lansing, MI",14,20,16,0.8,Rifle,4
27286392,2,Rural Texas,4,20,16,0.8,Fire,4
29225011,2,"Tampa-St. Petersburg-Clearwater, FL",4,20,16,0.8,Fire,4
30665251,2,"Anniston-Oxford, AL",7,20,16,0.8,Knife or cutting instrument,4
34839970,1,"Jackson, MI",11,20,16,0.8,"Personal weapons, includes beating",4
42443295,1,"Cedar Rapids, IA",7,20,16,0.8,Knife or cutting instrument,4
44489792,1,"Syracuse, NY",14,20,16,0.8,Rifle,4
56604191,1,"Milwaukee-Waukesha-West Allis, WI",8,20,16,0.8,"Narcotics or drugs, sleeping pills",4
65410222,2,"Roanoke, VA",5,20,16,0.8,"Firearm, type not stated",4
86352457,2,"Joplin, MO",6,20,16,0.8,"Handgun - pistol, revolver, etc",4
88859743,1,Rural Delaware,15,20,16,0.8,Shotgun,4
97632677,2,"Chico, CA",7,20,16,0.8,Knife or cutting instrument,4
6115882,2,"Orlando-Kissimmee, FL",14,19,15,0.7894736842105263,Rifle,4
6504407,2,"Sacramento-Roseville, CA",8,19,15,0.7894736842105263,"Narcotics or drugs, sleeping pills",4
6748897,2,"Knoxville, TN",1,19,15,0.7894736842105263,"Blunt object - hammer, club, etc",4
15408915,2,"Greeley, CO",7,19,15,0.7894736842105263,Knife or cutting instrument,4
28104880,1,"College Station-Bryan, TX",5,19,15,0.7894736842105263,"Firearm, type not stated",4
41187152,1,"Springfield, MA",15,19,15,0.7894736842105263,Shotgun,4
44579084,1,"Syracuse, NY",10,19,15,0.7894736842105263,Other or type unknown,4
51065911,1,"Rocky Mount, NC",1,19,15,0.7894736842105263,"Blunt object - hammer, club, etc",4
72513993,1,Rural Missouri,4,19,15,0.7894736842105263,Fire,4
76200573,1,"Boise City-Nampa, ID",1,19,15,0.7894736842105263,"Blunt object - hammer, club, etc",4
76996360,2,"Portland-South Portland-Biddeford, ME",11,19,15,0.7894736842105263,"Personal weapons, includes beating",4
82156522,1,"Santa Barbara-Santa Maria, CA",15,19,15,0.7894736842105263,Shotgun,4
82590523,2,"Fort Wayne, IN",11,19,15,0.7894736842105263,"Personal weapons, includes beating",4
85577244,1,Rural New Hampshire,10,19,15,0.7894736842105263,Other or type unknown,4
87961626,1,"Oklahoma City, OK",4,19,15,0.7894736842105263,Fire,4
90207674,2,"Rochester, NY",14,19,15,0.7894736842105263,Rifle,4
15940895,1,"Pine Bluff, AR",1,18,14,0.7777777777777778,"Blunt object - hammer, club, etc",4
41099068,1,"Charlotte-Gastonia-Concord, NC-SC",4,18,14,0.7777777777777778,Fire,4
42518856,2,"Toledo, OH",15,18,14,0.7777777777777778,Shotgun,4
47511134,1,"San Luis Obispo-Paso Robles, CA",14,18,14,0.7777777777777778,Rifle,4
66687304,1,"Canton-Massillon, OH",14,18,14,0.7777777777777778,Rifle,4
70937605,2,"Utica-Rome, NY",6,18,14,0.7777777777777778,"Handgun - pistol, revolver, etc",4
78036064,2,Rural Wyoming,10,18,14,0.7777777777777778,Other or type unknown,4
83868675,2,"Macon, GA",5,18,14,0.7777777777777778,"Firearm, type not stated",4
89053529,1,Rural Maine,1,18,14,0.7777777777777778,"Blunt object - hammer, club, etc",4
93805396,1,"Topeka, KS",15,18,14,0.7777777777777778,Shotgun,4
98471569,2,"Lawton, OK",7,18,14,0.7777777777777778,Knife or cutting instrument,4
99542931,1,"El Centro, CA",1,18,14,0.7777777777777778,"Blunt object - hammer, club, etc",4
11451494,1,"Abilene, TX",1,17,13,0.7647058823529411,"Blunt object - hammer, club, etc",4
14732908,1,"Lake Charles, LA",1,17,13,0.7647058823529411,"Blunt object - hammer, club, etc",4
21998917,2,"Longview, TX",5,17,13,0.7647058823529411,"Firearm, type not stated",4
31900935,1,"Redding, CA",1,17,13,0.7647058823529411,"Blunt object - hammer, club, etc",4
37033303,2,"Raleigh-Cary, NC",1,17,13,0.7647058823529411,"Blunt object - hammer, club, etc",4
47309830,2,"Detroit-Warren-Livonia, MI",2,17,13,0.7647058823529411,Drowning,4
52642371,2,"Las Cruces, NM",7,17,13,0.7647058823529411,Knife or cutting instrument,4
66881857,2,Rural Alaska,1,17,13,0.7647058823529411,"Blunt object - hammer, club, etc",4
71600742,2,"Fresno, CA",14,17,13,0.7647058823529411,Rifle,4
89105883,2,"Kankakee-Bradley, IL",6,17,13,0.7647058823529411,"Handgun - pistol, revolver, etc",4
94957908,1,"Parkersburg-Marietta-Vienna, WV-OH",10,17,13,0.7647058823529411,Other or type unknown,4
8254623,1,"Grand Junction, CO",5,16,12,0.75,"Firearm, type not stated",4
26301216,2,"Montgomery, AL",14,16,12,0.75,Rifle,4
27707153,1,"Seattle-Tacoma-Bellevue, WA",0,16,12,0.75,Asphyxiation - includes death by gas,4
38301822,1,"Naples-Marco Island, FL",15,16,12,0.75,Shotgun,4
46112355,2,"Las Vegas-Paradise, NV",4,16,12,0.75,Fire,4
54800881,1,"Greeley, CO",10,16,12,0.75,Other or type unknown,4
56930714,1,"Muskegon-Norton Shores, MI",10,16,12,0.75,Other or type unknown,4
65222767,1,"Eugene-Springfield, OR",10,16,12,0.75,Other or type unknown,4
70747895,2,"Gainesville, FL",11,16,12,0.75,"Personal weapons, includes beating",4
73156397,1,"Portland-Vancouver-Beaverton, OR-WA",0,16,12,0.75,Asphyxiation - includes death by gas,4
78789251,2,"Flint, MI",14,16,12,0.75,Rifle,4
80216094,2,"Yuma, AZ",5,16,12,0.75,"Firearm, type not stated",4
81967576,1,"Columbia, SC",4,16,12,0.75,Fire,4
82105013,2,"Decatur, AL",7,16,12,0.75,Knife or cutting instrument,4
83004871,2,"Tulsa, OK",4,16,12,0.75,Fire,4
93668953,1,"Honolulu, HI",4,16,12,0.75,Fire,4
93892650,2,"Louisville, KY-IN",4,16,12,0.75,Fire,4
96761343,1,"Orlando-Kissimmee, FL",8,16,12,0.75,"Narcotics or drugs, sleeping pills",4
97118541,2,"Albany-Schenectady-Troy, NY",16,16,12,0.75,Strangulation - hanging,4
3854324,2,"Madera, CA",7,15,11,0.7333333333333333,Knife or cutting instrument,4
5934450,2,"Chico, CA",1,15,11,0.7333333333333333,"Blunt object - hammer, club, etc",4
6581016,1,"Norwich-New London, CT",5,15,11,0.7333333333333333,"Firearm, type not stated",4
7062046,1,"Santa Rosa-Petaluma, CA",10,15,11,0.7333333333333333,Other or type unknown,4
15075890,1,"Joplin, MO",1,15,11,0.7333333333333333,"Blunt object - hammer, club, etc",4
15963755,1,"Hanford-Corcoran, CA",10,15,11,0.7333333333333333,Other or type unknown,4
20104563,1,"New Orleans-Metairie-Kenner, LA",0,15,11,0.7333333333333333,Asphyxiation - includes death by gas,4
25011925,1,"Ocala, FL",1,15,11,0.7333333333333333,"Blunt object - hammer, club, etc",4
25031044,2,"Dothan, AL",7,15,11,0.7333333333333333,Knife or cutting instrument,4
29012710,1,"Santa Barbara-Santa Maria, CA",10,15,11,0.7333333333333333,Other or type unknown,4
44760189,1,"Lawton, OK",10,15,11,0.7333333333333333,Other or type unknown,4
50291747,2,"Tucson, AZ",5,15,11,0.7333333333333333,"Firearm, type not stated",4
52167636,2,"Utica-Rome, NY",11,15,11,0.7333333333333333,"Personal weapons, includes beating",4
58085815,2,"Vallejo-Fairfield, CA",14,15,11,0.7333333333333333,Rifle,4
62547170,2,Rural Idaho,10,15,11,0.7333333333333333,Other or type unknown,4
78383575,1,Rural Arkansas,9,15,11,0.7333333333333333,Other gun,4
97779280,1,"Akron, OH",4,15,11,0.7333333333333333,Fire,4
97865755,1,"Cleveland-Elyria-Mentor, OH",0,15,11,0.7333333333333333,Asphyxiation - includes death by gas,4
460042,2,Rural Illinois,10,14,10,0.7142857142857143,Other or type unknown,4
1184894,1,"Brunswick, GA",10,14,10,0.7142857142857143,Other or type unknown,4
5175383,2,"Omaha-Council Bluffs, NE-IA",1,14,10,0.7142857142857143,"Blunt object - hammer, club, etc",4
5428879,1,"Utica-Rome, NY",10,14,10,0.7142857142857143,Other or type unknown,4
11517770,1,"Vineland-Millville-Bridgeton, NJ",1,14,10,0.7142857142857143,"Blunt object - hammer, club, etc",4
24830187,1,Rural Oregon,4,14,10,0.7142857142857143,Fire,4
34520458,2,"Naples-Marco Island, FL",5,14,10,0.7142857142857143,"Firearm, type not stated",4
49475457,2,"Portland-South Portland-Biddeford, ME",1,14,10,0.7142857142857143,"Blunt object - hammer, club, etc",4
51998828,2,"Buffalo-Niagara Falls, NY",4,14,10,0.7142857142857143,Fire,4
53609096,2,"Lubbock, TX",1,14,10,0.7142857142857143,"Blunt object - hammer, club, etc",4
74016721,1,"Columbus, OH",0,14,10,0.7142857142857143,Asphyxiation - includes death by gas,4
77622581,2,"Syracuse, NY",10,14,10,0.7142857142857143,Other or type unknown,4
82965606,2,"Richmond, VA",0,14,10,0.7142857142857143,Asphyxiation - includes death by gas,4
84739713,1,"Evansville, IN-KY",1,14,10,0.7142857142857143,"Blunt object - hammer, club, etc",4
86489463,1,"Pueblo, CO",15,14,10,0.7142857142857143,Shotgun,4
92401877,2,"Winston-Salem, NC",1,14,10,0.7142857142857143,"Blunt object - hammer, club, etc",4
96848716,1,"Cincinnati-Middletown, OH-KY-IN",16,14,10,0.7142857142857143,Strangulation - hanging,4
98322808,2,"Anchorage, AK",16,14,10,0.7142857142857143,Strangulation - hanging,4
1284820,2,Rural Missouri,4,13,9,0.6923076923076923,Fire,4
1446578,2,"Des Moines, IA",1,13,9,0.6923076923076923,"Blunt object - hammer, club, etc",4
2711404,1,"Hinesville-Fort Stewart, GA",5,13,9,0.6923076923076923,"Firearm, type not stated",4
4568273,1,"El Centro, CA",11,13,9,0.6923076923076923,"Personal weapons, includes beating",4
5856601,2,"Trenton-Ewing, NJ",5,13,9,0.6923076923076923,"Firearm, type not stated",4
10033118,1,"Gadsden, AL",11,13,9,0.6923076923076923,"Personal weapons, includes beating",4
13345252,2,"Hanford-Corcoran, CA",7,13,9,0.6923076923076923,Knife or cutting instrument,4
20659377,2,"Yuba City, CA",7,13,9,0.6923076923076923,Knife or cutting instrument,4
22980604,2,Rural Washington,5,13,9,0.6923076923076923,"Firearm, type not stated",4
29984145,2,"Youngstown-Warren-Boardman, OH-PA",4,13,9,0.6923076923076923,Fire,4
30102208,2,"Hagerstown-Martinsburg, MD-WV",10,13,9,0.6923076923076923,Other or type unknown,4
32954127,2,Rural Hawaii,1,13,9,0.6923076923076923,"Blunt object - hammer, club, etc",4
34876826,2,"Farmington, NM",10,13,9,0.6923076923076923,Other or type unknown,4
50620707,2,"Nashville-Davidson-Murfreesboro, TN",4,13,9,0.6923076923076923,Fire,4
51292542,2,"Jackson, TN",10,13,9,0.6923076923076923,Other or type unknown,4
61300086,1,"Grand Forks, ND-MN",6,13,9,0.6923076923076923,"Handgun - pistol, revolver, etc",4
63142753,2,"Greensboro-High Point, NC",9,13,9,0.6923076923076923,Other gun,4
63600259,2,"Waterloo-Cedar Falls, IA",5,13,9,0.6923076923076923,"Firearm, type not stated",4
65349146,2,"Gadsden, AL",10,13,9,0.6923076923076923,Other or type unknown,4
66641134,1,"Monroe, MI",10,13,9,0.6923076923076923,Other or type unknown,4
68368074,2,"Portland-South Portland-Biddeford, ME",16,13,9,0.6923076923076923,Strangulation - hanging,4
68429391,2,"Lexington-Fayette, KY",1,13,9,0.6923076923076923,"Blunt object - hammer, club, etc",4
69592882,2,"Morristown, TN",7,13,9,0.6923076923076923,Knife or cutting instrument,4
71672839,1,"Kokomo, IN",5,13,9,0.6923076923076923,"Firearm, type not stated",4
82745092,2,"Jefferson City, MO",7,13,9,0.6923076923076923,Knife or cutting instrument,4
96484643,1,"Springfield, IL",1,13,9,0.6923076923076923,"Blunt object - hammer, club, etc",4
99476357,2,"Gainesville, FL",5,13,9,0.6923076923076923,"Firearm, type not stated",4
4646356,1,"Peoria, IL",1,12,8,0.6666666666666666,"Blunt object - hammer, club, etc",4
13762512,2,"Kansas City, MO-KS",2,12,8,0.6666666666666666,Drowning,4
21350628,1,Rural New York,17,12,8,0.6666666666666666,Weapon Not Reported,4
21571462,1,"Dover, DE",10,12,8,0.6666666666666666,Other or type unknown,4
42784628,1,"Hartford, CT",0,12,8,0.6666666666666666,Asphyxiation - includes death by gas,4
43183085,1,"Oklahoma City, OK",16,12,8,0.6666666666666666,Strangulation - hanging,4
48399197,2,"Billings, MT",7,12,8,0.6666666666666666,Knife or cutting instrument,4
58001458,1,"Texarkana, TX-Texarkana, AR",10,12,8,0.6666666666666666,Other or type unknown,4
64384934,1,"Albuquerque, NM",4,12,8,0.6666666666666666,Fire,4
64577408,2,"Anniston-Oxford, AL",5,12,8,0.6666666666666666,"Firearm, type not stated",4
69631569,2,"Waco, TX",5,12,8,0.6666666666666666,"Firearm, type not stated",4
70528062,1,"Decatur, AL",5,12,8,0.6666666666666666,"Firearm, type not stated",4
73176357,2,"Salt Lake City, UT",0,12,8,0.6666666666666666,Asphyxiation - includes death by gas,4
89881449,2,"Austin-Round Rock, TX",0,12,8,0.6666666666666666,Asphyxiation - includes death by gas,4
90499436,2,"Myrtle Beach-Conway, SC",1,12,8,0.6666666666666666,"Blunt object - hammer, club, etc",4
97331814,2,"Beaumont-Port Arthur, TX",16,12,8,0.6666666666666666,Strangulation - hanging,4
99319054,1,"Florence-Muscle Shoals, AL",14,12,8,0.6666666666666666,Rifle,4
3199164,1,"Altoona, PA",7,11,7,0.6363636363636364,Knife or cutting instrument,4
8689165,1,"Victoria, TX",1,11,7,0.6363636363636364,"Blunt object - hammer, club, etc",4
9657713,1,"Springfield, OH",1,11,7,0.6363636363636364,"Blunt object - hammer, club, etc",4
12018754,2,"San Antonio, TX",4,11,7,0.6363636363636364,Fire,4
18687146,1,"Buffalo-Niagara Falls, NY",17,11,7,0.6363636363636364,Weapon Not Reported,4
23241364,2,"New Orleans-Metairie-Kenner, LA",0,11,7,0.6363636363636364,Asphyxiation - includes death by gas,4
33812369,1,"Richmond, VA",16,11,7,0.6363636363636364,Strangulation - hanging,4
35924435,1,"Ithaca, NY",6,11,7,0.6363636363636364,"Handgun - pistol, revolver, etc",4
38918495,2,Rural Texas,2,11,7,0.6363636363636364,Drowning,4
42230869,2,"Waco, TX",1,11,7,0.6363636363636364,"Blunt object - hammer, club, etc",4
44491523,1,Rural Arizona,16,11,7,0.6363636363636364,Strangulation - hanging,4
51281429,2,"Rochester, NY",0,11,7,0.6363636363636364,Asphyxiation - includes death by gas,4
52884578,2,"Elkhart-Goshen, IN",10,11,7,0.6363636363636364,Other or type unknown,4
55735334,1,"Riverside-San Bernardino, CA",2,11,7,0.6363636363636364,Drowning,4
61388823,2,"Pascagoula, MS",11,11,7,0.6363636363636364,"Personal weapons, includes beating",4
61547142,2,"Texarkana, TX-Texarkana, AR",1,11,7,0.6363636363636364,"Blunt object - hammer, club, etc",4
68387709,2,"Naples-Marco Island, FL",1,11,7,0.6363636363636364,"Blunt object - hammer, club, etc",4
68514880,2,"Albuquerque, NM",0,11,7,0.6363636363636364,Asphyxiation - includes death by gas,4
87136752,2,Rural Virginia,4,11,7,0.6363636363636364,Fire,4
91817435,2,"Gulfport-Biloxi, MS",5,11,7,0.6363636363636364,"Firearm, type not stated",4
10270861,2,"Lansing-East Lansing, MI",1,10,6,0.6,"Blunt object - hammer, club, etc",4
21292998,1,Rural Arkansas,16,10,6,0.6,Strangulation - hanging,4
46724016,1,"Salem, OR",16,10,6,0.6,Strangulation - hanging,4
61149534,2,"Florence-Muscle Shoals, AL",7,10,6,0.6,Knife or cutting instrument,4
61385386,1,"Milwaukee-Waukesha-West Allis, WI",9,10,6,0.6,Other gun,4
71499757,2,"Rockford, IL",5,10,6,0.6,"Firearm, type not stated",4
75279967,2,"Bridgeport-Stamford-Norwalk, CT",0,10,6,0.6,Asphyxiation - includes death by gas,4
77228516,2,"Hot Springs, AR",5,10,6,0.6,"Firearm, type not stated",4
77331791,2,"Vero Beach, FL",10,10,6,0.6,Other or type unknown,4
84697075,1,"Oklahoma City, OK",0,10,6,0.6,Asphyxiation - includes death by gas,4
88201545,1,"Yakima, WA",16,10,6,0.6,Strangulation - hanging,4
97382433,2,"Savannah, GA",5,10,6,0.6,"Firearm, type not stated",4
561611,2,"Eugene-Springfield, OR",16,9,5,0.5555555555555556,Strangulation - hanging,4
9771760,1,"Minneapolis-St. Paul-Bloomington, MN-WI",9,9,5,0.5555555555555556,Other gun,4
13444090,1,"Cincinnati-Middletown, OH-KY-IN",9,9,5,0.5555555555555556,Other gun,4
29526074,1,Rural Florida,16,9,5,0.5555555555555556,Strangulation - hanging,4
33648604,2,Rural South Carolina,16,9,5,0.5555555555555556,Strangulation - hanging,4
38516566,2,"Valdosta, GA",1,9,5,0.5555555555555556,"Blunt object - hammer, club, etc",4
40880579,1,Rural Oregon,9,9,5,0.5555555555555556,Other gun,4
42951951,1,"Tampa-St. Petersburg-Clearwater, FL",16,9,5,0.5555555555555556,Strangulation - hanging,4
64540207,2,"Durham, NC",9,9,5,0.5555555555555556,Other gun,4
68478050,2,"Punta Gorda, FL",10,9,5,0.5555555555555556,Other or type unknown,4
75376230,1,"Norwich-New London, CT",4,9,5,0.5555555555555556,Fire,4
80969636,2,"Waterloo-Cedar Falls, IA",10,9,5,0.5555555555555556,Other or type unknown,4
81209091,1,"El Centro, CA",10,9,5,0.5555555555555556,Other or type unknown,4
11748725,9,"Mobile, AL",6,8,4,0.5,"Handgun - pistol, revolver, etc",4
24295603,2,"Odessa, TX",1,8,4,0.5,"Blunt object - hammer, club, etc",4
29798767,2,"Auburn-Opelika, AL",10,8,4,0.5,Other or type unknown,4
33330790,2,"Hinesville-Fort Stewart, GA",10,8,4,0.5,Other or type unknown,4
34405135,1,"Wheeling, WV-OH",5,8,4,0.5,"Firearm, type not stated",4
35456347,1,"Albuquerque, NM",9,8,4,0.5,Other gun,4
44276713,1,"Louisville, KY-IN",9,8,4,0.5,Other gun,4
50891993,1,"Napa, CA",1,8,4,0.5,"Blunt object - hammer, club, etc",4
51561835,2,"Yuba City, CA",10,8,4,0.5,Other or type unknown,4
54332158,2,"Kennewick-Richland-Pasco, WA",1,8,4,0.5,"Blunt object - hammer, club, etc",4
56217360,1,"College Station-Bryan, TX",10,8,4,0.5,Other or type unknown,4
62868396,1,Rural Pennsylvania,16,8,4,0.5,Strangulation - hanging,4
81055865,1,"Muncie, IN",10,8,4,0.5,Other or type unknown,4
81534941,1,"Valdosta, GA",1,8,4,0.5,"Blunt object - hammer, club, etc",4
88464214,1,"Augusta-Richmond County, GA-SC",0,8,4,0.5,Asphyxiation - includes death by gas,4
93118817,2,"Rocky Mount, NC",9,8,4,0.5,Other gun,4
94312378,2,"Greeley, CO",1,8,4,0.5,"Blunt object - hammer, club, etc",4
94592894,2,"Spokane, WA",0,8,4,0.5,Asphyxiation - includes death by gas,4
99782809,1,"Salinas, CA",8,8,4,0.5,"Narcotics or drugs, sleeping pills",4
3254094,1,"El Paso, TX",4,7,3,0.42857142857142855,Fire,4
17827537,1,"Salinas, CA",16,7,3,0.42857142857142855,Strangulation - hanging,4
22474590,1,"Palm Bay-Melbourne-Titusville, FL",9,7,3,0.42857142857142855,Other gun,4
30780551,2,"Decatur, AL",10,7,3,0.42857142857142855,Other or type unknown,4
33550900,1,"Toledo, OH",16,7,3,0.42857142857142855,Strangulation - hanging,4
36930682,9,"Seattle-Tacoma-Bellevue, WA",5,7,3,0.42857142857142855,"Firearm, type not stated",4
47389553,1,"Pine Bluff, AR",9,7,3,0.42857142857142855,Other gun,4
53618944,2,"New Orleans-Metairie-Kenner, LA",9,7,3,0.42857142857142855,Other gun,4
54111265,1,"Charleston, WV",9,7,3,0.42857142857142855,Other gun,4
55589842,1,"Erie, PA",9,7,3,0.42857142857142855,Other gun,4
69431638,1,"Grand Junction, CO",10,7,3,0.42857142857142855,Other or type unknown,4
70547417,2,"Prescott, AZ",10,7,3,0.42857142857142855,Other or type unknown,4
73385080,2,"Mansfield, OH",10,7,3,0.42857142857142855,Other or type unknown,4
76876496,1,"Joplin, MO",5,7,3,0.42857142857142855,"Firearm, type not stated",4
81335193,2,"Springfield, IL",16,7,3,0.42857142857142855,Strangulation - hanging,4
82997619,2,Rural Ohio,16,7,3,0.42857142857142855,Strangulation - hanging,4
87306906,2,"Terre Haute, IN",5,7,3,0.42857142857142855,"Firearm, type not stated",4
89999892,2,"Valdosta, GA",16,7,3,0.42857142857142855,Strangulation - hanging,4
97402715,1,Rural California,4,7,3,0.42857142857142855,Fire,4
1581416,9,"Columbus, OH",10,6,2,0.3333333333333333,Other or type unknown,4
2139997,9,"Mobile, AL",10,6,2,0.3333333333333333,Other or type unknown,4
3609149,2,"York-Hanover, PA",5,6,2,0.3333333333333333,"Firearm, type not stated",4
12521105,2,"Merced, CA",4,6,2,0.3333333333333333,Fire,4
12578970,2,Rural Kentucky,16,6,2,0.3333333333333333,Strangulation - hanging,4
21812152,2,Rural Mississippi,0,6,2,0.3333333333333333,Asphyxiation - includes death by gas,4
28961128,2,"Pensacola-Ferry Pass-Brent, FL",16,6,2,0.3333333333333333,Strangulation - hanging,4
33357594,2,"Anniston-Oxford, AL",10,6,2,0.3333333333333333,Other or type unknown,4
41472937,2,"Bremerton-Silverdale, WA",5,6,2,0.3333333333333333,"Firearm, type not stated",4
46302166,1,"Mobile, AL",16,6,2,0.3333333333333333,Strangulation - hanging,4
53320773,9,Rural North Carolina,11,6,2,0.3333333333333333,"Personal weapons, includes beating",4
57931044,2,"Tucson, AZ",4,6,2,0.3333333333333333,Fire,4
58056272,9,"Cleveland-Elyria-Mentor, OH",6,6,2,0.3333333333333333,"Handgun - pistol, revolver, etc",4
70782458,9,Rural Virginia,10,6,2,0.3333333333333333,Other or type unknown,4
72260698,1,"Rochester, NY",17,6,2,0.3333333333333333,Weapon Not Reported,4
73619292,1,"Columbus, OH",16,6,2,0.3333333333333333,Strangulation - hanging,4
76949525,2,"Houma-Bayou Cane-Thibodaux, LA",14,6,2,0.3333333333333333,Rifle,4
80130513,1,"Kokomo, IN",4,6,2,0.3333333333333333,Fire,4
80901201,2,"Alexandria, LA",16,6,2,0.3333333333333333,Strangulation - hanging,4
83615596,2,"Waco, TX",16,6,2,0.3333333333333333,Strangulation - hanging,4
94225509,2,"Greenville, NC",9,6,2,0.3333333333333333,Other gun,4
15075714,1,Rural Maryland,2,5,1,0.2,Drowning,4
21715801,1,"Naples-Marco Island, FL",4,5,1,0.2,Fire,4
46272886,1,"Manchester-Nashua, NH",4,5,1,0.2,Fire,4
53926299,9,"San Diego-Carlsbad-San Marcos, CA",10,5,1,0.2,Other or type unknown,4
61468824,9,Rural Kentucky,10,5,1,0.2,Other or type unknown,4
66319038,1,"Flint, MI",16,5,1,0.2,Strangulation - hanging,4
86384008,9,"Trenton-Ewing, NJ",10,5,1,0.2,Other or type unknown,4
89496828,1,"Brownsville-Harlingen, TX",2,5,1,0.2,Drowning,4
1611300,2,Rural Oregon,17,4,0,0.0,Weapon Not Reported,4
2448123,1,"Indianapolis, IN",9,4,0,0.0,Other gun,4
10391082,1,"Little Rock-North Little Rock, AR",17,4,0,0.0,Weapon Not Reported,4
18542629,2,"Columbus, OH",17,4,0,0.0,Weapon Not Reported,4
20948025,1,"Las Vegas-Paradise, NV",17,4,0,0.0,Weapon Not Reported,4
21066391,2,"Miami-Fort Lauderdale, FL",17,4,0,0.0,Weapon Not Reported,4
25162217,1,Rural Iowa,17,4,0,0.0,Weapon Not Reported,4
30088688,1,Rural Oregon,17,4,0,0.0,Weapon Not Reported,4
32108179,1,"Virginia Beach-Norfolk-Newport News, VA-NC",17,4,0,0.0,Weapon Not Reported,4
35405710,1,"Gulfport-Biloxi, MS",0,4,0,0.0,Asphyxiation - includes death by gas,4
36120476,2,"El Paso, TX",17,4,0,0.0,Weapon Not Reported,4
37490644,2,Rural South Carolina,17,4,0,0.0,Weapon Not Reported,4
37804839,2,Rural Texas,17,4,0,0.0,Weapon Not Reported,4
37854191,2,Rural Alabama,17,4,0,0.0,Weapon Not Reported,4
38306996,2,"Philadelphia-Camden-Wilmington, PA-NJ-DE",17,4,0,0.0,Weapon Not Reported,4
45587402,2,"Manchester-Nashua, NH",16,4,0,0.0,Strangulation - hanging,4
49663040,1,"Vallejo-Fairfield, CA",17,4,0,0.0,Weapon Not Reported,4
51732987,2,"Medford, OR",17,4,0,0.0,Weapon Not Reported,4
58059583,2,"Austin-Round Rock, TX",17,4,0,0.0,Weapon Not Reported,4
59385924,1,"Mobile, AL",17,4,0,0.0,Weapon Not Reported,4
60034825,9,"Las Vegas-Paradise, NV",10,4,0,0.0,Other or type unknown,4
65381887,1,"Minneapolis-St. Paul-Bloomington, MN-WI",17,4,0,0.0,Weapon Not Reported,4
73887709,2,"Lawton, OK",16,4,0,0.0,Strangulation - hanging,4
74257142,1,"Alexandria, LA",17,4,0,0.0,Weapon Not Reported,4
75197413,2,"Minneapolis-St. Paul-Bloomington, MN-WI",9,4,0,0.0,Other gun,4
77712196,1,"Norwich-New London, CT",3,4,0,0.0,Explosives,4
81080591,1,Rural Mississippi,17,4,0,0.0,Weapon Not Reported,4
81337529,2,"Washington-Arlington-Alexandria, DC-VA-MD-WV",17,4,0,0.0,Weapon Not Reported,4
82893618,2,"San Diego-Carlsbad-San Marcos, CA",17,4,0,0.0,Weapon Not Reported,4
86298594,9,"Brownsville-Harlingen, TX",5,4,0,0.0,"Firearm, type not stated",4
87215113,1,"Anchorage, AK",17,4,0,0.0,Weapon Not Reported,4
88373393,1,"Charlottesville, VA",17,4,0,0.0,Weapon Not Reported,4
91517081,9,"Los Angeles-Long Beach, CA",10,4,0,0.0,Other or type unknown,4
92327756,1,"Yuma, AZ",17,4,0,0.0,Weapon Not Reported,4
92686706,2,Rural Louisiana,17,4,0,0.0,Weapon Not Reported,4
98362514,9,"Chicago-Naperville-Joliet, IL-IN-WI",9,4,0,0.0,Other gun,4
10346745,2,Rural Texas,14,184,181,0.9836956521739131,Rifle,3
86566839,1,Rural Wisconsin,6,184,181,0.9836956521739131,"Handgun - pistol, revolver, etc",3
45580544,1,"Columbia, SC",15,128,125,0.9765625,Shotgun,3
17337658,1,"Nashville-Davidson-Murfreesboro, TN",11,110,107,0.9727272727272728,"Personal weapons, includes beating",3
57557313,1,"Greenville, SC",15,109,106,0.9724770642201835,Shotgun,3
59968933,1,"Blacksburg-Christiansburg, VA",6,96,93,0.96875,"Handgun - pistol, revolver, etc",3
79027016,1,"Albany, GA",7,95,92,0.968421052631579,Knife or cutting instrument,3
6973347,2,Rural Oklahoma,14,84,81,0.9642857142857143,Rifle,3
44972730,1,Rural West Virginia,11,84,81,0.9642857142857143,"Personal weapons, includes beating",3
2009418,1,"El Paso, TX",11,81,78,0.9629629629629629,"Personal weapons, includes beating",3
87800239,2,Rural Mississippi,15,80,77,0.9625,Shotgun,3
49080454,1,"San Angelo, TX",6,78,75,0.9615384615384616,"Handgun - pistol, revolver, etc",3
40621917,2,"Palm Bay-Melbourne-Titusville, FL",6,76,73,0.9605263157894737,"Handgun - pistol, revolver, etc",3
7240478,1,Rural New York,14,72,69,0.9583333333333334,Rifle,3
50137079,1,Rural Georgia,11,70,67,0.9571428571428572,"Personal weapons, includes beating",3
28485845,1,"Little Rock-North Little Rock, AR",11,68,65,0.9558823529411765,"Personal weapons, includes beating",3
69487896,1,"Columbia, SC",14,68,65,0.9558823529411765,Rifle,3
44274476,2,Rural Tennessee,11,66,63,0.9545454545454546,"Personal weapons, includes beating",3
82319530,1,Rural Indiana,11,66,63,0.9545454545454546,"Personal weapons, includes beating",3
91523226,2,"Lynchburg, VA",6,66,63,0.9545454545454546,"Handgun - pistol, revolver, etc",3
23158831,2,Rural Minnesota,7,63,60,0.9523809523809523,Knife or cutting instrument,3
85248358,1,"Greenville, SC",11,63,60,0.9523809523809523,"Personal weapons, includes beating",3
78126396,1,"Hickory-Lenoir-Morganton, NC",14,62,59,0.9516129032258065,Rifle,3
43071227,2,Rural Mississippi,11,61,58,0.9508196721311475,"Personal weapons, includes beating",3
57899361,1,"Cleveland, TN",6,59,56,0.9491525423728814,"Handgun - pistol, revolver, etc",3
18554009,2,"Charleston-North Charleston, SC",11,58,55,0.9482758620689655,"Personal weapons, includes beating",3
75917364,1,"Lakeland, FL",11,57,54,0.9473684210526315,"Personal weapons, includes beating",3
8486627,1,"Lynchburg, VA",7,56,53,0.9464285714285714,Knife or cutting instrument,3
47798410,2,"Seattle-Tacoma-Bellevue, WA",14,56,53,0.9464285714285714,Rifle,3
94058130,1,"Midland, TX",7,56,53,0.9464285714285714,Knife or cutting instrument,3
11295240,1,Rural Oregon,11,55,52,0.9454545454545454,"Personal weapons, includes beating",3
93623860,1,Rural Indiana,14,55,52,0.9454545454545454,Rifle,3
63324995,2,"Little Rock-North Little Rock, AR",11,54,51,0.9444444444444444,"Personal weapons, includes beating",3
25210741,1,Rural Minnesota,15,53,50,0.9433962264150944,Shotgun,3
76627014,1,"Goldsboro, NC",7,53,50,0.9433962264150944,Knife or cutting instrument,3
25134492,2,"Oklahoma City, OK",15,52,49,0.9423076923076923,Shotgun,3
42566792,1,"Hattiesburg, MS",7,52,49,0.9423076923076923,Knife or cutting instrument,3
85540642,1,Rural Colorado,11,52,49,0.9423076923076923,"Personal weapons, includes beating",3
86737647,2,"Reno-Sparks, NV",11,52,49,0.9423076923076923,"Personal weapons, includes beating",3
99657073,1,"Rocky Mount, NC",15,51,48,0.9411764705882353,Shotgun,3
4548787,2,Rural Indiana,15,50,47,0.94,Shotgun,3
57236020,2,"San Antonio, TX",15,50,47,0.94,Shotgun,3
73803933,1,Rural North Carolina,8,50,47,0.94,"Narcotics or drugs, sleeping pills",3
84835104,1,Rural Hawaii,11,50,47,0.94,"Personal weapons, includes beating",3
85852626,1,"Evansville, IN-KY",7,49,46,0.9387755102040817,Knife or cutting instrument,3
1830220,1,"Anchorage, AK",14,48,45,0.9375,Rifle,3
9308590,1,"Duluth, MN-WI",6,48,45,0.9375,"Handgun - pistol, revolver, etc",3
14957613,1,Rural Iowa,15,48,45,0.9375,Shotgun,3
29177543,1,"Pensacola-Ferry Pass-Brent, FL",11,48,45,0.9375,"Personal weapons, includes beating",3
34839982,1,"Grand Junction, CO",6,48,45,0.9375,"Handgun - pistol, revolver, etc",3
50948611,1,"Muskegon-Norton Shores, MI",7,48,45,0.9375,Knife or cutting instrument,3
74732778,1,"Pine Bluff, AR",15,48,45,0.9375,Shotgun,3
88742582,1,"Fayetteville-Springdale-Rogers, AR-MO",7,48,45,0.9375,Knife or cutting instrument,3
98774911,1,"Winchester, VA-WV",6,47,44,0.9361702127659575,"Handgun - pistol, revolver, etc",3
67712030,1,"Portland-South Portland-Biddeford, ME",7,45,42,0.9333333333333333,Knife or cutting instrument,3
76727791,2,"Texarkana, TX-Texarkana, AR",6,45,42,0.9333333333333333,"Handgun - pistol, revolver, etc",3
2772181,1,"Charleston, WV",14,44,41,0.9318181818181818,Rifle,3
11268928,2,Rural Maine,11,43,40,0.9302325581395349,"Personal weapons, includes beating",3
18539308,2,"Santa Cruz-Watsonville, CA",6,43,40,0.9302325581395349,"Handgun - pistol, revolver, etc",3
19685278,1,"Kingsport-Bristol-Bristol, TN-VA",5,43,40,0.9302325581395349,"Firearm, type not stated",3
33213331,2,"Fayetteville-Springdale-Rogers, AR-MO",6,43,40,0.9302325581395349,"Handgun - pistol, revolver, etc",3
80053683,1,"Huntington-Ashland, WV-KY-OH",15,43,40,0.9302325581395349,Shotgun,3
13819701,2,Rural New Hampshire,6,42,39,0.9285714285714286,"Handgun - pistol, revolver, etc",3
25118701,1,"Omaha-Council Bluffs, NE-IA",15,42,39,0.9285714285714286,Shotgun,3
93667928,2,"Raleigh-Cary, NC",15,42,39,0.9285714285714286,Shotgun,3
47429199,2,Rural Missouri,11,41,38,0.926829268292683,"Personal weapons, includes beating",3
88205991,1,"Dayton, OH",14,41,38,0.926829268292683,Rifle,3
88335935,1,"Sumter, SC",7,41,38,0.926829268292683,Knife or cutting instrument,3
27673355,2,"Sacramento-Roseville, CA",15,40,37,0.925,Shotgun,3
87830713,1,"Poughkeepsie-Newburgh-Middletown, NY",11,40,37,0.925,"Personal weapons, includes beating",3
4765661,1,Rural Illinois,11,39,36,0.9230769230769231,"Personal weapons, includes beating",3
23447275,1,"Myrtle Beach-Conway, SC",14,39,36,0.9230769230769231,Rifle,3
25471555,2,"Naples-Marco Island, FL",6,39,36,0.9230769230769231,"Handgun - pistol, revolver, etc",3
42705090,1,"Binghamton, NY",7,39,36,0.9230769230769231,Knife or cutting instrument,3
51364719,1,"Dothan, AL",15,39,36,0.9230769230769231,Shotgun,3
84518570,2,"Erie, PA",6,39,36,0.9230769230769231,"Handgun - pistol, revolver, etc",3
92258129,1,"Wilmington, NC",15,39,36,0.9230769230769231,Shotgun,3
95628646,2,"Manchester-Nashua, NH",7,39,36,0.9230769230769231,Knife or cutting instrument,3
19877340,1,"Jackson, TN",7,38,35,0.9210526315789473,Knife or cutting instrument,3
32048044,2,Rural Virginia,1,38,35,0.9210526315789473,"Blunt object - hammer, club, etc",3
72284306,1,"Anchorage, AK",15,38,35,0.9210526315789473,Shotgun,3
81733754,2,Rural Arizona,11,38,35,0.9210526315789473,"Personal weapons, includes beating",3
89160705,2,"Columbia, SC",1,38,35,0.9210526315789473,"Blunt object - hammer, club, etc",3
90468448,2,Rural New Mexico,11,38,35,0.9210526315789473,"Personal weapons, includes beating",3
96586807,2,"Greensboro-High Point, NC",15,38,35,0.9210526315789473,Shotgun,3
22910737,2,"Vineland-Millville-Bridgeton, NJ",6,37,34,0.918918918918919,"Handgun - pistol, revolver, etc",3
61245568,1,"Nashville-Davidson-Murfreesboro, TN",8,37,34,0.918918918918919,"Narcotics or drugs, sleeping pills",3
28514742,1,"Springfield, MA",11,36,33,0.9166666666666666,"Personal weapons, includes beating",3
42777786,2,Rural Kansas,5,36,33,0.9166666666666666,"Firearm, type not stated",3
43356420,1,"Harrisburg-Carlisle, PA",11,36,33,0.9166666666666666,"Personal weapons, includes beating",3
93686592,2,"Poughkeepsie-Newburgh-Middletown, NY",11,35,32,0.9142857142857143,"Personal weapons, includes beating",3
95939123,1,"Corpus Christi, TX",14,35,32,0.9142857142857143,Rifle,3
39499122,1,"Madison, WI",11,34,31,0.9117647058823529,"Personal weapons, includes beating",3
59806018,2,"Ocala, FL",5,34,31,0.9117647058823529,"Firearm, type not stated",3
74334495,1,Rural Hawaii,14,34,31,0.9117647058823529,Rifle,3
97949650,1,"Jonesboro, AR",7,34,31,0.9117647058823529,Knife or cutting instrument,3
30526712,1,"Allentown-Bethlehem-Easton, PA-NJ",11,33,30,0.9090909090909091,"Personal weapons, includes beating",3
55188887,2,"Santa Rosa-Petaluma, CA",7,33,30,0.9090909090909091,Knife or cutting instrument,3
62319665,1,"Madison, WI",10,33,30,0.9090909090909091,Other or type unknown,3
79017245,1,Rural Maine,15,33,30,0.9090909090909091,Shotgun,3
83465502,1,"San Angelo, TX",7,33,30,0.9090909090909091,Knife or cutting instrument,3
91918885,1,"Albany-Schenectady-Troy, NY",14,33,30,0.9090909090909091,Rifle,3
15236106,2,Rural Oregon,11,32,29,0.90625,"Personal weapons, includes beating",3
15898689,1,"Harrisburg-Carlisle, PA",15,32,29,0.90625,Shotgun,3
23896068,1,"Grand Junction, CO",7,32,29,0.90625,Knife or cutting instrument,3
51199244,2,Rural Wyoming,11,32,29,0.90625,"Personal weapons, includes beating",3
54608050,1,Rural Utah,7,32,29,0.90625,Knife or cutting instrument,3
95442375,1,Rural Montana,10,32,29,0.90625,Other or type unknown,3
10295865,1,"Harrisburg-Carlisle, PA",14,31,28,0.9032258064516129,Rifle,3
12914527,2,"Amarillo, TX",11,31,28,0.9032258064516129,"Personal weapons, includes beating",3
20325308,2,"Warner Robins, GA",6,31,28,0.9032258064516129,"Handgun - pistol, revolver, etc",3
54187374,1,"Billings, MT",7,31,28,0.9032258064516129,Knife or cutting instrument,3
59934331,1,"Lawrence, KS",6,31,28,0.9032258064516129,"Handgun - pistol, revolver, etc",3
60825038,1,"Auburn-Opelika, AL",7,31,28,0.9032258064516129,Knife or cutting instrument,3
70046999,1,"New York-New Jersey-Long Island, NY-NJ",2,31,28,0.9032258064516129,Drowning,3
74252785,1,"Medford, OR",7,31,28,0.9032258064516129,Knife or cutting instrument,3
5084816,2,Rural Kansas,15,30,27,0.9,Shotgun,3
29830578,1,"Denver-Aurora, CO",0,30,27,0.9,Asphyxiation - includes death by gas,3
57351539,1,"Bay City, MI",6,30,27,0.9,"Handgun - pistol, revolver, etc",3
87372700,1,"Boise City-Nampa, ID",14,30,27,0.9,Rifle,3
6807442,2,"Grand Rapids-Wyoming, MI",15,29,26,0.896551724137931,Shotgun,3
26284189,2,"Oklahoma City, OK",14,29,26,0.896551724137931,Rifle,3
56720722,1,"Gainesville, GA",7,29,26,0.896551724137931,Knife or cutting instrument,3
74694143,2,"Lubbock, TX",11,29,26,0.896551724137931,"Personal weapons, includes beating",3
97249058,1,"Lansing-East Lansing, MI",11,29,26,0.896551724137931,"Personal weapons, includes beating",3
13620754,1,"Norwich-New London, CT",7,28,25,0.8928571428571429,Knife or cutting instrument,3
17879116,2,"Youngstown-Warren-Boardman, OH-PA",11,28,25,0.8928571428571429,"Personal weapons, includes beating",3
18593495,2,"York-Hanover, PA",7,28,25,0.8928571428571429,Knife or cutting instrument,3
28946604,2,Rural New Hampshire,11,28,25,0.8928571428571429,"Personal weapons, includes beating",3
54901139,2,Rural Pennsylvania,0,28,25,0.8928571428571429,Asphyxiation - includes death by gas,3
65968037,2,"Springfield, OH",6,28,25,0.8928571428571429,"Handgun - pistol, revolver, etc",3
78157938,2,"Wilmington, NC",11,28,25,0.8928571428571429,"Personal weapons, includes beating",3
82083820,2,"Pascagoula, MS",6,28,25,0.8928571428571429,"Handgun - pistol, revolver, etc",3
91242442,1,"Texarkana, TX-Texarkana, AR",14,28,25,0.8928571428571429,Rifle,3
7211550,1,Rural Wyoming,15,27,24,0.8888888888888888,Shotgun,3
7845687,1,"Columbus, GA-AL",11,27,24,0.8888888888888888,"Personal weapons, includes beating",3
23276975,1,Rural Minnesota,1,27,24,0.8888888888888888,"Blunt object - hammer, club, etc",3
23481867,1,"Prescott, AZ",7,27,24,0.8888888888888888,Knife or cutting instrument,3
43136744,2,"Mobile, AL",15,27,24,0.8888888888888888,Shotgun,3
88968478,2,"Colorado Springs, CO",5,27,24,0.8888888888888888,"Firearm, type not stated",3
92085069,2,"Merced, CA",7,27,24,0.8888888888888888,Knife or cutting instrument,3
93772521,1,"Philadelphia-Camden-Wilmington, PA-NJ-DE",2,27,24,0.8888888888888888,Drowning,3
95084086,1,"Rocky Mount, NC",11,27,24,0.8888888888888888,"Personal weapons, includes beating",3
44325259,1,"Odessa, TX",11,26,23,0.8846153846153846,"Personal weapons, includes beating",3
47353726,2,"Olympia, WA",6,26,23,0.8846153846153846,"Handgun - pistol, revolver, etc",3
65125743,1,"Allentown-Bethlehem-Easton, PA-NJ",15,26,23,0.8846153846153846,Shotgun,3
66224136,2,Rural Idaho,7,26,23,0.8846153846153846,Knife or cutting instrument,3
74336290,2,"Billings, MT",6,26,23,0.8846153846153846,"Handgun - pistol, revolver, etc",3
9945219,2,"Roanoke, VA",10,25,22,0.88,Other or type unknown,3
21225153,2,"Yuma, AZ",6,25,22,0.88,"Handgun - pistol, revolver, etc",3
30481779,1,"Waco, TX",11,25,22,0.88,"Personal weapons, includes beating",3
40829675,2,"Flagstaff, AZ",6,25,22,0.88,"Handgun - pistol, revolver, etc",3
71007196,2,"Hot Springs, AR",6,25,22,0.88,"Handgun - pistol, revolver, etc",3
84499663,2,"Washington-Arlington-Alexandria, DC-VA-MD-WV",8,25,22,0.88,"Narcotics or drugs, sleeping pills",3
85137872,2,Rural South Dakota,7,25,22,0.88,Knife or cutting instrument,3
6279179,2,"San Luis Obispo-Paso Robles, CA",6,24,21,0.875,"Handgun - pistol, revolver, etc",3
12547649,1,"Jacksonville, NC",11,24,21,0.875,"Personal weapons, includes beating",3
19605688,1,"Binghamton, NY",6,24,21,0.875,"Handgun - pistol, revolver, etc",3
46239745,1,"Alexandria, LA",14,24,21,0.875,Rifle,3
58001786,2,"Spokane, WA",11,24,21,0.875,"Personal weapons, includes beating",3
80203646,1,"Fairbanks, AK",7,24,21,0.875,Knife or cutting instrument,3
15865394,2,"College Station-Bryan, TX",7,23,20,0.8695652173913043,Knife or cutting instrument,3
20606237,1,"South Bend-Mishawaka, IN-MI",1,23,20,0.8695652173913043,"Blunt object - hammer, club, etc",3
50468676,1,"Manchester-Nashua, NH",5,23,20,0.8695652173913043,"Firearm, type not stated",3
50625775,2,"Scranton--Wilkes-Barre, PA",11,23,20,0.8695652173913043,"Personal weapons, includes beating",3
51079913,2,"Los Angeles-Long Beach, CA",12,23,20,0.8695652173913043,Poison - does not include gas,3
56662868,1,"St. Joseph, MO-KS",7,23,20,0.8695652173913043,Knife or cutting instrument,3
66721791,1,"Lake Charles, LA",10,23,20,0.8695652173913043,Other or type unknown,3
68191721,1,"Medford, OR",5,23,20,0.8695652173913043,"Firearm, type not stated",3
74586876,1,"Elmira, NY",7,23,20,0.8695652173913043,Knife or cutting instrument,3
90340863,1,"Tallahassee, FL",1,23,20,0.8695652173913043,"Blunt object - hammer, club, etc",3
93793053,1,"Odessa, TX",15,23,20,0.8695652173913043,Shotgun,3
95435999,1,"Cleveland-Elyria-Mentor, OH",8,23,20,0.8695652173913043,"Narcotics or drugs, sleeping pills",3
96609427,1,"Vallejo-Fairfield, CA",14,23,20,0.8695652173913043,Rifle,3
97570384,2,"Vero Beach, FL",6,23,20,0.8695652173913043,"Handgun - pistol, revolver, etc",3
21401970,1,"Portland-South Portland-Biddeford, ME",14,22,19,0.8636363636363636,Rifle,3
36287047,1,"Pocatello, ID",6,22,19,0.8636363636363636,"Handgun - pistol, revolver, etc",3
38565988,1,"Hattiesburg, MS",10,22,19,0.8636363636363636,Other or type unknown,3
41449694,1,"Honolulu, HI",15,22,19,0.8636363636363636,Shotgun,3
41529850,2,"Madison, WI",10,22,19,0.8636363636363636,Other or type unknown,3
56977366,1,"Rome, GA",7,22,19,0.8636363636363636,Knife or cutting instrument,3
65307707,1,"Chicago-Naperville-Joliet, IL-IN-WI",2,22,19,0.8636363636363636,Drowning,3
77061113,2,"Birmingham-Hoover, AL",14,22,19,0.8636363636363636,Rifle,3
80773322,2,"McAllen-Edinburg-Mission, TX",1,22,19,0.8636363636363636,"Blunt object - hammer, club, etc",3
82162959,1,"Sioux Falls, SD",7,22,19,0.8636363636363636,Knife or cutting instrument,3
85410078,1,Rural Wyoming,10,22,19,0.8636363636363636,Other or type unknown,3
89850827,2,"Columbus, GA-AL",11,22,19,0.8636363636363636,"Personal weapons, includes beating",3
96662809,2,Rural Colorado,1,22,19,0.8636363636363636,"Blunt object - hammer, club, etc",3
99031415,1,"Panama City-Lynn Haven, FL",10,22,19,0.8636363636363636,Other or type unknown,3
14502614,1,Rural South Dakota,1,21,18,0.8571428571428571,"Blunt object - hammer, club, etc",3
16555907,1,Rural Maryland,5,21,18,0.8571428571428571,"Firearm, type not stated",3
18486057,1,"Boise City-Nampa, ID",15,21,18,0.8571428571428571,Shotgun,3
19731638,1,"Green Bay, WI",10,21,18,0.8571428571428571,Other or type unknown,3
28597200,2,"Battle Creek, MI",11,21,18,0.8571428571428571,"Personal weapons, includes beating",3
39078826,2,"Durham, NC",14,21,18,0.8571428571428571,Rifle,3
40292609,2,"Salisbury, MD",6,21,18,0.8571428571428571,"Handgun - pistol, revolver, etc",3
51606601,1,"Joplin, MO",10,21,18,0.8571428571428571,Other or type unknown,3
54702678,1,"Abilene, TX",10,21,18,0.8571428571428571,Other or type unknown,3
57596432,2,"New York-New Jersey-Long Island, NY-NJ",13,21,18,0.8571428571428571,Pushed or thrown out window,3
62679996,1,"Santa Rosa-Petaluma, CA",11,21,18,0.8571428571428571,"Personal weapons, includes beating",3
85539660,2,"New York-New Jersey-Long Island, NY-NJ",8,21,18,0.8571428571428571,"Narcotics or drugs, sleeping pills",3
86158202,1,Rural Wyoming,1,21,18,0.8571428571428571,"Blunt object - hammer, club, etc",3
89881773,2,"Clarksville, TN-KY",15,21,18,0.8571428571428571,Shotgun,3
95462459,1,"Muskegon-Norton Shores, MI",15,21,18,0.8571428571428571,Shotgun,3
95762031,2,Rural Missouri,5,21,18,0.8571428571428571,"Firearm, type not stated",3
3525329,1,"Rockford, IL",1,20,17,0.85,"Blunt object - hammer, club, etc",3
6427826,2,"Columbus, OH",14,20,17,0.85,Rifle,3
25247560,1,Rural Vermont,11,20,17,0.85,"Personal weapons, includes beating",3
40393978,2,"Spartanburg, SC",11,20,17,0.85,"Personal weapons, includes beating",3
59811865,2,"Santa Rosa-Petaluma, CA",11,20,17,0.85,"Personal weapons, includes beating",3
63203722,1,"Deltona-Daytona Beach-Ormond Beach, FL",15,20,17,0.85,Shotgun,3
82397171,2,"Columbus, OH",8,20,17,0.85,"Narcotics or drugs, sleeping pills",3
87215676,1,"Mount Vernon-Anacortes, WA",7,20,17,0.85,Knife or cutting instrument,3
94452081,1,"Rome, GA",15,20,17,0.85,Shotgun,3
4247458,1,"Fargo, ND-MN",6,19,16,0.8421052631578947,"Handgun - pistol, revolver, etc",3
31304681,2,"Bremerton-Silverdale, WA",6,19,16,0.8421052631578947,"Handgun - pistol, revolver, etc",3
32848587,1,"Yuma, AZ",11,19,16,0.8421052631578947,"Personal weapons, includes beating",3
35810395,2,"Fayetteville, NC",14,19,16,0.8421052631578947,Rifle,3
51576337,2,"Farmington, NM",7,19,16,0.8421052631578947,Knife or cutting instrument,3
51996514,2,Rural Wisconsin,5,19,16,0.8421052631578947,"Firearm, type not stated",3
59496026,2,Rural Oklahoma,4,19,16,0.8421052631578947,Fire,3
65470448,2,"Lincoln, NE",7,19,16,0.8421052631578947,Knife or cutting instrument,3
68528631,1,"Redding, CA",11,19,16,0.8421052631578947,"Personal weapons, includes beating",3
69415039,1,"Medford, OR",10,19,16,0.8421052631578947,Other or type unknown,3
85012929,1,"Lincoln, NE",10,19,16,0.8421052631578947,Other or type unknown,3
91848806,2,"Worcester, MA",1,19,16,0.8421052631578947,"Blunt object - hammer, club, etc",3
97540881,1,"Muncie, IN",7,19,16,0.8421052631578947,Knife or cutting instrument,3
6562414,1,"Salisbury, MD",15,18,15,0.8333333333333334,Shotgun,3
14401907,2,"Duluth, MN-WI",7,18,15,0.8333333333333334,Knife or cutting instrument,3
25460926,2,"Oklahoma City, OK",0,18,15,0.8333333333333334,Asphyxiation - includes death by gas,3
25960400,1,"Jefferson City, MO",10,18,15,0.8333333333333334,Other or type unknown,3
29173855,1,"Parkersburg-Marietta-Vienna, WV-OH",15,18,15,0.8333333333333334,Shotgun,3
37834448,1,"Napa, CA",7,18,15,0.8333333333333334,Knife or cutting instrument,3
44388634,2,"Wichita, KS",15,18,15,0.8333333333333334,Shotgun,3
46688160,1,"Dover, DE",15,18,15,0.8333333333333334,Shotgun,3
56187589,2,"Green Bay, WI",7,18,15,0.8333333333333334,Knife or cutting instrument,3
59981064,2,"Tuscaloosa, AL",7,18,15,0.8333333333333334,Knife or cutting instrument,3
63545160,1,"Lafayette, LA",1,18,15,0.8333333333333334,"Blunt object - hammer, club, etc",3
66771057,2,"Valdosta, GA",7,18,15,0.8333333333333334,Knife or cutting instrument,3
69350575,2,Rural Utah,10,18,15,0.8333333333333334,Other or type unknown,3
70465434,2,"Gainesville, GA",7,18,15,0.8333333333333334,Knife or cutting instrument,3
88347050,2,"San Diego-Carlsbad-San Marcos, CA",4,18,15,0.8333333333333334,Fire,3
88877778,1,"Reading, PA",14,18,15,0.8333333333333334,Rifle,3
95618050,1,"Atlanta-Sandy Springs-Marietta, GA",8,18,15,0.8333333333333334,"Narcotics or drugs, sleeping pills",3
1326552,2,"Charleston, WV",11,17,14,0.8235294117647058,"Personal weapons, includes beating",3
1916997,2,"Panama City-Lynn Haven, FL",10,17,14,0.8235294117647058,Other or type unknown,3
22547996,2,"Cincinnati-Middletown, OH-KY-IN",4,17,14,0.8235294117647058,Fire,3
32484588,2,"Anderson, SC",7,17,14,0.8235294117647058,Knife or cutting instrument,3
37380799,1,"La Crosse, WI-MN",6,17,14,0.8235294117647058,"Handgun - pistol, revolver, etc",3
44685401,1,"Pittsburgh, PA",16,17,14,0.8235294117647058,Strangulation - hanging,3
52655261,2,Rural Maryland,10,17,14,0.8235294117647058,Other or type unknown,3
61528696,1,Rural Mississippi,4,17,14,0.8235294117647058,Fire,3
63927045,1,"Sumter, SC",1,17,14,0.8235294117647058,"Blunt object - hammer, club, etc",3
76053977,2,"Napa, CA",6,17,14,0.8235294117647058,"Handgun - pistol, revolver, etc",3
76749631,1,"Longview, TX",11,17,14,0.8235294117647058,"Personal weapons, includes beating",3
79699279,2,Rural Missouri,0,17,14,0.8235294117647058,Asphyxiation - includes death by gas,3
82249710,1,"Sherman-Denison, TX",15,17,14,0.8235294117647058,Shotgun,3
84756484,2,"Green Bay, WI",10,17,14,0.8235294117647058,Other or type unknown,3
94818592,2,Rural Louisiana,16,17,14,0.8235294117647058,Strangulation - hanging,3
96232424,1,"Johnson City, TN",15,17,14,0.8235294117647058,Shotgun,3
96943557,1,Rural Georgia,4,17,14,0.8235294117647058,Fire,3
17332847,1,"Hot Springs, AR",10,16,13,0.8125,Other or type unknown,3
29148233,1,"Jacksonville, FL",4,16,13,0.8125,Fire,3
47262041,2,"Palm Bay-Melbourne-Titusville, FL",1,16,13,0.8125,"Blunt object - hammer, club, etc",3
52259999,1,"Jackson, MI",14,16,13,0.8125,Rifle,3
55624546,1,"Asheville, NC",5,16,13,0.8125,"Firearm, type not stated",3
58838397,2,"Salem, OR",5,16,13,0.8125,"Firearm, type not stated",3
61372346,1,"Ogden-Clearfield, UT",1,16,13,0.8125,"Blunt object - hammer, club, etc",3
66754545,2,"Columbia, MO",7,16,13,0.8125,Knife or cutting instrument,3
73222897,1,"Manchester-Nashua, NH",10,16,13,0.8125,Other or type unknown,3
81619815,2,"Spartanburg, SC",10,16,13,0.8125,Other or type unknown,3
82161986,1,"Casper, WY",7,16,13,0.8125,Knife or cutting instrument,3
82479800,2,"South Bend-Mishawaka, IN-MI",11,16,13,0.8125,"Personal weapons, includes beating",3
96620118,2,"Indianapolis, IN",0,16,13,0.8125,Asphyxiation - includes death by gas,3
99511026,2,"Davenport-Moline-Rock Island, IA-IL",11,16,13,0.8125,"Personal weapons, includes beating",3
19847665,2,"Dallas-Fort Worth-Arlington, TX",2,15,12,0.8,Drowning,3
30502636,2,"Atlanta-Sandy Springs-Marietta, GA",8,15,12,0.8,"Narcotics or drugs, sleeping pills",3
37883093,2,"Lafayette, LA",1,15,12,0.8,"Blunt object - hammer, club, etc",3
41127956,2,"Vero Beach, FL",7,15,12,0.8,Knife or cutting instrument,3
42089082,2,"Santa Cruz-Watsonville, CA",1,15,12,0.8,"Blunt object - hammer, club, etc",3
42182832,2,"Modesto, CA",10,15,12,0.8,Other or type unknown,3
43687105,1,"Goldsboro, NC",11,15,12,0.8,"Personal weapons, includes beating",3
44535311,1,"Sumter, SC",14,15,12,0.8,Rifle,3
46666569,1,"Canton-Massillon, OH",10,15,12,0.8,Other or type unknown,3
47003315,2,"Albany, GA",11,15,12,0.8,"Personal weapons, includes beating",3
48903810,1,"Bloomington-Normal, IL",7,15,12,0.8,Knife or cutting instrument,3
51435831,2,Rural Michigan,4,15,12,0.8,Fire,3
69172524,1,"Las Cruces, NM",15,15,12,0.8,Shotgun,3
69714656,2,Rural South Carolina,0,15,12,0.8,Asphyxiation - includes death by gas,3
79547233,1,Rural Delaware,1,15,12,0.8,"Blunt object - hammer, club, etc",3
82310440,2,"York-Hanover, PA",11,15,12,0.8,"Personal weapons, includes beating",3
87138370,2,"Columbia, SC",4,15,12,0.8,Fire,3
87522626,2,"Kansas City, MO-KS",8,15,12,0.8,"Narcotics or drugs, sleeping pills",3
93057791,2,Rural Indiana,4,15,12,0.8,Fire,3
9594820,1,"Yuma, AZ",1,14,11,0.7857142857142857,"Blunt object - hammer, club, etc",3
9608697,1,"Gainesville, GA",1,14,11,0.7857142857142857,"Blunt object - hammer, club, etc",3
13711476,2,"Alexandria, LA",5,14,11,0.7857142857142857,"Firearm, type not stated",3
25077060,1,"Baton Rouge, LA",16,14,11,0.7857142857142857,Strangulation - hanging,3
26279009,1,Rural Ohio,0,14,11,0.7857142857142857,Asphyxiation - includes death by gas,3
28132911,2,"Provo-Orem, UT",10,14,11,0.7857142857142857,Other or type unknown,3
35833658,2,Rural Idaho,1,14,11,0.7857142857142857,"Blunt object - hammer, club, etc",3
39154346,2,"Gulfport-Biloxi, MS",11,14,11,0.7857142857142857,"Personal weapons, includes beating",3
40432074,2,"Binghamton, NY",10,14,11,0.7857142857142857,Other or type unknown,3
45401678,2,"Pueblo, CO",10,14,11,0.7857142857142857,Other or type unknown,3
54320511,2,"Williamsport, PA",6,14,11,0.7857142857142857,"Handgun - pistol, revolver, etc",3
59372685,1,"Colorado Springs, CO",9,14,11,0.7857142857142857,Other gun,3
61180821,1,"Reading, PA",15,14,11,0.7857142857142857,Shotgun,3
68261793,1,"Cleveland, TN",15,14,11,0.7857142857142857,Shotgun,3
70980399,1,"Goldsboro, NC",1,14,11,0.7857142857142857,"Blunt object - hammer, club, etc",3
71166172,1,"Danville, VA",11,14,11,0.7857142857142857,"Personal weapons, includes beating",3
73233392,2,"Lynchburg, VA",5,14,11,0.7857142857142857,"Firearm, type not stated",3
74928123,2,"Lexington-Fayette, KY",14,14,11,0.7857142857142857,Rifle,3
84535520,2,"Muskegon-Norton Shores, MI",10,14,11,0.7857142857142857,Other or type unknown,3
93663790,1,"Anniston-Oxford, AL",11,14,11,0.7857142857142857,"Personal weapons, includes beating",3
94369059,1,"Charleston-North Charleston, SC",4,14,11,0.7857142857142857,Fire,3
95577893,2,"Montgomery, AL",1,14,11,0.7857142857142857,"Blunt object - hammer, club, etc",3
1104902,2,"Youngstown-Warren-Boardman, OH-PA",14,13,10,0.7692307692307693,Rifle,3
1603102,1,"Little Rock-North Little Rock, AR",4,13,10,0.7692307692307693,Fire,3
3325107,2,"Chicago-Naperville-Joliet, IL-IN-WI",8,13,10,0.7692307692307693,"Narcotics or drugs, sleeping pills",3
4207876,2,"Allentown-Bethlehem-Easton, PA-NJ",5,13,10,0.7692307692307693,"Firearm, type not stated",3
6157944,2,"Boise City-Nampa, ID",1,13,10,0.7692307692307693,"Blunt object - hammer, club, etc",3
9884816,1,"Vineland-Millville-Bridgeton, NJ",5,13,10,0.7692307692307693,"Firearm, type not stated",3
11247548,2,"Houston-Sugar Land-Baytown, TX",8,13,10,0.7692307692307693,"Narcotics or drugs, sleeping pills",3
13225614,1,"Farmington, NM",1,13,10,0.7692307692307693,"Blunt object - hammer, club, etc",3
19190764,1,"Erie, PA",1,13,10,0.7692307692307693,"Blunt object - hammer, club, etc",3
22224053,2,"Louisville, KY-IN",0,13,10,0.7692307692307693,Asphyxiation - includes death by gas,3
23365152,1,"San Angelo, TX",15,13,10,0.7692307692307693,Shotgun,3
25179551,1,"Warner Robins, GA",5,13,10,0.7692307692307693,"Firearm, type not stated",3
30583770,2,"Manchester-Nashua, NH",10,13,10,0.7692307692307693,Other or type unknown,3
36884285,2,"Buffalo-Niagara Falls, NY",14,13,10,0.7692307692307693,Rifle,3
37890300,1,"Terre Haute, IN",15,13,10,0.7692307692307693,Shotgun,3
45092051,1,"Austin-Round Rock, TX",4,13,10,0.7692307692307693,Fire,3
47338813,2,"Macon, GA",16,13,10,0.7692307692307693,Strangulation - hanging,3
48601029,1,"Harrisburg-Carlisle, PA",0,13,10,0.7692307692307693,Asphyxiation - includes death by gas,3
56600296,2,"Anderson, IN",7,13,10,0.7692307692307693,Knife or cutting instrument,3
57356396,2,"Fort Collins-Loveland, CO",7,13,10,0.7692307692307693,Knife or cutting instrument,3
61365004,2,"Allentown-Bethlehem-Easton, PA-NJ",9,13,10,0.7692307692307693,Other gun,3
65188333,1,"Greenville, SC",4,13,10,0.7692307692307693,Fire,3
69923951,1,"Los Angeles-Long Beach, CA",12,13,10,0.7692307692307693,Poison - does not include gas,3
80154561,2,"Portland-Vancouver-Beaverton, OR-WA",4,13,10,0.7692307692307693,Fire,3
80361359,1,"Pascagoula, MS",10,13,10,0.7692307692307693,Other or type unknown,3
80690593,2,"Jackson, MS",5,13,10,0.7692307692307693,"Firearm, type not stated",3
82430539,1,"Prescott, AZ",15,13,10,0.7692307692307693,Shotgun,3
84777203,1,"Laredo, TX",15,13,10,0.7692307692307693,Shotgun,3
95301346,1,"Utica-Rome, NY",1,13,10,0.7692307692307693,"Blunt object - hammer, club, etc",3
1961820,1,"Atlantic City, NJ",15,12,9,0.75,Shotgun,3
6281344,1,"Portland-Vancouver-Beaverton, OR-WA",8,12,9,0.75,"Narcotics or drugs, sleeping pills",3
11283810,2,"Greeley, CO",10,12,9,0.75,Other or type unknown,3
19679996,1,"Danville, VA",1,12,9,0.75,"Blunt object - hammer, club, etc",3
20636078,1,"Naples-Marco Island, FL",11,12,9,0.75,"Personal weapons, includes beating",3
21513368,2,"Port St. Lucie-Fort Pierce, FL",1,12,9,0.75,"Blunt object - hammer, club, etc",3
29850484,1,"Boulder, CO",10,12,9,0.75,Other or type unknown,3
33023429,2,"Charlottesville, VA",10,12,9,0.75,Other or type unknown,3
36493453,1,"Sumter, SC",10,12,9,0.75,Other or type unknown,3
39399761,2,"Vineland-Millville-Bridgeton, NJ",15,12,9,0.75,Shotgun,3
41513825,2,"Madera, CA",1,12,9,0.75,"Blunt object - hammer, club, etc",3
49662641,1,"Springfield, OH",15,12,9,0.75,Shotgun,3
50612926,1,"Muskegon-Norton Shores, MI",1,12,9,0.75,"Blunt object - hammer, club, etc",3
54630896,1,"Memphis, TN-MS-AR",8,12,9,0.75,"Narcotics or drugs, sleeping pills",3
55831206,2,"Columbia, MO",10,12,9,0.75,Other or type unknown,3
64307763,1,"Flagstaff, AZ",10,12,9,0.75,Other or type unknown,3
82405148,1,"Bellingham, WA",10,12,9,0.75,Other or type unknown,3
88611490,2,"Huntington-Ashland, WV-KY-OH",5,12,9,0.75,"Firearm, type not stated",3
91412791,2,"Jacksonville, FL",16,12,9,0.75,Strangulation - hanging,3
95864096,1,"Pittsfield, MA",5,12,9,0.75,"Firearm, type not stated",3
400759,2,"Utica-Rome, NY",10,11,8,0.7272727272727273,Other or type unknown,3
5836254,2,"Michigan City-La Porte, IN",7,11,8,0.7272727272727273,Knife or cutting instrument,3
5985615,2,"Lafayette, LA",15,11,8,0.7272727272727273,Shotgun,3
7293108,2,"Grand Rapids-Wyoming, MI",0,11,8,0.7272727272727273,Asphyxiation - includes death by gas,3
10930819,1,"Fargo, ND-MN",10,11,8,0.7272727272727273,Other or type unknown,3
12950153,2,"Battle Creek, MI",1,11,8,0.7272727272727273,"Blunt object - hammer, club, etc",3
19266078,2,"Odessa, TX",5,11,8,0.7272727272727273,"Firearm, type not stated",3
19629603,1,"Columbia, MO",14,11,8,0.7272727272727273,Rifle,3
20904630,2,"Madera, CA",10,11,8,0.7272727272727273,Other or type unknown,3
21792376,1,"Winchester, VA-WV",5,11,8,0.7272727272727273,"Firearm, type not stated",3
23332380,1,"Indianapolis, IN",0,11,8,0.7272727272727273,Asphyxiation - includes death by gas,3
24146724,1,"El Paso, TX",16,11,8,0.7272727272727273,Strangulation - hanging,3
37406083,2,"Killeen-Temple-Fort Hood, TX",15,11,8,0.7272727272727273,Shotgun,3
38064116,2,"Houma-Bayou Cane-Thibodaux, LA",10,11,8,0.7272727272727273,Other or type unknown,3
46798238,1,"Michigan City-La Porte, IN",10,11,8,0.7272727272727273,Other or type unknown,3
48587087,2,"Corpus Christi, TX",16,11,8,0.7272727272727273,Strangulation - hanging,3
52598864,1,"Anderson, SC",10,11,8,0.7272727272727273,Other or type unknown,3
57170177,1,"Terre Haute, IN",1,11,8,0.7272727272727273,"Blunt object - hammer, club, etc",3
63654995,1,"Madison, WI",1,11,8,0.7272727272727273,"Blunt object - hammer, club, etc",3
66862037,2,"Laredo, TX",10,11,8,0.7272727272727273,Other or type unknown,3
73862497,2,"Terre Haute, IN",10,11,8,0.7272727272727273,Other or type unknown,3
75299726,1,"Johnstown, PA",1,11,8,0.7272727272727273,"Blunt object - hammer, club, etc",3
77421491,2,"Fort Collins-Loveland, CO",1,11,8,0.7272727272727273,"Blunt object - hammer, club, etc",3
92155616,2,"Athens-Clarke County, GA",10,11,8,0.7272727272727273,Other or type unknown,3
93063746,2,"Terre Haute, IN",15,11,8,0.7272727272727273,Shotgun,3
99108024,2,"Joplin, MO",10,11,8,0.7272727272727273,Other or type unknown,3
2553303,2,"Sherman-Denison, TX",10,10,7,0.7,Other or type unknown,3
14749321,2,"Hattiesburg, MS",10,10,7,0.7,Other or type unknown,3
14772325,2,"Seattle-Tacoma-Bellevue, WA",9,10,7,0.7,Other gun,3
14971402,2,"Lancaster, PA",8,10,7,0.7,"Narcotics or drugs, sleeping pills",3
29445904,2,"Anniston-Oxford, AL",11,10,7,0.7,"Personal weapons, includes beating",3
32006539,1,"Niles-Benton Harbor, MI",1,10,7,0.7,"Blunt object - hammer, club, etc",3
32460128,1,"Ogden-Clearfield, UT",15,10,7,0.7,Shotgun,3
33003173,2,"Flint, MI",0,10,7,0.7,Asphyxiation - includes death by gas,3
45335862,2,"Houma-Bayou Cane-Thibodaux, LA",4,10,7,0.7,Fire,3
48221434,2,"Seattle-Tacoma-Bellevue, WA",2,10,7,0.7,Drowning,3
49144516,2,"Elizabethtown, KY",1,10,7,0.7,"Blunt object - hammer, club, etc",3
55568504,2,"Bloomington-Normal, IL",7,10,7,0.7,Knife or cutting instrument,3
56891230,1,"Hot Springs, AR",1,10,7,0.7,"Blunt object - hammer, club, etc",3
57211581,1,"St. Joseph, MO-KS",10,10,7,0.7,Other or type unknown,3
61811299,2,"Springfield, MA",0,10,7,0.7,Asphyxiation - includes death by gas,3
66074273,1,Rural New Hampshire,1,10,7,0.7,"Blunt object - hammer, club, etc",3
71448221,1,"Austin-Round Rock, TX",0,10,7,0.7,Asphyxiation - includes death by gas,3
81171169,2,"Reading, PA",16,10,7,0.7,Strangulation - hanging,3
81215725,1,Rural New York,16,10,7,0.7,Strangulation - hanging,3
90908430,2,"Jackson, MI",11,10,7,0.7,"Personal weapons, includes beating",3
91243730,2,"Omaha-Council Bluffs, NE-IA",5,10,7,0.7,"Firearm, type not stated",3
94092662,1,"Chicago-Naperville-Joliet, IL-IN-WI",12,10,7,0.7,Poison - does not include gas,3
99263505,1,"Eau Claire, WI",10,10,7,0.7,Other or type unknown,3
99888716,1,"Dalton, GA",15,10,7,0.7,Shotgun,3
3665234,2,"Pascagoula, MS",10,9,6,0.6666666666666666,Other or type unknown,3
7358683,1,"Janesville, WI",5,9,6,0.6666666666666666,"Firearm, type not stated",3
9553167,2,"Chattanooga, TN-GA",16,9,6,0.6666666666666666,Strangulation - hanging,3
17828579,1,"Baton Rouge, LA",0,9,6,0.6666666666666666,Asphyxiation - includes death by gas,3
19085117,2,"Monroe, LA",10,9,6,0.6666666666666666,Other or type unknown,3
21367425,1,"San Angelo, TX",10,9,6,0.6666666666666666,Other or type unknown,3
26034136,2,Rural Wisconsin,16,9,6,0.6666666666666666,Strangulation - hanging,3
30640619,1,"Farmington, NM",5,9,6,0.6666666666666666,"Firearm, type not stated",3
33733076,2,"Brownsville-Harlingen, TX",5,9,6,0.6666666666666666,"Firearm, type not stated",3
37825937,1,"Clarksville, TN-KY",8,9,6,0.6666666666666666,"Narcotics or drugs, sleeping pills",3
38254739,1,"Norwich-New London, CT",1,9,6,0.6666666666666666,"Blunt object - hammer, club, etc",3
39801602,2,"Michigan City-La Porte, IN",10,9,6,0.6666666666666666,Other or type unknown,3
41539024,2,"Fresno, CA",0,9,6,0.6666666666666666,Asphyxiation - includes death by gas,3
47697519,2,"Elizabethtown, KY",5,9,6,0.6666666666666666,"Firearm, type not stated",3
51392424,1,"Visalia-Porterville, CA",2,9,6,0.6666666666666666,Drowning,3
52358325,1,"Salem, OR",9,9,6,0.6666666666666666,Other gun,3
56033483,2,"Pine Bluff, AR",10,9,6,0.6666666666666666,Other or type unknown,3
69218630,1,"Bremerton-Silverdale, WA",5,9,6,0.6666666666666666,"Firearm, type not stated",3
69924315,1,"Warner Robins, GA",10,9,6,0.6666666666666666,Other or type unknown,3
73835547,2,"Fairbanks, AK",7,9,6,0.6666666666666666,Knife or cutting instrument,3
77957636,2,"Austin-Round Rock, TX",4,9,6,0.6666666666666666,Fire,3
78192431,2,"Honolulu, HI",4,9,6,0.6666666666666666,Fire,3
82183476,2,"York-Hanover, PA",1,9,6,0.6666666666666666,"Blunt object - hammer, club, etc",3
85450137,1,"Longview, WA",1,9,6,0.6666666666666666,"Blunt object - hammer, club, etc",3
85722040,2,"Springfield, IL",5,9,6,0.6666666666666666,"Firearm, type not stated",3
87664877,2,"Shreveport-Bossier City, LA",16,9,6,0.6666666666666666,Strangulation - hanging,3
88297099,1,"Muncie, IN",5,9,6,0.6666666666666666,"Firearm, type not stated",3
98737995,1,"Vallejo-Fairfield, CA",0,9,6,0.6666666666666666,Asphyxiation - includes death by gas,3
98854271,2,"Yuba City, CA",1,9,6,0.6666666666666666,"Blunt object - hammer, club, etc",3
1567851,1,"Lima, OH",5,8,5,0.625,"Firearm, type not stated",3
4677685,2,"Chicago-Naperville-Joliet, IL-IN-WI",12,8,5,0.625,Poison - does not include gas,3
12886813,2,"Napa, CA",7,8,5,0.625,Knife or cutting instrument,3
19315037,2,"Gainesville, GA",10,8,5,0.625,Other or type unknown,3
20821167,1,"Jackson, MI",4,8,5,0.625,Fire,3
21180983,1,"Knoxville, TN",9,8,5,0.625,Other gun,3
22352402,1,"Lincoln, NE",5,8,5,0.625,"Firearm, type not stated",3
23487656,2,"Duluth, MN-WI",16,8,5,0.625,Strangulation - hanging,3
24465691,2,"Kalamazoo-Portage, MI",16,8,5,0.625,Strangulation - hanging,3
26245927,2,"Ann Arbor, MI",5,8,5,0.625,"Firearm, type not stated",3
39837400,2,"Santa Cruz-Watsonville, CA",16,8,5,0.625,Strangulation - hanging,3
41450463,2,"Davenport-Moline-Rock Island, IA-IL",16,8,5,0.625,Strangulation - hanging,3
41715074,2,"El Paso, TX",4,8,5,0.625,Fire,3
45194577,2,"Grand Junction, CO",10,8,5,0.625,Other or type unknown,3
47156491,2,"Kalamazoo-Portage, MI",1,8,5,0.625,"Blunt object - hammer, club, etc",3
48906491,2,"Dalton, GA",10,8,5,0.625,Other or type unknown,3
52145643,2,"Monroe, LA",16,8,5,0.625,Strangulation - hanging,3
54407800,1,"Rome, GA",10,8,5,0.625,Other or type unknown,3
54441575,9,"Memphis, TN-MS-AR",10,8,5,0.625,Other or type unknown,3
54687624,1,"Glens Falls, NY",6,8,5,0.625,"Handgun - pistol, revolver, etc",3
56801411,1,"Kankakee-Bradley, IL",10,8,5,0.625,Other or type unknown,3
58416380,1,"Stockton, CA",0,8,5,0.625,Asphyxiation - includes death by gas,3
60391143,2,"Hartford, CT",0,8,5,0.625,Asphyxiation - includes death by gas,3
61843338,2,"Mount Vernon-Anacortes, WA",7,8,5,0.625,Knife or cutting instrument,3
61911083,1,"McAllen-Edinburg-Mission, TX",0,8,5,0.625,Asphyxiation - includes death by gas,3
70684062,1,"Monroe, MI",1,8,5,0.625,"Blunt object - hammer, club, etc",3
78180398,2,"Jackson, TN",5,8,5,0.625,"Firearm, type not stated",3
81126615,2,"Lewiston-Auburn, ME",10,8,5,0.625,Other or type unknown,3
82784953,2,"Danville, IL",6,8,5,0.625,"Handgun - pistol, revolver, etc",3
84482874,2,"Battle Creek, MI",15,8,5,0.625,Shotgun,3
85323962,1,"Fort Walton Beach-Destin, FL",1,8,5,0.625,"Blunt object - hammer, club, etc",3
85901321,1,"Atlantic City, NJ",4,8,5,0.625,Fire,3
92229900,2,"Victoria, TX",10,8,5,0.625,Other or type unknown,3
94121423,2,"Tuscaloosa, AL",5,8,5,0.625,"Firearm, type not stated",3
98192974,1,"Fresno, CA",0,8,5,0.625,Asphyxiation - includes death by gas,3
98910081,2,"Kansas City, MO-KS",9,8,5,0.625,Other gun,3
99114046,2,Rural Nevada,1,8,5,0.625,"Blunt object - hammer, club, etc",3
2188599,1,"Reading, PA",0,7,4,0.5714285714285714,Asphyxiation - includes death by gas,3
6344194,2,"Muncie, IN",10,7,4,0.5714285714285714,Other or type unknown,3
8049213,2,"South Bend-Mishawaka, IN-MI",16,7,4,0.5714285714285714,Strangulation - hanging,3
9288153,1,"Bellingham, WA",5,7,4,0.5714285714285714,"Firearm, type not stated",3
10701653,2,"Decatur, AL",5,7,4,0.5714285714285714,"Firearm, type not stated",3
16001449,1,"Knoxville, TN",4,7,4,0.5714285714285714,Fire,3
17131080,9,"New Orleans-Metairie-Kenner, LA",10,7,4,0.5714285714285714,Other or type unknown,3
18992641,2,"Winston-Salem, NC",16,7,4,0.5714285714285714,Strangulation - hanging,3
21092903,1,"Lebanon, PA",10,7,4,0.5714285714285714,Other or type unknown,3
22264814,2,"Nashville-Davidson-Murfreesboro, TN",9,7,4,0.5714285714285714,Other gun,3
23342159,1,"Bloomington, IN",1,7,4,0.5714285714285714,"Blunt object - hammer, club, etc",3
26451858,1,Rural Kentucky,9,7,4,0.5714285714285714,Other gun,3
29857924,9,Rural Alabama,5,7,4,0.5714285714285714,"Firearm, type not stated",3
30032324,1,"Chicago-Naperville-Joliet, IL-IN-WI",3,7,4,0.5714285714285714,Explosives,3
31149126,1,"Hartford, CT",16,7,4,0.5714285714285714,Strangulation - hanging,3
38095335,2,"Memphis, TN-MS-AR",9,7,4,0.5714285714285714,Other gun,3
39757714,1,"Grand Rapids-Wyoming, MI",4,7,4,0.5714285714285714,Fire,3
40679167,2,"Hot Springs, AR",1,7,4,0.5714285714285714,"Blunt object - hammer, club, etc",3
42770490,2,Rural Illinois,4,7,4,0.5714285714285714,Fire,3
48688700,1,"Bremerton-Silverdale, WA",10,7,4,0.5714285714285714,Other or type unknown,3
57497649,1,"Jackson, MS",4,7,4,0.5714285714285714,Fire,3
59278853,1,"Cape Coral-Fort Myers, FL",9,7,4,0.5714285714285714,Other gun,3
61247736,9,"Houston-Sugar Land-Baytown, TX",6,7,4,0.5714285714285714,"Handgun - pistol, revolver, etc",3
63222714,2,"Ann Arbor, MI",1,7,4,0.5714285714285714,"Blunt object - hammer, club, etc",3
63879713,2,Rural Hawaii,16,7,4,0.5714285714285714,Strangulation - hanging,3
65501089,2,Rural Nebraska,16,7,4,0.5714285714285714,Strangulation - hanging,3
76973598,2,"Danville, IL",7,7,4,0.5714285714285714,Knife or cutting instrument,3
77872829,2,Rural Arizona,5,7,4,0.5714285714285714,"Firearm, type not stated",3
81257669,1,"Boston-Cambridge-Quincy, MA-NH",8,7,4,0.5714285714285714,"Narcotics or drugs, sleeping pills",3
83803623,2,"Jackson, MS",16,7,4,0.5714285714285714,Strangulation - hanging,3
83869202,1,"Monroe, LA",9,7,4,0.5714285714285714,Other gun,3
84035331,1,"Bridgeport-Stamford-Norwalk, CT",16,7,4,0.5714285714285714,Strangulation - hanging,3
86070336,1,"Myrtle Beach-Conway, SC",9,7,4,0.5714285714285714,Other gun,3
89782769,9,Rural Michigan,10,7,4,0.5714285714285714,Other or type unknown,3
91882365,2,"Tampa-St. Petersburg-Clearwater, FL",2,7,4,0.5714285714285714,Drowning,3
94766333,2,"South Bend-Mishawaka, IN-MI",14,7,4,0.5714285714285714,Rifle,3
4764348,2,"College Station-Bryan, TX",10,6,3,0.5,Other or type unknown,3
4902431,2,"Birmingham-Hoover, AL",16,6,3,0.5,Strangulation - hanging,3
9406782,1,"Battle Creek, MI",4,6,3,0.5,Fire,3
13225650,1,"Salinas, CA",9,6,3,0.5,Other gun,3
14586119,1,"Elkhart-Goshen, IN",1,6,3,0.5,"Blunt object - hammer, club, etc",3
17362794,1,"Killeen-Temple-Fort Hood, TX",9,6,3,0.5,Other gun,3
21214220,9,"Cincinnati-Middletown, OH-KY-IN",5,6,3,0.5,"Firearm, type not stated",3
21502880,2,"St. Cloud, MN",15,6,3,0.5,Shotgun,3
31418241,2,"Fort Wayne, IN",4,6,3,0.5,Fire,3
31447266,2,"Bremerton-Silverdale, WA",16,6,3,0.5,Strangulation - hanging,3
32781749,9,"Washington-Arlington-Alexandria, DC-VA-MD-WV",10,6,3,0.5,Other or type unknown,3
33846800,1,"Philadelphia-Camden-Wilmington, PA-NJ-DE",3,6,3,0.5,Explosives,3
36113951,1,"San Diego-Carlsbad-San Marcos, CA",12,6,3,0.5,Poison - does not include gas,3
43104833,1,Rural West Virginia,3,6,3,0.5,Explosives,3
43531809,1,"Elkhart-Goshen, IN",4,6,3,0.5,Fire,3
46723171,2,"Owensboro, KY",1,6,3,0.5,"Blunt object - hammer, club, etc",3
46964257,1,"Wenatchee, WA",1,6,3,0.5,"Blunt object - hammer, club, etc",3
47209150,2,"Lexington-Fayette, KY",8,6,3,0.5,"Narcotics or drugs, sleeping pills",3
48227335,2,"Chico, CA",16,6,3,0.5,Strangulation - hanging,3
48883595,2,"Wilmington, NC",5,6,3,0.5,"Firearm, type not stated",3
57186925,1,"Fresno, CA",9,6,3,0.5,Other gun,3
59847483,1,"Bangor, ME",4,6,3,0.5,Fire,3
60606222,2,"Wilmington, NC",16,6,3,0.5,Strangulation - hanging,3
61908298,2,"Canton-Massillon, OH",16,6,3,0.5,Strangulation - hanging,3
64768521,1,"Omaha-Council Bluffs, NE-IA",16,6,3,0.5,Strangulation - hanging,3
65711618,1,"Merced, CA",4,6,3,0.5,Fire,3
66161934,2,"Spartanburg, SC",5,6,3,0.5,"Firearm, type not stated",3
74194716,1,"Jackson, MS",0,6,3,0.5,Asphyxiation - includes death by gas,3
76220668,2,"Virginia Beach-Norfolk-Newport News, VA-NC",2,6,3,0.5,Drowning,3
79910678,1,"Weirton-Steubenville, WV-OH",10,6,3,0.5,Other or type unknown,3
80418925,2,"Flagstaff, AZ",7,6,3,0.5,Knife or cutting instrument,3
82109822,1,"Savannah, GA",16,6,3,0.5,Strangulation - hanging,3
83055052,2,"Bowling Green, KY",10,6,3,0.5,Other or type unknown,3
88238190,1,"Napa, CA",5,6,3,0.5,"Firearm, type not stated",3
91387095,1,"San Francisco-Oakland-Fremont, CA",12,6,3,0.5,Poison - does not include gas,3
91490988,1,"Columbus, IN",14,6,3,0.5,Rifle,3
93840739,1,"Peoria, IL",10,6,3,0.5,Other or type unknown,3
94058265,1,Rural South Carolina,0,6,3,0.5,Asphyxiation - includes death by gas,3
1195003,2,"Harrisburg-Carlisle, PA",12,5,2,0.4,Poison - does not include gas,3
4507113,2,"Fayetteville-Springdale-Rogers, AR-MO",16,5,2,0.4,Strangulation - hanging,3
6110650,9,Rural Arizona,10,5,2,0.4,Other or type unknown,3
11427220,1,"Jacksonville, FL",0,5,2,0.4,Asphyxiation - includes death by gas,3
11507168,2,"Bowling Green, KY",5,5,2,0.4,"Firearm, type not stated",3
11580803,1,"Kokomo, IN",15,5,2,0.4,Shotgun,3
19261731,2,"Kingsport-Bristol-Bristol, TN-VA",4,5,2,0.4,Fire,3
26378399,2,"Durham, NC",4,5,2,0.4,Fire,3
30256193,1,"Saginaw, MI",9,5,2,0.4,Other gun,3
31393268,2,"Eugene-Springfield, OR",5,5,2,0.4,"Firearm, type not stated",3
31411802,2,Rural New Hampshire,4,5,2,0.4,Fire,3
33685073,2,"Tulsa, OK",2,5,2,0.4,Drowning,3
39716199,1,"Nashville-Davidson-Murfreesboro, TN",16,5,2,0.4,Strangulation - hanging,3
40105313,1,Rural New Mexico,16,5,2,0.4,Strangulation - hanging,3
44638988,2,"Fairbanks, AK",10,5,2,0.4,Other or type unknown,3
47942403,2,"York-Hanover, PA",16,5,2,0.4,Strangulation - hanging,3
50336181,2,"Wilmington, NC",9,5,2,0.4,Other gun,3
53516597,1,"Atlantic City, NJ",16,5,2,0.4,Strangulation - hanging,3
55363238,2,Rural Georgia,2,5,2,0.4,Drowning,3
56304946,1,"Lima, OH",10,5,2,0.4,Other or type unknown,3
58720316,1,"Kansas City, MO-KS",2,5,2,0.4,Drowning,3
60016910,2,"Durham, NC",16,5,2,0.4,Strangulation - hanging,3
69820868,2,"Kankakee-Bradley, IL",10,5,2,0.4,Other or type unknown,3
70123485,9,Rural Arkansas,5,5,2,0.4,"Firearm, type not stated",3
80706805,2,"Ocean City, NJ",16,5,2,0.4,Strangulation - hanging,3
84025573,2,"Greensboro-High Point, NC",16,5,2,0.4,Strangulation - hanging,3
85645587,1,"Valdosta, GA",16,5,2,0.4,Strangulation - hanging,3
93918615,2,"Columbus, OH",9,5,2,0.4,Other gun,3
98742931,2,"Spartanburg, SC",4,5,2,0.4,Fire,3
99125029,1,"Beaumont-Port Arthur, TX",4,5,2,0.4,Fire,3
3227517,2,"Morgantown, WV",4,4,1,0.25,Fire,3
5868526,1,"Waterloo-Cedar Falls, IA",15,4,1,0.25,Shotgun,3
6569321,1,"Columbia, SC",16,4,1,0.25,Strangulation - hanging,3
8117738,2,"Norwich-New London, CT",16,4,1,0.25,Strangulation - hanging,3
11420428,1,"Ann Arbor, MI",4,4,1,0.25,Fire,3
16672480,1,"Mobile, AL",9,4,1,0.25,Other gun,3
20185827,2,Rural Arizona,4,4,1,0.25,Fire,3
20245249,9,Rural Louisiana,10,4,1,0.25,Other or type unknown,3
20713519,1,Rural Texas,9,4,1,0.25,Other gun,3
21263618,2,"Farmington, NM",16,4,1,0.25,Strangulation - hanging,3
23502859,9,"Albuquerque, NM",10,4,1,0.25,Other or type unknown,3
31451043,9,"Indianapolis, IN",10,4,1,0.25,Other or type unknown,3
33785340,1,"Morgantown, WV",8,4,1,0.25,"Narcotics or drugs, sleeping pills",3
47672079,9,"Peoria, IL",5,4,1,0.25,"Firearm, type not stated",3
50711674,2,"Waco, TX",4,4,1,0.25,Fire,3
57658272,1,"Kennewick-Richland-Pasco, WA",4,4,1,0.25,Fire,3
58018639,2,"Atlanta-Sandy Springs-Marietta, GA",3,4,1,0.25,Explosives,3
58769857,1,Rural Wyoming,4,4,1,0.25,Fire,3
60638243,1,"Lebanon, PA",5,4,1,0.25,"Firearm, type not stated",3
63555310,2,"Des Moines, IA",16,4,1,0.25,Strangulation - hanging,3
64778296,2,"Tucson, AZ",9,4,1,0.25,Other gun,3
66727393,1,"El Paso, TX",9,4,1,0.25,Other gun,3
70708563,2,"Terre Haute, IN",16,4,1,0.25,Strangulation - hanging,3
72234498,2,"St. Louis, MO-IL",3,4,1,0.25,Explosives,3
77386806,9,"Dallas-Fort Worth-Arlington, TX",6,4,1,0.25,"Handgun - pistol, revolver, etc",3
82059999,9,"Dayton, OH",10,4,1,0.25,Other or type unknown,3
84234812,2,"Victoria, TX",16,4,1,0.25,Strangulation - hanging,3
85094632,2,"Santa Fe, NM",16,4,1,0.25,Strangulation - hanging,3
90728224,2,"Erie, PA",4,4,1,0.25,Fire,3
95989698,1,"Deltona-Daytona Beach-Ormond Beach, FL",4,4,1,0.25,Fire,3
6645901,1,"Washington-Arlington-Alexandria, DC-VA-MD-WV",3,3,0,0.0,Explosives,3
6837481,9,"Los Angeles-Long Beach, CA",6,3,0,0.0,"Handgun - pistol, revolver, etc",3
10421859,2,Rural Indiana,17,3,0,0.0,Weapon Not Reported,3
10877925,9,"St. Louis, MO-IL",10,3,0,0.0,Other or type unknown,3
11305309,2,"Grand Rapids-Wyoming, MI",17,3,0,0.0,Weapon Not Reported,3
17733924,1,"Jonesboro, AR",17,3,0,0.0,Weapon Not Reported,3
18053465,2,"Durham, NC",17,3,0,0.0,Weapon Not Reported,3
18760155,1,"Durham, NC",17,3,0,0.0,Weapon Not Reported,3
20338161,2,"Columbia, SC",17,3,0,0.0,Weapon Not Reported,3
21604225,2,"Baltimore-Towson, MD",12,3,0,0.0,Poison - does not include gas,3
22406409,2,"Vero Beach, FL",1,3,0,0.0,"Blunt object - hammer, club, etc",3
22456303,1,"Shreveport-Bossier City, LA",17,3,0,0.0,Weapon Not Reported,3
22475318,2,"Cleveland-Elyria-Mentor, OH",17,3,0,0.0,Weapon Not Reported,3
23970234,2,"Knoxville, TN",17,3,0,0.0,Weapon Not Reported,3
24505912,9,Rural Alabama,8,3,0,0.0,"Narcotics or drugs, sleeping pills",3
24968113,9,Rural Kansas,10,3,0,0.0,Other or type unknown,3
26144229,2,"Elmira, NY",10,3,0,0.0,Other or type unknown,3
27016276,2,"Texarkana, TX-Texarkana, AR",17,3,0,0.0,Weapon Not Reported,3
28337278,2,"Lansing-East Lansing, MI",17,3,0,0.0,Weapon Not Reported,3
31418690,2,Rural Ohio,2,3,0,0.0,Drowning,3
33482457,2,"Charlotte-Gastonia-Concord, NC-SC",17,3,0,0.0,Weapon Not Reported,3
34611760,1,"Lima, OH",17,3,0,0.0,Weapon Not Reported,3
39482438,1,"Visalia-Porterville, CA",17,3,0,0.0,Weapon Not Reported,3
41575793,2,"Naples-Marco Island, FL",4,3,0,0.0,Fire,3
43759035,9,"Atlantic City, NJ",10,3,0,0.0,Other or type unknown,3
45240133,1,"Tulsa, OK",17,3,0,0.0,Weapon Not Reported,3
49016731,1,"Lake Charles, LA",17,3,0,0.0,Weapon Not Reported,3
50346911,9,"Philadelphia-Camden-Wilmington, PA-NJ-DE",6,3,0,0.0,"Handgun - pistol, revolver, etc",3
52097064,9,"Chicago-Naperville-Joliet, IL-IN-WI",4,3,0,0.0,Fire,3
52426794,1,"Anniston-Oxford, AL",16,3,0,0.0,Strangulation - hanging,3
53534301,2,"Kokomo, IN",17,3,0,0.0,Weapon Not Reported,3
60739680,2,"Raleigh-Cary, NC",17,3,0,0.0,Weapon Not Reported,3
62939874,1,"Joplin, MO",4,3,0,0.0,Fire,3
65179074,1,Rural Indiana,17,3,0,0.0,Weapon Not Reported,3
70156383,2,"Yakima, WA",17,3,0,0.0,Weapon Not Reported,3
70999773,1,"Bowling Green, KY",17,3,0,0.0,Weapon Not Reported,3
72142859,2,Rural Idaho,17,3,0,0.0,Weapon Not Reported,3
73230608,1,Rural Virginia,17,3,0,0.0,Weapon Not Reported,3
74938583,1,"Laredo, TX",16,3,0,0.0,Strangulation - hanging,3
75486513,1,"Louisville, KY-IN",17,3,0,0.0,Weapon Not Reported,3
76591229,1,"Kokomo, IN",17,3,0,0.0,Weapon Not Reported,3
78382073,2,"Fort Wayne, IN",3,3,0,0.0,Explosives,3
79845493,2,"Flint, MI",17,3,0,0.0,Weapon Not Reported,3
81390657,1,"Albuquerque, NM",17,3,0,0.0,Weapon Not Reported,3
82352426,9,"Baltimore-Towson, MD",6,3,0,0.0,"Handgun - pistol, revolver, etc",3
84599644,9,"Pine Bluff, AR",5,3,0,0.0,"Firearm, type not stated",3
85312294,2,"Ann Arbor, MI",4,3,0,0.0,Fire,3
85573827,9,"New York-New Jersey-Long Island, NY-NJ",1,3,0,0.0,"Blunt object - hammer, club, etc",3
86661954,2,Rural Louisiana,2,3,0,0.0,Drowning,3
87159618,1,"Birmingham-Hoover, AL",9,3,0,0.0,Other gun,3
94684094,1,Rural Arizona,17,3,0,0.0,Weapon Not Reported,3
95986989,1,"Chattanooga, TN-GA",16,3,0,0.0,Strangulation - hanging,3
96804097,1,"Pittsburgh, PA",3,3,0,0.0,Explosives,3
99838327,1,Rural Minnesota,7,104,102,0.9807692307692307,Knife or cutting instrument,2
9093083,1,Rural Virginia,11,93,91,0.978494623655914,"Personal weapons, includes beating",2
74851063,1,Rural Tennessee,11,84,82,0.9761904761904762,"Personal weapons, includes beating",2
59917854,2,"Anderson, SC",6,80,78,0.975,"Handgun - pistol, revolver, etc",2
69258837,1,Rural Louisiana,11,77,75,0.974025974025974,"Personal weapons, includes beating",2
4435224,2,"Boise City-Nampa, ID",6,76,74,0.9736842105263158,"Handgun - pistol, revolver, etc",2
9379262,2,Rural Georgia,15,72,70,0.9722222222222222,Shotgun,2
41851274,1,Rural Wisconsin,11,69,67,0.9710144927536232,"Personal weapons, includes beating",2
50425326,1,Rural Arkansas,11,68,66,0.9705882352941176,"Personal weapons, includes beating",2
63728571,2,Rural Michigan,14,66,64,0.9696969696969697,Rifle,2
93625400,2,Rural Idaho,6,66,64,0.9696969696969697,"Handgun - pistol, revolver, etc",2
51421806,1,Rural South Dakota,6,65,63,0.9692307692307692,"Handgun - pistol, revolver, etc",2
75497661,2,Rural Wisconsin,14,64,62,0.96875,Rifle,2
12916610,1,"Ann Arbor, MI",7,63,61,0.9682539682539683,Knife or cutting instrument,2
7054390,1,"Florence, SC",15,62,60,0.967741935483871,Shotgun,2
66859640,2,Rural New York,6,62,60,0.967741935483871,"Handgun - pistol, revolver, etc",2
33046845,2,"Memphis, TN-MS-AR",15,61,59,0.9672131147540983,Shotgun,2
78339308,1,Rural Kansas,15,60,58,0.9666666666666667,Shotgun,2
9659505,2,"Tallahassee, FL",6,58,56,0.9655172413793104,"Handgun - pistol, revolver, etc",2
83316310,1,"Anderson, SC",7,57,55,0.9649122807017544,Knife or cutting instrument,2
59279015,2,Rural Virginia,14,56,54,0.9642857142857143,Rifle,2
84637229,1,"Longview, TX",14,56,54,0.9642857142857143,Rifle,2
92939486,2,"Pittsburgh, PA",15,55,53,0.9636363636363636,Shotgun,2
50399724,1,"Davenport-Moline-Rock Island, IA-IL",7,54,52,0.9629629629629629,Knife or cutting instrument,2
57475731,1,"McAllen-Edinburg-Mission, TX",11,54,52,0.9629629629629629,"Personal weapons, includes beating",2
68220123,2,"Des Moines, IA",6,54,52,0.9629629629629629,"Handgun - pistol, revolver, etc",2
88548809,1,"Spartanburg, SC",15,54,52,0.9629629629629629,Shotgun,2
64880084,1,Rural Montana,14,53,51,0.9622641509433962,Rifle,2
71457008,1,"Utica-Rome, NY",7,53,51,0.9622641509433962,Knife or cutting instrument,2
94562881,2,Rural Wisconsin,11,53,51,0.9622641509433962,"Personal weapons, includes beating",2
33790830,2,"Sacramento-Roseville, CA",14,51,49,0.9607843137254902,Rifle,2
44486029,1,"Sarasota-Bradenton-Venice, FL",11,51,49,0.9607843137254902,"Personal weapons, includes beating",2
34519323,2,"Virginia Beach-Norfolk-Newport News, VA-NC",15,50,48,0.96,Shotgun,2
67834553,2,Rural Alaska,14,50,48,0.96,Rifle,2
77439230,2,"Prescott, AZ",6,50,48,0.96,"Handgun - pistol, revolver, etc",2
63061471,1,"Anderson, SC",15,49,47,0.9591836734693877,Shotgun,2
9728964,2,"Niles-Benton Harbor, MI",6,48,46,0.9583333333333334,"Handgun - pistol, revolver, etc",2
21280673,1,Rural Maine,14,48,46,0.9583333333333334,Rifle,2
76169971,1,"Harrisonburg, VA",6,48,46,0.9583333333333334,"Handgun - pistol, revolver, etc",2
94666885,1,"El Paso, TX",15,48,46,0.9583333333333334,Shotgun,2
41707507,2,Rural Iowa,11,47,45,0.9574468085106383,"Personal weapons, includes beating",2
49947319,2,"El Paso, TX",11,47,45,0.9574468085106383,"Personal weapons, includes beating",2
60718614,2,Rural Louisiana,14,47,45,0.9574468085106383,Rifle,2
38888904,2,"Columbia, SC",15,46,44,0.9565217391304348,Shotgun,2
2479852,2,"Portland-Vancouver-Beaverton, OR-WA",14,45,43,0.9555555555555556,Rifle,2
95225007,1,Rural Ohio,14,45,43,0.9555555555555556,Rifle,2
59478789,2,"Greenville, SC",11,44,42,0.9545454545454546,"Personal weapons, includes beating",2
24421149,2,"Odessa, TX",6,43,41,0.9534883720930233,"Handgun - pistol, revolver, etc",2
27114689,1,"Peoria, IL",7,43,41,0.9534883720930233,Knife or cutting instrument,2
45738987,1,"Tuscaloosa, AL",15,43,41,0.9534883720930233,Shotgun,2
51511286,2,Rural Mississippi,14,43,41,0.9534883720930233,Rifle,2
26760704,2,"Sumter, SC",6,42,40,0.9523809523809523,"Handgun - pistol, revolver, etc",2
30651076,1,"Des Moines, IA",11,42,40,0.9523809523809523,"Personal weapons, includes beating",2
12237541,2,"Knoxville, TN",11,41,39,0.9512195121951219,"Personal weapons, includes beating",2
36563191,1,"Topeka, KS",7,41,39,0.9512195121951219,Knife or cutting instrument,2
42404698,1,"Gulfport-Biloxi, MS",15,41,39,0.9512195121951219,Shotgun,2
83524747,1,"Palm Bay-Melbourne-Titusville, FL",11,41,39,0.9512195121951219,"Personal weapons, includes beating",2
9230632,1,"Panama City-Lynn Haven, FL",7,40,38,0.95,Knife or cutting instrument,2
10518477,1,"Fort Smith, AR-OK",15,40,38,0.95,Shotgun,2
80623549,2,"Seattle-Tacoma-Bellevue, WA",15,40,38,0.95,Shotgun,2
88362592,2,"Gainesville, FL",6,40,38,0.95,"Handgun - pistol, revolver, etc",2
88977425,1,"Evansville, IN-KY",11,40,38,0.95,"Personal weapons, includes beating",2
9560202,2,"Abilene, TX",6,39,37,0.9487179487179487,"Handgun - pistol, revolver, etc",2
10509790,2,Rural Washington,11,39,37,0.9487179487179487,"Personal weapons, includes beating",2
35467931,1,"Boise City-Nampa, ID",11,39,37,0.9487179487179487,"Personal weapons, includes beating",2
57009439,1,"Yuma, AZ",7,39,37,0.9487179487179487,Knife or cutting instrument,2
40842142,1,"Anniston-Oxford, AL",15,38,36,0.9473684210526315,Shotgun,2
50690260,1,"Greeley, CO",7,38,36,0.9473684210526315,Knife or cutting instrument,2
53285023,1,"Burlington, NC",7,38,36,0.9473684210526315,Knife or cutting instrument,2
64861178,1,"Houma-Bayou Cane-Thibodaux, LA",15,38,36,0.9473684210526315,Shotgun,2
68130219,1,"Sioux City, IA-NE-SD",6,38,36,0.9473684210526315,"Handgun - pistol, revolver, etc",2
20747518,1,"Rapid City, SD",7,37,35,0.9459459459459459,Knife or cutting instrument,2
38931081,1,"Ogden-Clearfield, UT",11,37,35,0.9459459459459459,"Personal weapons, includes beating",2
48186043,1,"Longview, WA",6,37,35,0.9459459459459459,"Handgun - pistol, revolver, etc",2
75318768,1,Rural Delaware,7,37,35,0.9459459459459459,Knife or cutting instrument,2
84313470,2,"Albany-Schenectady-Troy, NY",15,37,35,0.9459459459459459,Shotgun,2
6022982,2,"Lancaster, PA",6,36,34,0.9444444444444444,"Handgun - pistol, revolver, etc",2
10302001,2,"Baton Rouge, LA",15,36,34,0.9444444444444444,Shotgun,2
13489971,1,"Killeen-Temple-Fort Hood, TX",15,36,34,0.9444444444444444,Shotgun,2
41627325,1,"Des Moines, IA",10,36,34,0.9444444444444444,Other or type unknown,2
42167062,2,"Johnson City, TN",6,36,34,0.9444444444444444,"Handgun - pistol, revolver, etc",2
86319428,2,"Tulsa, OK",14,36,34,0.9444444444444444,Rifle,2
29314991,1,Rural Maine,11,35,33,0.9428571428571428,"Personal weapons, includes beating",2
55913372,1,"Dothan, AL",5,35,33,0.9428571428571428,"Firearm, type not stated",2
64225063,1,"Casper, WY",6,35,33,0.9428571428571428,"Handgun - pistol, revolver, etc",2
85233735,2,"Hickory-Lenoir-Morganton, NC",15,35,33,0.9428571428571428,Shotgun,2
11465003,1,Rural Maryland,15,34,32,0.9411764705882353,Shotgun,2
28862284,2,Rural Michigan,8,34,32,0.9411764705882353,"Narcotics or drugs, sleeping pills",2
72442010,2,Rural Indiana,11,34,32,0.9411764705882353,"Personal weapons, includes beating",2
83593026,1,"Battle Creek, MI",7,34,32,0.9411764705882353,Knife or cutting instrument,2
88426590,1,"Fort Wayne, IN",11,34,32,0.9411764705882353,"Personal weapons, includes beating",2
92337469,2,"McAllen-Edinburg-Mission, TX",11,34,32,0.9411764705882353,"Personal weapons, includes beating",2
16719172,2,"Winston-Salem, NC",15,33,31,0.9393939393939394,Shotgun,2
28991314,1,"Asheville, NC",11,33,31,0.9393939393939394,"Personal weapons, includes beating",2
57921149,2,"Hattiesburg, MS",6,33,31,0.9393939393939394,"Handgun - pistol, revolver, etc",2
61355460,1,"Akron, OH",15,33,31,0.9393939393939394,Shotgun,2
86144440,1,"Bridgeport-Stamford-Norwalk, CT",11,33,31,0.9393939393939394,"Personal weapons, includes beating",2
7111280,2,"Omaha-Council Bluffs, NE-IA",11,32,30,0.9375,"Personal weapons, includes beating",2
26799436,1,"Fayetteville-Springdale-Rogers, AR-MO",11,32,30,0.9375,"Personal weapons, includes beating",2
48537301,1,"Decatur, AL",15,32,30,0.9375,Shotgun,2
50001805,2,"Boston-Cambridge-Quincy, MA-NH",15,32,30,0.9375,Shotgun,2
54598823,1,Rural Nevada,14,32,30,0.9375,Rifle,2
85599737,1,"Lansing-East Lansing, MI",15,32,30,0.9375,Shotgun,2
94019193,2,"Peoria, IL",6,32,30,0.9375,"Handgun - pistol, revolver, etc",2
26480315,2,"Shreveport-Bossier City, LA",15,31,29,0.9354838709677419,Shotgun,2
27747630,2,Rural Hawaii,6,31,29,0.9354838709677419,"Handgun - pistol, revolver, etc",2
28309540,2,"Denver-Aurora, CO",14,31,29,0.9354838709677419,Rifle,2
31140752,2,"Allentown-Bethlehem-Easton, PA-NJ",11,31,29,0.9354838709677419,"Personal weapons, includes beating",2
36298520,2,"Dayton, OH",15,31,29,0.9354838709677419,Shotgun,2
37300284,1,"St. Louis, MO-IL",0,31,29,0.9354838709677419,Asphyxiation - includes death by gas,2
48748409,1,"Lynchburg, VA",15,31,29,0.9354838709677419,Shotgun,2
62757395,1,"Pueblo, CO",11,31,29,0.9354838709677419,"Personal weapons, includes beating",2
94311375,1,"Fayetteville-Springdale-Rogers, AR-MO",10,31,29,0.9354838709677419,Other or type unknown,2
18501428,1,"Dover, DE",7,30,28,0.9333333333333333,Knife or cutting instrument,2
54243684,1,"Lynchburg, VA",10,30,28,0.9333333333333333,Other or type unknown,2
72696182,1,"Chattanooga, TN-GA",11,30,28,0.9333333333333333,"Personal weapons, includes beating",2
3806352,2,"Boise City-Nampa, ID",7,29,27,0.9310344827586207,Knife or cutting instrument,2
35700083,2,"Evansville, IN-KY",11,29,27,0.9310344827586207,"Personal weapons, includes beating",2
39005402,1,"Jackson, TN",15,29,27,0.9310344827586207,Shotgun,2
53616539,2,"Jonesboro, AR",6,29,27,0.9310344827586207,"Handgun - pistol, revolver, etc",2
91468414,2,"Jackson, MS",15,29,27,0.9310344827586207,Shotgun,2
6044757,1,"Morristown, TN",7,28,26,0.9285714285714286,Knife or cutting instrument,2
23390745,2,"Port St. Lucie-Fort Pierce, FL",11,28,26,0.9285714285714286,"Personal weapons, includes beating",2
28428376,1,"Scranton--Wilkes-Barre, PA",14,28,26,0.9285714285714286,Rifle,2
39208768,1,"Wheeling, WV-OH",7,28,26,0.9285714285714286,Knife or cutting instrument,2
53043532,1,"Salem, OR",11,28,26,0.9285714285714286,"Personal weapons, includes beating",2
70452447,2,"Bowling Green, KY",6,28,26,0.9285714285714286,"Handgun - pistol, revolver, etc",2
86838215,1,"Tallahassee, FL",11,28,26,0.9285714285714286,"Personal weapons, includes beating",2
92593564,2,Rural Maryland,7,28,26,0.9285714285714286,Knife or cutting instrument,2
5054067,2,"Scranton--Wilkes-Barre, PA",14,27,25,0.9259259259259259,Rifle,2
12345420,2,"Beaumont-Port Arthur, TX",15,27,25,0.9259259259259259,Shotgun,2
12700706,2,"Hagerstown-Martinsburg, MD-WV",6,27,25,0.9259259259259259,"Handgun - pistol, revolver, etc",2
30841507,1,"Syracuse, NY",17,27,25,0.9259259259259259,Weapon Not Reported,2
38377541,2,"Milwaukee-Waukesha-West Allis, WI",14,27,25,0.9259259259259259,Rifle,2
59038029,1,"College Station-Bryan, TX",15,27,25,0.9259259259259259,Shotgun,2
66735766,1,"Kingsport-Bristol-Bristol, TN-VA",14,27,25,0.9259259259259259,Rifle,2
72670981,1,Rural North Dakota,7,27,25,0.9259259259259259,Knife or cutting instrument,2
79923017,1,"Colorado Springs, CO",15,27,25,0.9259259259259259,Shotgun,2
6461104,1,Rural North Dakota,10,26,24,0.9230769230769231,Other or type unknown,2
20272008,1,"Amarillo, TX",14,26,24,0.9230769230769231,Rifle,2
25228291,1,"Duluth, MN-WI",7,26,24,0.9230769230769231,Knife or cutting instrument,2
29413916,1,"Vineland-Millville-Bridgeton, NJ",11,26,24,0.9230769230769231,"Personal weapons, includes beating",2
51727731,2,Rural Missouri,8,26,24,0.9230769230769231,"Narcotics or drugs, sleeping pills",2
77478623,1,"Elizabethtown, KY",7,26,24,0.9230769230769231,Knife or cutting instrument,2
77686318,2,"Myrtle Beach-Conway, SC",7,26,24,0.9230769230769231,Knife or cutting instrument,2
79195115,1,"Fort Walton Beach-Destin, FL",7,26,24,0.9230769230769231,Knife or cutting instrument,2
95947851,1,"Asheville, NC",1,26,24,0.9230769230769231,"Blunt object - hammer, club, etc",2
23663955,2,"San Angelo, TX",6,25,23,0.92,"Handgun - pistol, revolver, etc",2
29873220,1,"Eugene-Springfield, OR",14,25,23,0.92,Rifle,2
30497187,2,"Chattanooga, TN-GA",11,25,23,0.92,"Personal weapons, includes beating",2
40571850,2,"Stockton, CA",14,25,23,0.92,Rifle,2
44926622,2,"Lubbock, TX",5,25,23,0.92,"Firearm, type not stated",2
52548092,1,"Springfield, OH",7,25,23,0.92,Knife or cutting instrument,2
54110644,1,"Myrtle Beach-Conway, SC",1,25,23,0.92,"Blunt object - hammer, club, etc",2
62872794,1,"Chico, CA",15,25,23,0.92,Shotgun,2
68624548,2,"Kingsport-Bristol-Bristol, TN-VA",5,25,23,0.92,"Firearm, type not stated",2
69545422,1,"Abilene, TX",11,25,23,0.92,"Personal weapons, includes beating",2
83238109,1,"Danville, VA",14,25,23,0.92,Rifle,2
84115835,1,"Kennewick-Richland-Pasco, WA",5,25,23,0.92,"Firearm, type not stated",2
84706416,1,"Portland-South Portland-Biddeford, ME",11,25,23,0.92,"Personal weapons, includes beating",2
93268723,2,"Las Vegas-Paradise, NV",15,25,23,0.92,Shotgun,2
97574015,1,"Yakima, WA",15,25,23,0.92,Shotgun,2
8413925,1,"Kingsport-Bristol-Bristol, TN-VA",10,24,22,0.9166666666666666,Other or type unknown,2
23031905,2,"Alexandria, LA",7,24,22,0.9166666666666666,Knife or cutting instrument,2
23041149,1,"Scranton--Wilkes-Barre, PA",4,24,22,0.9166666666666666,Fire,2
28511681,2,"Fort Wayne, IN",15,24,22,0.9166666666666666,Shotgun,2
31781633,2,"Johnstown, PA",6,24,22,0.9166666666666666,"Handgun - pistol, revolver, etc",2
33691495,2,"Tucson, AZ",14,24,22,0.9166666666666666,Rifle,2
46964682,1,Rural New York,4,24,22,0.9166666666666666,Fire,2
48300204,1,"South Bend-Mishawaka, IN-MI",11,24,22,0.9166666666666666,"Personal weapons, includes beating",2
51088480,2,"Gainesville, GA",6,24,22,0.9166666666666666,"Handgun - pistol, revolver, etc",2
53987293,1,"Cleveland, TN",7,24,22,0.9166666666666666,Knife or cutting instrument,2
57767091,2,"Erie, PA",7,24,22,0.9166666666666666,Knife or cutting instrument,2
60380658,2,"Fayetteville-Springdale-Rogers, AR-MO",7,24,22,0.9166666666666666,Knife or cutting instrument,2
64287690,2,Rural West Virginia,5,24,22,0.9166666666666666,"Firearm, type not stated",2
69890176,1,Rural South Carolina,4,24,22,0.9166666666666666,Fire,2
72599587,2,"Fort Walton Beach-Destin, FL",6,24,22,0.9166666666666666,"Handgun - pistol, revolver, etc",2
3277799,2,"Sumter, SC",7,23,21,0.9130434782608695,Knife or cutting instrument,2
5517713,2,Rural Minnesota,1,23,21,0.9130434782608695,"Blunt object - hammer, club, etc",2
5928510,2,Rural Arizona,14,23,21,0.9130434782608695,Rifle,2
9319650,1,"Kingston, NY",7,23,21,0.9130434782608695,Knife or cutting instrument,2
31154996,1,"Reno-Sparks, NV",14,23,21,0.9130434782608695,Rifle,2
47336056,2,"Davenport-Moline-Rock Island, IA-IL",7,23,21,0.9130434782608695,Knife or cutting instrument,2
54089788,2,Rural Nebraska,7,23,21,0.9130434782608695,Knife or cutting instrument,2
85441118,1,"Olympia, WA",7,23,21,0.9130434782608695,Knife or cutting instrument,2
86850101,1,"Florence, SC",1,23,21,0.9130434782608695,"Blunt object - hammer, club, etc",2
96551906,1,"Santa Barbara-Santa Maria, CA",11,23,21,0.9130434782608695,"Personal weapons, includes beating",2
1937460,2,"Victoria, TX",7,22,20,0.9090909090909091,Knife or cutting instrument,2
5295398,2,"Lima, OH",6,22,20,0.9090909090909091,"Handgun - pistol, revolver, etc",2
8724126,2,"Danville, VA",7,22,20,0.9090909090909091,Knife or cutting instrument,2
11450983,1,"Monroe, LA",1,22,20,0.9090909090909091,"Blunt object - hammer, club, etc",2
13446504,1,"Waterloo-Cedar Falls, IA",7,22,20,0.9090909090909091,Knife or cutting instrument,2
14164142,2,"Longview, TX",10,22,20,0.9090909090909091,Other or type unknown,2
18284832,1,"Jackson, MI",15,22,20,0.9090909090909091,Shotgun,2
19107960,1,"Lima, OH",7,22,20,0.9090909090909091,Knife or cutting instrument,2
40737316,1,"York-Hanover, PA",15,22,20,0.9090909090909091,Shotgun,2
40895935,2,"Morristown, TN",6,22,20,0.9090909090909091,"Handgun - pistol, revolver, etc",2
56541361,2,"Albuquerque, NM",14,22,20,0.9090909090909091,Rifle,2
75620056,2,"Vineland-Millville-Bridgeton, NJ",7,22,20,0.9090909090909091,Knife or cutting instrument,2
79122286,1,"Bend, OR",6,22,20,0.9090909090909091,"Handgun - pistol, revolver, etc",2
79800871,2,"Hickory-Lenoir-Morganton, NC",11,22,20,0.9090909090909091,"Personal weapons, includes beating",2
96247208,1,"Lewiston, ID-WA",6,22,20,0.9090909090909091,"Handgun - pistol, revolver, etc",2
4662438,2,"Atlantic City, NJ",1,21,19,0.9047619047619048,"Blunt object - hammer, club, etc",2
5016538,1,"Salem, OR",14,21,19,0.9047619047619048,Rifle,2
19775901,2,Rural Vermont,11,21,19,0.9047619047619048,"Personal weapons, includes beating",2
20497667,2,"Sherman-Denison, TX",6,21,19,0.9047619047619048,"Handgun - pistol, revolver, etc",2
27818874,2,"Minneapolis-St. Paul-Bloomington, MN-WI",0,21,19,0.9047619047619048,Asphyxiation - includes death by gas,2
32943220,2,"Ogden-Clearfield, UT",7,21,19,0.9047619047619048,Knife or cutting instrument,2
42284844,2,"Grand Rapids-Wyoming, MI",14,21,19,0.9047619047619048,Rifle,2
48227361,2,"Topeka, KS",11,21,19,0.9047619047619048,"Personal weapons, includes beating",2
56501229,1,"Springfield, MO",11,21,19,0.9047619047619048,"Personal weapons, includes beating",2
62640587,2,"Philadelphia-Camden-Wilmington, PA-NJ-DE",2,21,19,0.9047619047619048,Drowning,2
66612526,2,"Sioux City, IA-NE-SD",7,21,19,0.9047619047619048,Knife or cutting instrument,2
67237680,2,"Memphis, TN-MS-AR",4,21,19,0.9047619047619048,Fire,2
86059266,2,"Hickory-Lenoir-Morganton, NC",14,21,19,0.9047619047619048,Rifle,2
86149533,1,"Gulfport-Biloxi, MS",14,21,19,0.9047619047619048,Rifle,2
98363996,1,Rural Virginia,8,21,19,0.9047619047619048,"Narcotics or drugs, sleeping pills",2
99745040,2,"Naples-Marco Island, FL",7,21,19,0.9047619047619048,Knife or cutting instrument,2
4849169,1,"Killeen-Temple-Fort Hood, TX",14,20,18,0.9,Rifle,2
4932931,1,"Fort Smith, AR-OK",11,20,18,0.9,"Personal weapons, includes beating",2
9074234,2,"Huntsville, AL",5,20,18,0.9,"Firearm, type not stated",2
10691785,2,"Lexington-Fayette, KY",11,20,18,0.9,"Personal weapons, includes beating",2
14190046,2,"Providence-New Bedford-Fall River, RI-MA",15,20,18,0.9,Shotgun,2
14371272,2,Rural Nebraska,15,20,18,0.9,Shotgun,2
15360103,1,"Bismarck, ND",6,20,18,0.9,"Handgun - pistol, revolver, etc",2
16103963,2,"Worcester, MA",5,20,18,0.9,"Firearm, type not stated",2
19077984,1,"Lawton, OK",15,20,18,0.9,Shotgun,2
23075848,1,"Canton-Massillon, OH",11,20,18,0.9,"Personal weapons, includes beating",2
23937298,2,"Columbus, GA-AL",5,20,18,0.9,"Firearm, type not stated",2
24344263,2,"Nashville-Davidson-Murfreesboro, TN",8,20,18,0.9,"Narcotics or drugs, sleeping pills",2
28567890,2,"Muskegon-Norton Shores, MI",7,20,18,0.9,Knife or cutting instrument,2
29569127,2,"Rocky Mount, NC",11,20,18,0.9,"Personal weapons, includes beating",2
35092870,2,"Syracuse, NY",1,20,18,0.9,"Blunt object - hammer, club, etc",2
38557620,1,"Jackson, TN",11,20,18,0.9,"Personal weapons, includes beating",2
43273470,1,"Tallahassee, FL",14,20,18,0.9,Rifle,2
51532450,2,"Huntington-Ashland, WV-KY-OH",11,20,18,0.9,"Personal weapons, includes beating",2
58581034,1,"Spokane, WA",15,20,18,0.9,Shotgun,2
75067191,2,"Tucson, AZ",15,20,18,0.9,Shotgun,2
79503970,1,"Lynchburg, VA",11,20,18,0.9,"Personal weapons, includes beating",2
82056793,1,"Gadsden, AL",15,20,18,0.9,Shotgun,2
87531195,2,"Visalia-Porterville, CA",15,20,18,0.9,Shotgun,2
14727999,1,"Orlando-Kissimmee, FL",4,19,17,0.8947368421052632,Fire,2
26636065,1,"Chicago-Naperville-Joliet, IL-IN-WI",8,19,17,0.8947368421052632,"Narcotics or drugs, sleeping pills",2
40316562,2,"Dover, DE",6,19,17,0.8947368421052632,"Handgun - pistol, revolver, etc",2
46633333,1,"Gulfport-Biloxi, MS",11,19,17,0.8947368421052632,"Personal weapons, includes beating",2
60372493,2,"Pascagoula, MS",7,19,17,0.8947368421052632,Knife or cutting instrument,2
71643006,2,"Michigan City-La Porte, IN",6,19,17,0.8947368421052632,"Handgun - pistol, revolver, etc",2
88016427,1,"Tuscaloosa, AL",11,19,17,0.8947368421052632,"Personal weapons, includes beating",2
88876400,2,"Dallas-Fort Worth-Arlington, TX",8,19,17,0.8947368421052632,"Narcotics or drugs, sleeping pills",2
90388962,2,"Altoona, PA",6,19,17,0.8947368421052632,"Handgun - pistol, revolver, etc",2
95595204,2,"Idaho Falls, ID",6,19,17,0.8947368421052632,"Handgun - pistol, revolver, etc",2
96556602,2,"Vineland-Millville-Bridgeton, NJ",11,19,17,0.8947368421052632,"Personal weapons, includes beating",2
3829487,1,"Charlotte-Gastonia-Concord, NC-SC",8,18,16,0.8888888888888888,"Narcotics or drugs, sleeping pills",2
23354944,1,"Gainesville, GA",5,18,16,0.8888888888888888,"Firearm, type not stated",2
27751482,1,"San Francisco-Oakland-Fremont, CA",2,18,16,0.8888888888888888,Drowning,2
30090627,1,"Bowling Green, KY",15,18,16,0.8888888888888888,Shotgun,2
34675193,1,Rural Delaware,11,18,16,0.8888888888888888,"Personal weapons, includes beating",2
37681739,2,Rural Indiana,5,18,16,0.8888888888888888,"Firearm, type not stated",2
38336522,1,Rural Nebraska,1,18,16,0.8888888888888888,"Blunt object - hammer, club, etc",2
42880273,1,"Ogden-Clearfield, UT",10,18,16,0.8888888888888888,Other or type unknown,2
45831494,2,Rural Kentucky,4,18,16,0.8888888888888888,Fire,2
57673681,2,"Greenville, NC",7,18,16,0.8888888888888888,Knife or cutting instrument,2
65068552,2,Rural Arkansas,4,18,16,0.8888888888888888,Fire,2
69475025,1,"Kennewick-Richland-Pasco, WA",11,18,16,0.8888888888888888,"Personal weapons, includes beating",2
73091344,2,Rural Maryland,11,18,16,0.8888888888888888,"Personal weapons, includes beating",2
75402896,2,"Worcester, MA",11,18,16,0.8888888888888888,"Personal weapons, includes beating",2
75408140,2,"Florence, SC",11,18,16,0.8888888888888888,"Personal weapons, includes beating",2
79891239,1,"Dallas-Fort Worth-Arlington, TX",8,18,16,0.8888888888888888,"Narcotics or drugs, sleeping pills",2
99061121,2,"Phoenix-Mesa-Scottsdale, AZ",4,18,16,0.8888888888888888,Fire,2
99744816,1,"Cumberland, MD-WV",6,18,16,0.8888888888888888,"Handgun - pistol, revolver, etc",2
9723762,1,"Akron, OH",14,17,15,0.8823529411764706,Rifle,2
25743920,1,"Charlottesville, VA",10,17,15,0.8823529411764706,Other or type unknown,2
33452513,1,"Olympia, WA",5,17,15,0.8823529411764706,"Firearm, type not stated",2
35962399,1,Rural Michigan,0,17,15,0.8823529411764706,Asphyxiation - includes death by gas,2
39101311,1,"Evansville, IN-KY",15,17,15,0.8823529411764706,Shotgun,2
43229032,2,"Jacksonville, NC",10,17,15,0.8823529411764706,Other or type unknown,2
45018352,1,"Morgantown, WV",7,17,15,0.8823529411764706,Knife or cutting instrument,2
45066958,2,"Columbia, SC",0,17,15,0.8823529411764706,Asphyxiation - includes death by gas,2
45303635,1,"Panama City-Lynn Haven, FL",1,17,15,0.8823529411764706,"Blunt object - hammer, club, etc",2
46282647,1,"Monroe, LA",14,17,15,0.8823529411764706,Rifle,2
46991999,2,"Anderson, IN",6,17,15,0.8823529411764706,"Handgun - pistol, revolver, etc",2
49941018,2,"Champaign-Urbana, IL",7,17,15,0.8823529411764706,Knife or cutting instrument,2
51572051,1,"Bangor, ME",5,17,15,0.8823529411764706,"Firearm, type not stated",2
52590417,2,"Hartford, CT",4,17,15,0.8823529411764706,Fire,2
56024781,1,"Midland, TX",5,17,15,0.8823529411764706,"Firearm, type not stated",2
60006039,2,"Abilene, TX",7,17,15,0.8823529411764706,Knife or cutting instrument,2
69003433,1,Rural Wyoming,5,17,15,0.8823529411764706,"Firearm, type not stated",2
75027105,1,"Hickory-Lenoir-Morganton, NC",1,17,15,0.8823529411764706,"Blunt object - hammer, club, etc",2
76294642,2,"Ogden-Clearfield, UT",10,17,15,0.8823529411764706,Other or type unknown,2
78635318,1,"Jefferson City, MO",7,17,15,0.8823529411764706,Knife or cutting instrument,2
83925181,2,"Akron, OH",1,17,15,0.8823529411764706,"Blunt object - hammer, club, etc",2
90757086,1,"Burlington-South Burlington, VT",7,17,15,0.8823529411764706,Knife or cutting instrument,2
92391417,2,"Columbus, OH",0,17,15,0.8823529411764706,Asphyxiation - includes death by gas,2
92606494,1,"Las Vegas-Paradise, NV",8,17,15,0.8823529411764706,"Narcotics or drugs, sleeping pills",2
93866669,2,"Scranton--Wilkes-Barre, PA",4,17,15,0.8823529411764706,Fire,2
9556962,2,"Orlando-Kissimmee, FL",15,16,14,0.875,Shotgun,2
18047165,2,"Gulfport-Biloxi, MS",1,16,14,0.875,"Blunt object - hammer, club, etc",2
20034099,1,"Elkhart-Goshen, IN",15,16,14,0.875,Shotgun,2
21565577,2,Rural Minnesota,16,16,14,0.875,Strangulation - hanging,2
22804741,2,"Norwich-New London, CT",7,16,14,0.875,Knife or cutting instrument,2
25400492,1,"Fayetteville-Springdale-Rogers, AR-MO",1,16,14,0.875,"Blunt object - hammer, club, etc",2
31643216,1,"Duluth, MN-WI",1,16,14,0.875,"Blunt object - hammer, club, etc",2
57576403,2,"Cedar Rapids, IA",7,16,14,0.875,Knife or cutting instrument,2
58331258,2,"Tyler, TX",1,16,14,0.875,"Blunt object - hammer, club, etc",2
71516961,1,"Great Falls, MT",7,16,14,0.875,Knife or cutting instrument,2
72115260,1,"Houston-Sugar Land-Baytown, TX",8,16,14,0.875,"Narcotics or drugs, sleeping pills",2
73413791,2,"Rockford, IL",11,16,14,0.875,"Personal weapons, includes beating",2
82407031,2,"Macon, GA",1,16,14,0.875,"Blunt object - hammer, club, etc",2
97606408,1,"Niles-Benton Harbor, MI",14,16,14,0.875,Rifle,2
4404033,1,"Holland-Grand Haven, MI",7,15,13,0.8666666666666667,Knife or cutting instrument,2
6898471,1,"Houma-Bayou Cane-Thibodaux, LA",1,15,13,0.8666666666666667,"Blunt object - hammer, club, etc",2
7258658,1,"Sherman-Denison, TX",10,15,13,0.8666666666666667,Other or type unknown,2
38126529,2,"Sumter, SC",1,15,13,0.8666666666666667,"Blunt object - hammer, club, etc",2
39251055,1,"Las Cruces, NM",14,15,13,0.8666666666666667,Rifle,2
44010779,1,Rural Texas,2,15,13,0.8666666666666667,Drowning,2
46721493,1,"Johnson City, TN",5,15,13,0.8666666666666667,"Firearm, type not stated",2
55199910,2,"Orlando-Kissimmee, FL",4,15,13,0.8666666666666667,Fire,2
56265320,2,"Winchester, VA-WV",6,15,13,0.8666666666666667,"Handgun - pistol, revolver, etc",2
63520283,1,"Cumberland, MD-WV",7,15,13,0.8666666666666667,Knife or cutting instrument,2
63999417,1,Rural South Dakota,5,15,13,0.8666666666666667,"Firearm, type not stated",2
64644252,1,"Janesville, WI",7,15,13,0.8666666666666667,Knife or cutting instrument,2
78129309,1,Rural Minnesota,5,15,13,0.8666666666666667,"Firearm, type not stated",2
82088873,1,"Evansville, IN-KY",14,15,13,0.8666666666666667,Rifle,2
99005503,2,"Barnstable Town, MA",7,15,13,0.8666666666666667,Knife or cutting instrument,2
1089156,1,"Rapid City, SD",10,14,12,0.8571428571428571,Other or type unknown,2
4851992,2,"Redding, CA",11,14,12,0.8571428571428571,"Personal weapons, includes beating",2
6889452,2,"Worcester, MA",4,14,12,0.8571428571428571,Fire,2
7138923,1,"Denver-Aurora, CO",8,14,12,0.8571428571428571,"Narcotics or drugs, sleeping pills",2
8871227,2,Rural Mississippi,4,14,12,0.8571428571428571,Fire,2
13675741,1,"Kennewick-Richland-Pasco, WA",10,14,12,0.8571428571428571,Other or type unknown,2
14112149,2,"Fort Smith, AR-OK",16,14,12,0.8571428571428571,Strangulation - hanging,2
14128195,1,"Salem, OR",15,14,12,0.8571428571428571,Shotgun,2
21501584,1,"Portland-Vancouver-Beaverton, OR-WA",2,14,12,0.8571428571428571,Drowning,2
22112521,2,"Decatur, IL",6,14,12,0.8571428571428571,"Handgun - pistol, revolver, etc",2
27915106,1,"Valdosta, GA",15,14,12,0.8571428571428571,Shotgun,2
29191678,1,"St. George, UT",6,14,12,0.8571428571428571,"Handgun - pistol, revolver, etc",2
29554735,1,"Weirton-Steubenville, WV-OH",7,14,12,0.8571428571428571,Knife or cutting instrument,2
29725168,1,"Elizabethtown, KY",15,14,12,0.8571428571428571,Shotgun,2
33652559,2,Rural Nevada,14,14,12,0.8571428571428571,Rifle,2
34492171,1,"Fargo, ND-MN",1,14,12,0.8571428571428571,"Blunt object - hammer, club, etc",2
38973780,1,"Bowling Green, KY",8,14,12,0.8571428571428571,"Narcotics or drugs, sleeping pills",2
39102014,2,"Stockton, CA",15,14,12,0.8571428571428571,Shotgun,2
42606379,1,"Port St. Lucie-Fort Pierce, FL",15,14,12,0.8571428571428571,Shotgun,2
42850651,1,"Rockford, IL",11,14,12,0.8571428571428571,"Personal weapons, includes beating",2
43214607,2,"Myrtle Beach-Conway, SC",14,14,12,0.8571428571428571,Rifle,2
45326069,1,"Ann Arbor, MI",14,14,12,0.8571428571428571,Rifle,2
45644663,1,"St. Cloud, MN",10,14,12,0.8571428571428571,Other or type unknown,2
54041335,1,"Valdosta, GA",14,14,12,0.8571428571428571,Rifle,2
56415800,1,"Hagerstown-Martinsburg, MD-WV",15,14,12,0.8571428571428571,Shotgun,2
58188586,1,"Deltona-Daytona Beach-Ormond Beach, FL",14,14,12,0.8571428571428571,Rifle,2
60466571,2,"Albany-Schenectady-Troy, NY",4,14,12,0.8571428571428571,Fire,2
61191195,2,"Albany-Schenectady-Troy, NY",5,14,12,0.8571428571428571,"Firearm, type not stated",2
61294264,1,"Providence-New Bedford-Fall River, RI-MA",4,14,12,0.8571428571428571,Fire,2
82480888,2,"Peoria, IL",5,14,12,0.8571428571428571,"Firearm, type not stated",2
83195226,2,"Goldsboro, NC",7,14,12,0.8571428571428571,Knife or cutting instrument,2
95077992,1,"San Jose-Sunnyvale-Santa Clara, CA",0,14,12,0.8571428571428571,Asphyxiation - includes death by gas,2
95820680,2,"Peoria, IL",4,14,12,0.8571428571428571,Fire,2
98786184,1,"Punta Gorda, FL",7,14,12,0.8571428571428571,Knife or cutting instrument,2
943214,2,"Midland, TX",10,13,11,0.8461538461538461,Other or type unknown,2
1218540,1,"Ann Arbor, MI",1,13,11,0.8461538461538461,"Blunt object - hammer, club, etc",2
1337420,2,Rural Washington,0,13,11,0.8461538461538461,Asphyxiation - includes death by gas,2
2164415,2,"Baltimore-Towson, MD",8,13,11,0.8461538461538461,"Narcotics or drugs, sleeping pills",2
7685691,2,"Albany, GA",5,13,11,0.8461538461538461,"Firearm, type not stated",2
9924791,2,"Lake Charles, LA",11,13,11,0.8461538461538461,"Personal weapons, includes beating",2
14659486,1,"Flint, MI",8,13,11,0.8461538461538461,"Narcotics or drugs, sleeping pills",2
15866367,2,Rural Washington,16,13,11,0.8461538461538461,Strangulation - hanging,2
17039876,1,"Parkersburg-Marietta-Vienna, WV-OH",11,13,11,0.8461538461538461,"Personal weapons, includes beating",2
17957150,2,"Sherman-Denison, TX",7,13,11,0.8461538461538461,Knife or cutting instrument,2
18064773,1,"El Centro, CA",14,13,11,0.8461538461538461,Rifle,2
19558746,1,"Binghamton, NY",10,13,11,0.8461538461538461,Other or type unknown,2
33234454,2,"Winchester, VA-WV",10,13,11,0.8461538461538461,Other or type unknown,2
34008906,1,"Eugene-Springfield, OR",15,13,11,0.8461538461538461,Shotgun,2
39126553,1,"Columbia, MO",10,13,11,0.8461538461538461,Other or type unknown,2
49271764,1,"Reno-Sparks, NV",15,13,11,0.8461538461538461,Shotgun,2
54221388,2,"Laredo, TX",5,13,11,0.8461538461538461,"Firearm, type not stated",2
58892204,2,"Norwich-New London, CT",11,13,11,0.8461538461538461,"Personal weapons, includes beating",2
59135204,2,"Tyler, TX",11,13,11,0.8461538461538461,"Personal weapons, includes beating",2
61146992,2,"Boise City-Nampa, ID",5,13,11,0.8461538461538461,"Firearm, type not stated",2
64596136,1,"Springfield, OH",10,13,11,0.8461538461538461,Other or type unknown,2
64914505,1,"Victoria, TX",15,13,11,0.8461538461538461,Shotgun,2
68938238,2,"Scranton--Wilkes-Barre, PA",5,13,11,0.8461538461538461,"Firearm, type not stated",2
73433274,2,"Warner Robins, GA",11,13,11,0.8461538461538461,"Personal weapons, includes beating",2
75276475,2,"Rochester, MN",10,13,11,0.8461538461538461,Other or type unknown,2
77736371,2,"Monroe, MI",7,13,11,0.8461538461538461,Knife or cutting instrument,2
82757910,2,"Colorado Springs, CO",14,13,11,0.8461538461538461,Rifle,2
84743978,2,"Billings, MT",5,13,11,0.8461538461538461,"Firearm, type not stated",2
86116468,2,Rural New York,5,13,11,0.8461538461538461,"Firearm, type not stated",2
90202245,1,"Hagerstown-Martinsburg, MD-WV",10,13,11,0.8461538461538461,Other or type unknown,2
93452428,2,"Yakima, WA",15,13,11,0.8461538461538461,Shotgun,2
98106662,1,"Lansing-East Lansing, MI",4,13,11,0.8461538461538461,Fire,2
2278632,2,"Wichita, KS",14,12,10,0.8333333333333334,Rifle,2
11911507,2,"San Francisco-Oakland-Fremont, CA",8,12,10,0.8333333333333334,"Narcotics or drugs, sleeping pills",2
23252734,1,"Minneapolis-St. Paul-Bloomington, MN-WI",0,12,10,0.8333333333333334,Asphyxiation - includes death by gas,2
24779246,2,"Odessa, TX",10,12,10,0.8333333333333334,Other or type unknown,2
26346059,2,"Kankakee-Bradley, IL",7,12,10,0.8333333333333334,Knife or cutting instrument,2
30426396,1,Rural New York,0,12,10,0.8333333333333334,Asphyxiation - includes death by gas,2
32315429,2,"Omaha-Council Bluffs, NE-IA",0,12,10,0.8333333333333334,Asphyxiation - includes death by gas,2
32720939,1,"Oklahoma City, OK",9,12,10,0.8333333333333334,Other gun,2
35019022,1,"Duluth, MN-WI",5,12,10,0.8333333333333334,"Firearm, type not stated",2
37198158,1,"Trenton-Ewing, NJ",14,12,10,0.8333333333333334,Rifle,2
45296285,1,"Valdosta, GA",5,12,10,0.8333333333333334,"Firearm, type not stated",2
45728273,2,"San Diego-Carlsbad-San Marcos, CA",9,12,10,0.8333333333333334,Other gun,2
51366690,2,"Greenville, NC",15,12,10,0.8333333333333334,Shotgun,2
53773269,2,"Cincinnati-Middletown, OH-KY-IN",8,12,10,0.8333333333333334,"Narcotics or drugs, sleeping pills",2
55740875,1,"San Diego-Carlsbad-San Marcos, CA",8,12,10,0.8333333333333334,"Narcotics or drugs, sleeping pills",2
59326006,2,"Washington-Arlington-Alexandria, DC-VA-MD-WV",2,12,10,0.8333333333333334,Drowning,2
59561129,1,"Baltimore-Towson, MD",8,12,10,0.8333333333333334,"Narcotics or drugs, sleeping pills",2
65585185,2,"Reading, PA",11,12,10,0.8333333333333334,"Personal weapons, includes beating",2
66573500,2,"Salisbury, MD",11,12,10,0.8333333333333334,"Personal weapons, includes beating",2
69713040,2,"Albuquerque, NM",15,12,10,0.8333333333333334,Shotgun,2
72885710,2,"Billings, MT",10,12,10,0.8333333333333334,Other or type unknown,2
74731313,2,"Bremerton-Silverdale, WA",11,12,10,0.8333333333333334,"Personal weapons, includes beating",2
77103204,2,"Phoenix-Mesa-Scottsdale, AZ",2,12,10,0.8333333333333334,Drowning,2
78254190,2,"Madison, WI",5,12,10,0.8333333333333334,"Firearm, type not stated",2
80996803,2,"Cleveland-Elyria-Mentor, OH",8,12,10,0.8333333333333334,"Narcotics or drugs, sleeping pills",2
85374145,1,"Decatur, AL",11,12,10,0.8333333333333334,"Personal weapons, includes beating",2
86907492,1,"Salisbury, MD",14,12,10,0.8333333333333334,Rifle,2
88608100,2,"Duluth, MN-WI",10,12,10,0.8333333333333334,Other or type unknown,2
90677751,1,"Morristown, TN",5,12,10,0.8333333333333334,"Firearm, type not stated",2
91420517,2,"Houma-Bayou Cane-Thibodaux, LA",11,12,10,0.8333333333333334,"Personal weapons, includes beating",2
94276513,1,"Dover, DE",1,12,10,0.8333333333333334,"Blunt object - hammer, club, etc",2
95691938,2,"Longview, TX",15,12,10,0.8333333333333334,Shotgun,2
3603111,2,"Yuba City, CA",15,11,9,0.8181818181818182,Shotgun,2
6739643,2,"Hagerstown-Martinsburg, MD-WV",1,11,9,0.8181818181818182,"Blunt object - hammer, club, etc",2
8769804,1,"Jonesboro, AR",10,11,9,0.8181818181818182,Other or type unknown,2
9161805,2,"Sioux Falls, SD",10,11,9,0.8181818181818182,Other or type unknown,2
11028979,1,"Worcester, MA",14,11,9,0.8181818181818182,Rifle,2
11206129,2,"Huntington-Ashland, WV-KY-OH",15,11,9,0.8181818181818182,Shotgun,2
12155543,1,"Boulder, CO",1,11,9,0.8181818181818182,"Blunt object - hammer, club, etc",2
13628577,1,"Shreveport-Bossier City, LA",16,11,9,0.8181818181818182,Strangulation - hanging,2
16165589,2,"Canton-Massillon, OH",5,11,9,0.8181818181818182,"Firearm, type not stated",2
27966058,2,"Gainesville, FL",15,11,9,0.8181818181818182,Shotgun,2
28805882,2,"Anderson, SC",10,11,9,0.8181818181818182,Other or type unknown,2
32831799,2,"Bremerton-Silverdale, WA",1,11,9,0.8181818181818182,"Blunt object - hammer, club, etc",2
35409863,2,"Amarillo, TX",5,11,9,0.8181818181818182,"Firearm, type not stated",2
39184716,1,"Bowling Green, KY",1,11,9,0.8181818181818182,"Blunt object - hammer, club, etc",2
41528608,1,"Portland-South Portland-Biddeford, ME",10,11,9,0.8181818181818182,Other or type unknown,2
43651634,2,"Hagerstown-Martinsburg, MD-WV",5,11,9,0.8181818181818182,"Firearm, type not stated",2
48546761,1,"Midland, TX",10,11,9,0.8181818181818182,Other or type unknown,2
52359824,2,"Rapid City, SD",7,11,9,0.8181818181818182,Knife or cutting instrument,2
56543948,2,"Tyler, TX",15,11,9,0.8181818181818182,Shotgun,2
58638749,1,"Burlington, NC",1,11,9,0.8181818181818182,"Blunt object - hammer, club, etc",2
63095331,2,Rural Montana,1,11,9,0.8181818181818182,"Blunt object - hammer, club, etc",2
63988489,2,Rural Idaho,5,11,9,0.8181818181818182,"Firearm, type not stated",2
66610691,1,"Kingston, NY",15,11,9,0.8181818181818182,Shotgun,2
68166971,2,"Monroe, LA",5,11,9,0.8181818181818182,"Firearm, type not stated",2
68803996,2,Rural Illinois,5,11,9,0.8181818181818182,"Firearm, type not stated",2
72937661,1,"Canton-Massillon, OH",4,11,9,0.8181818181818182,Fire,2
76165004,1,"Manchester-Nashua, NH",1,11,9,0.8181818181818182,"Blunt object - hammer, club, etc",2
76373755,1,"Williamsport, PA",10,11,9,0.8181818181818182,Other or type unknown,2
81538314,2,"Abilene, TX",1,11,9,0.8181818181818182,"Blunt object - hammer, club, etc",2
83796655,2,"Monroe, LA",1,11,9,0.8181818181818182,"Blunt object - hammer, club, etc",2
85156058,1,Rural Utah,5,11,9,0.8181818181818182,"Firearm, type not stated",2
87955092,1,"Pittsburgh, PA",0,11,9,0.8181818181818182,Asphyxiation - includes death by gas,2
93529406,9,Rural Tennessee,10,11,9,0.8181818181818182,Other or type unknown,2
96227496,2,"Spartanburg, SC",1,11,9,0.8181818181818182,"Blunt object - hammer, club, etc",2
99630671,1,Rural Connecticut,6,11,9,0.8181818181818182,"Handgun - pistol, revolver, etc",2
4169993,1,"Lakeland, FL",4,10,8,0.8,Fire,2
4560154,1,"Columbia, MO",1,10,8,0.8,"Blunt object - hammer, club, etc",2
4632072,2,"Kennewick-Richland-Pasco, WA",10,10,8,0.8,Other or type unknown,2
9305052,2,"St. Joseph, MO-KS",10,10,8,0.8,Other or type unknown,2
12315811,2,"Atlantic City, NJ",15,10,8,0.8,Shotgun,2
17464211,1,"Albany-Schenectady-Troy, NY",16,10,8,0.8,Strangulation - hanging,2
19098461,1,"Washington-Arlington-Alexandria, DC-VA-MD-WV",2,10,8,0.8,Drowning,2
21234307,2,"Scranton--Wilkes-Barre, PA",0,10,8,0.8,Asphyxiation - includes death by gas,2
22038800,2,"Boulder, CO",11,10,8,0.8,"Personal weapons, includes beating",2
30939954,2,"Danville, VA",5,10,8,0.8,"Firearm, type not stated",2
34147106,2,"San Luis Obispo-Paso Robles, CA",14,10,8,0.8,Rifle,2
34827035,2,"Portland-South Portland-Biddeford, ME",10,10,8,0.8,Other or type unknown,2
35125774,1,Rural Indiana,4,10,8,0.8,Fire,2
36085054,2,"Denver-Aurora, CO",9,10,8,0.8,Other gun,2
40492302,1,"Topeka, KS",1,10,8,0.8,"Blunt object - hammer, club, etc",2
43714334,2,"Elizabethtown, KY",7,10,8,0.8,Knife or cutting instrument,2
46379076,2,Rural Louisiana,8,10,8,0.8,"Narcotics or drugs, sleeping pills",2
49899663,1,"Olympia, WA",10,10,8,0.8,Other or type unknown,2
52258705,1,"Lancaster, PA",1,10,8,0.8,"Blunt object - hammer, club, etc",2
56965001,1,"Charleston-North Charleston, SC",0,10,8,0.8,Asphyxiation - includes death by gas,2
59371722,2,"Charleston, WV",14,10,8,0.8,Rifle,2
63488795,2,"Battle Creek, MI",5,10,8,0.8,"Firearm, type not stated",2
64674665,1,"Parkersburg-Marietta-Vienna, WV-OH",5,10,8,0.8,"Firearm, type not stated",2
64818471,2,"Decatur, IL",5,10,8,0.8,"Firearm, type not stated",2
64888502,1,"Austin-Round Rock, TX",9,10,8,0.8,Other gun,2
65170272,2,"Anderson, SC",14,10,8,0.8,Rifle,2
65625669,2,"Springfield, OH",7,10,8,0.8,Knife or cutting instrument,2
66688698,2,Rural Arizona,16,10,8,0.8,Strangulation - hanging,2
67059608,2,"Racine, WI",11,10,8,0.8,"Personal weapons, includes beating",2
69654599,1,"Kennewick-Richland-Pasco, WA",15,10,8,0.8,Shotgun,2
70238633,2,"Yuba City, CA",11,10,8,0.8,"Personal weapons, includes beating",2
70848322,2,"Santa Cruz-Watsonville, CA",11,10,8,0.8,"Personal weapons, includes beating",2
70944792,1,"San Angelo, TX",1,10,8,0.8,"Blunt object - hammer, club, etc",2
73571941,1,"Gainesville, GA",15,10,8,0.8,Shotgun,2
80142328,2,"Portland-Vancouver-Beaverton, OR-WA",2,10,8,0.8,Drowning,2
81947701,2,Rural Delaware,11,10,8,0.8,"Personal weapons, includes beating",2
84308721,1,"Cedar Rapids, IA",11,10,8,0.8,"Personal weapons, includes beating",2
85368442,2,"Chattanooga, TN-GA",0,10,8,0.8,Asphyxiation - includes death by gas,2
86610233,2,"Victoria, TX",11,10,8,0.8,"Personal weapons, includes beating",2
92303330,2,"Fayetteville-Springdale-Rogers, AR-MO",1,10,8,0.8,"Blunt object - hammer, club, etc",2
92762422,2,"Pine Bluff, AR",1,10,8,0.8,"Blunt object - hammer, club, etc",2
96904411,2,Rural California,0,10,8,0.8,Asphyxiation - includes death by gas,2
763246,2,"Albany-Schenectady-Troy, NY",0,9,7,0.7777777777777778,Asphyxiation - includes death by gas,2
1814863,2,"Kingsport-Bristol-Bristol, TN-VA",1,9,7,0.7777777777777778,"Blunt object - hammer, club, etc",2
3385319,1,"Lebanon, PA",15,9,7,0.7777777777777778,Shotgun,2
8821245,2,Rural New York,4,9,7,0.7777777777777778,Fire,2
9949239,2,"Augusta-Richmond County, GA-SC",0,9,7,0.7777777777777778,Asphyxiation - includes death by gas,2
16584802,2,"Flagstaff, AZ",10,9,7,0.7777777777777778,Other or type unknown,2
23504342,2,"Mansfield, OH",7,9,7,0.7777777777777778,Knife or cutting instrument,2
24340166,1,"Memphis, TN-MS-AR",16,9,7,0.7777777777777778,Strangulation - hanging,2
25432599,2,"Los Angeles-Long Beach, CA",9,9,7,0.7777777777777778,Other gun,2
27298931,2,"Yakima, WA",14,9,7,0.7777777777777778,Rifle,2
29815738,1,Rural Louisiana,2,9,7,0.7777777777777778,Drowning,2
31516766,2,"Kingston, NY",10,9,7,0.7777777777777778,Other or type unknown,2
32800197,1,Rural Oklahoma,9,9,7,0.7777777777777778,Other gun,2
33241338,2,"Roanoke, VA",4,9,7,0.7777777777777778,Fire,2
33629862,2,"Jonesboro, AR",7,9,7,0.7777777777777778,Knife or cutting instrument,2
34083901,2,"Weirton-Steubenville, WV-OH",7,9,7,0.7777777777777778,Knife or cutting instrument,2
35895386,2,"Sumter, SC",11,9,7,0.7777777777777778,"Personal weapons, includes beating",2
36694242,2,"Lakeland, FL",4,9,7,0.7777777777777778,Fire,2
42473143,2,Rural Nebraska,5,9,7,0.7777777777777778,"Firearm, type not stated",2
43298737,1,"Augusta-Richmond County, GA-SC",4,9,7,0.7777777777777778,Fire,2
48723365,2,"Yuma, AZ",7,9,7,0.7777777777777778,Knife or cutting instrument,2
49062306,1,"Louisville, KY-IN",16,9,7,0.7777777777777778,Strangulation - hanging,2
50839687,2,"Jackson, TN",11,9,7,0.7777777777777778,"Personal weapons, includes beating",2
50997523,2,"Auburn-Opelika, AL",7,9,7,0.7777777777777778,Knife or cutting instrument,2
53293777,2,"Alexandria, LA",1,9,7,0.7777777777777778,"Blunt object - hammer, club, etc",2
53682155,1,"Bremerton-Silverdale, WA",15,9,7,0.7777777777777778,Shotgun,2
56761919,2,"Vallejo-Fairfield, CA",16,9,7,0.7777777777777778,Strangulation - hanging,2
57017563,2,"Birmingham-Hoover, AL",4,9,7,0.7777777777777778,Fire,2
59636319,2,"McAllen-Edinburg-Mission, TX",16,9,7,0.7777777777777778,Strangulation - hanging,2
60607513,1,"Morristown, TN",14,9,7,0.7777777777777778,Rifle,2
62216116,2,"Spokane, WA",15,9,7,0.7777777777777778,Shotgun,2
62540199,2,"Modesto, CA",0,9,7,0.7777777777777778,Asphyxiation - includes death by gas,2
63431843,1,Rural Alaska,4,9,7,0.7777777777777778,Fire,2
64578333,1,"Pascagoula, MS",1,9,7,0.7777777777777778,"Blunt object - hammer, club, etc",2
64747872,2,"Raleigh-Cary, NC",16,9,7,0.7777777777777778,Strangulation - hanging,2
65179639,1,"Riverside-San Bernardino, CA",9,9,7,0.7777777777777778,Other gun,2
65640631,2,"Farmington, NM",11,9,7,0.7777777777777778,"Personal weapons, includes beating",2
67194315,2,"Pueblo, CO",5,9,7,0.7777777777777778,"Firearm, type not stated",2
72002446,1,"Baltimore-Towson, MD",2,9,7,0.7777777777777778,Drowning,2
72230455,2,"Missoula, MT",7,9,7,0.7777777777777778,Knife or cutting instrument,2
76030378,2,"Harrisburg-Carlisle, PA",14,9,7,0.7777777777777778,Rifle,2
79242459,2,"Springfield, MA",16,9,7,0.7777777777777778,Strangulation - hanging,2
81292269,9,Rural Arkansas,6,9,7,0.7777777777777778,"Handgun - pistol, revolver, etc",2
83669078,2,"San Luis Obispo-Paso Robles, CA",1,9,7,0.7777777777777778,"Blunt object - hammer, club, etc",2
88860877,2,"Pittsfield, MA",7,9,7,0.7777777777777778,Knife or cutting instrument,2
89609291,1,"Portland-South Portland-Biddeford, ME",1,9,7,0.7777777777777778,"Blunt object - hammer, club, etc",2
92147137,1,"Mansfield, OH",11,9,7,0.7777777777777778,"Personal weapons, includes beating",2
92741799,1,"San Luis Obispo-Paso Robles, CA",10,9,7,0.7777777777777778,Other or type unknown,2
93972131,2,"Wilmington, NC",1,9,7,0.7777777777777778,"Blunt object - hammer, club, etc",2
97787760,2,"Charlottesville, VA",5,9,7,0.7777777777777778,"Firearm, type not stated",2
98064216,1,"Logan, UT-ID",6,9,7,0.7777777777777778,"Handgun - pistol, revolver, etc",2
2644373,2,"Rockford, IL",1,8,6,0.75,"Blunt object - hammer, club, etc",2
9715371,1,Rural Pennsylvania,12,8,6,0.75,Poison - does not include gas,2
11303886,1,Rural Florida,4,8,6,0.75,Fire,2
12892355,2,"Bangor, ME",5,8,6,0.75,"Firearm, type not stated",2
14618747,2,"Lafayette, LA",16,8,6,0.75,Strangulation - hanging,2
15757865,1,"Fairbanks, AK",1,8,6,0.75,"Blunt object - hammer, club, etc",2
20507669,1,"Fort Collins-Loveland, CO",4,8,6,0.75,Fire,2
24071715,1,"Corpus Christi, TX",16,8,6,0.75,Strangulation - hanging,2
27337476,2,"Terre Haute, IN",11,8,6,0.75,"Personal weapons, includes beating",2
32798773,2,Rural Alabama,2,8,6,0.75,Drowning,2
35702063,2,"Pittsburgh, PA",9,8,6,0.75,Other gun,2
36294849,2,"Honolulu, HI",0,8,6,0.75,Asphyxiation - includes death by gas,2
37105748,2,Rural New Hampshire,1,8,6,0.75,"Blunt object - hammer, club, etc",2
38776802,2,"Fort Smith, AR-OK",5,8,6,0.75,"Firearm, type not stated",2
42450279,2,"Bay City, MI",10,8,6,0.75,Other or type unknown,2
45009701,2,Rural South Carolina,8,8,6,0.75,"Narcotics or drugs, sleeping pills",2
48863046,2,"Williamsport, PA",10,8,6,0.75,Other or type unknown,2
49745082,2,"Philadelphia-Camden-Wilmington, PA-NJ-DE",9,8,6,0.75,Other gun,2
51542997,2,"Baton Rouge, LA",0,8,6,0.75,Asphyxiation - includes death by gas,2
54029502,2,"Hagerstown-Martinsburg, MD-WV",4,8,6,0.75,Fire,2
55612714,2,"Norwich-New London, CT",10,8,6,0.75,Other or type unknown,2
59729149,1,"Lewiston-Auburn, ME",1,8,6,0.75,"Blunt object - hammer, club, etc",2
64762678,2,"Colorado Springs, CO",15,8,6,0.75,Shotgun,2
66389528,2,"Bridgeport-Stamford-Norwalk, CT",14,8,6,0.75,Rifle,2
72223254,1,"St. Cloud, MN",15,8,6,0.75,Shotgun,2
72950852,1,"Mount Vernon-Anacortes, WA",5,8,6,0.75,"Firearm, type not stated",2
73632352,1,"Tulsa, OK",9,8,6,0.75,Other gun,2
75318781,2,"Richmond, VA",8,8,6,0.75,"Narcotics or drugs, sleeping pills",2
82718124,1,Rural California,16,8,6,0.75,Strangulation - hanging,2
92379553,1,"Las Vegas-Paradise, NV",2,8,6,0.75,Drowning,2
96201625,1,"Decatur, IL",10,8,6,0.75,Other or type unknown,2
96211100,2,Rural Vermont,16,8,6,0.75,Strangulation - hanging,2
99459500,2,"Asheville, NC",1,8,6,0.75,"Blunt object - hammer, club, etc",2
811245,2,"Chattanooga, TN-GA",14,7,5,0.7142857142857143,Rifle,2
1158536,2,"Hickory-Lenoir-Morganton, NC",9,7,5,0.7142857142857143,Other gun,2
1184459,2,"Williamsport, PA",7,7,5,0.7142857142857143,Knife or cutting instrument,2
1967372,2,"Vallejo-Fairfield, CA",0,7,5,0.7142857142857143,Asphyxiation - includes death by gas,2
2174325,2,"Madera, CA",16,7,5,0.7142857142857143,Strangulation - hanging,2
4021031,1,"Elmira, NY",1,7,5,0.7142857142857143,"Blunt object - hammer, club, etc",2
4395981,2,"Lansing-East Lansing, MI",4,7,5,0.7142857142857143,Fire,2
4497741,2,"Orlando-Kissimmee, FL",16,7,5,0.7142857142857143,Strangulation - hanging,2
5609770,2,"Kokomo, IN",10,7,5,0.7142857142857143,Other or type unknown,2
6259039,1,"Burlington-South Burlington, VT",1,7,5,0.7142857142857143,"Blunt object - hammer, club, etc",2
7388477,1,"Ocean City, NJ",10,7,5,0.7142857142857143,Other or type unknown,2
9055019,1,"Bloomington-Normal, IL",10,7,5,0.7142857142857143,Other or type unknown,2
15599498,1,"Bloomington, IN",10,7,5,0.7142857142857143,Other or type unknown,2
16231717,2,"Harrisonburg, VA",7,7,5,0.7142857142857143,Knife or cutting instrument,2
19459270,2,"Anderson, IN",1,7,5,0.7142857142857143,"Blunt object - hammer, club, etc",2
22914841,1,"Lafayette, IN",5,7,5,0.7142857142857143,"Firearm, type not stated",2
24940690,9,"San Antonio, TX",6,7,5,0.7142857142857143,"Handgun - pistol, revolver, etc",2
26814385,2,"Buffalo-Niagara Falls, NY",0,7,5,0.7142857142857143,Asphyxiation - includes death by gas,2
27805362,1,"Mansfield, OH",10,7,5,0.7142857142857143,Other or type unknown,2
28647879,1,Rural Vermont,4,7,5,0.7142857142857143,Fire,2
34379453,2,"Boston-Cambridge-Quincy, MA-NH",8,7,5,0.7142857142857143,"Narcotics or drugs, sleeping pills",2
37175385,2,"Port St. Lucie-Fort Pierce, FL",14,7,5,0.7142857142857143,Rifle,2
39847048,1,"Wheeling, WV-OH",1,7,5,0.7142857142857143,"Blunt object - hammer, club, etc",2
40081884,1,"Lancaster, PA",4,7,5,0.7142857142857143,Fire,2
41499652,2,"Brunswick, GA",1,7,5,0.7142857142857143,"Blunt object - hammer, club, etc",2
43857963,1,"Baton Rouge, LA",4,7,5,0.7142857142857143,Fire,2
45300157,1,"Elmira, NY",17,7,5,0.7142857142857143,Weapon Not Reported,2
45326491,1,"Poughkeepsie-Newburgh-Middletown, NY",16,7,5,0.7142857142857143,Strangulation - hanging,2
47412955,1,"Kokomo, IN",10,7,5,0.7142857142857143,Other or type unknown,2
50274306,1,"Dallas-Fort Worth-Arlington, TX",12,7,5,0.7142857142857143,Poison - does not include gas,2
51094140,1,"Bridgeport-Stamford-Norwalk, CT",9,7,5,0.7142857142857143,Other gun,2
52381644,2,"Sherman-Denison, TX",5,7,5,0.7142857142857143,"Firearm, type not stated",2
54360355,2,"Salisbury, MD",1,7,5,0.7142857142857143,"Blunt object - hammer, club, etc",2
57609177,1,"Albuquerque, NM",8,7,5,0.7142857142857143,"Narcotics or drugs, sleeping pills",2
59661547,2,"Santa Cruz-Watsonville, CA",10,7,5,0.7142857142857143,Other or type unknown,2
60300258,2,"Columbia, MO",5,7,5,0.7142857142857143,"Firearm, type not stated",2
60998640,2,"Greenville, SC",16,7,5,0.7142857142857143,Strangulation - hanging,2
67261173,2,"Yakima, WA",10,7,5,0.7142857142857143,Other or type unknown,2
68041849,2,"Olympia, WA",7,7,5,0.7142857142857143,Knife or cutting instrument,2
69212729,1,"Omaha-Council Bluffs, NE-IA",9,7,5,0.7142857142857143,Other gun,2
70735519,2,"Salem, OR",14,7,5,0.7142857142857143,Rifle,2
73121900,2,"Greensboro-High Point, NC",4,7,5,0.7142857142857143,Fire,2
75472092,1,"Baton Rouge, LA",8,7,5,0.7142857142857143,"Narcotics or drugs, sleeping pills",2
76512543,2,"Stockton, CA",4,7,5,0.7142857142857143,Fire,2
79949044,2,"Parkersburg-Marietta-Vienna, WV-OH",7,7,5,0.7142857142857143,Knife or cutting instrument,2
80635330,1,"Memphis, TN-MS-AR",0,7,5,0.7142857142857143,Asphyxiation - includes death by gas,2
81189548,2,Rural West Virginia,0,7,5,0.7142857142857143,Asphyxiation - includes death by gas,2
87978105,2,"Baton Rouge, LA",4,7,5,0.7142857142857143,Fire,2
88204254,2,Rural Delaware,10,7,5,0.7142857142857143,Other or type unknown,2
88402434,1,"Holland-Grand Haven, MI",10,7,5,0.7142857142857143,Other or type unknown,2
91497203,2,"Ogden-Clearfield, UT",1,7,5,0.7142857142857143,"Blunt object - hammer, club, etc",2
92012309,1,"Raleigh-Cary, NC",4,7,5,0.7142857142857143,Fire,2
95310545,2,"Pine Bluff, AR",16,7,5,0.7142857142857143,Strangulation - hanging,2
98471073,1,"Florence, SC",4,7,5,0.7142857142857143,Fire,2
98479608,1,"Wichita, KS",4,7,5,0.7142857142857143,Fire,2
99011084,9,"Washington-Arlington-Alexandria, DC-VA-MD-WV",5,7,5,0.7142857142857143,"Firearm, type not stated",2
382428,1,"Anchorage, AK",16,6,4,0.6666666666666666,Strangulation - hanging,2
984661,2,"St. George, UT",10,6,4,0.6666666666666666,Other or type unknown,2
1022138,2,"Tyler, TX",5,6,4,0.6666666666666666,"Firearm, type not stated",2
8372322,1,Rural Idaho,12,6,4,0.6666666666666666,Poison - does not include gas,2
8656485,2,"El Centro, CA",1,6,4,0.6666666666666666,"Blunt object - hammer, club, etc",2
8733177,1,"Johnstown, PA",14,6,4,0.6666666666666666,Rifle,2
11579773,1,"Asheville, NC",4,6,4,0.6666666666666666,Fire,2
13248000,2,Rural Virginia,16,6,4,0.6666666666666666,Strangulation - hanging,2
18288774,2,"Eau Claire, WI",0,6,4,0.6666666666666666,Asphyxiation - includes death by gas,2
19164379,2,"Trenton-Ewing, NJ",0,6,4,0.6666666666666666,Asphyxiation - includes death by gas,2
21657881,2,"Janesville, WI",5,6,4,0.6666666666666666,"Firearm, type not stated",2
23171716,2,"Redding, CA",16,6,4,0.6666666666666666,Strangulation - hanging,2
23590343,1,"Kingsport-Bristol-Bristol, TN-VA",8,6,4,0.6666666666666666,"Narcotics or drugs, sleeping pills",2
24243321,1,"Columbus, IN",6,6,4,0.6666666666666666,"Handgun - pistol, revolver, etc",2
24451141,1,"Burlington-South Burlington, VT",11,6,4,0.6666666666666666,"Personal weapons, includes beating",2
25058426,1,"Rochester, NY",0,6,4,0.6666666666666666,Asphyxiation - includes death by gas,2
26289680,1,"Visalia-Porterville, CA",0,6,4,0.6666666666666666,Asphyxiation - includes death by gas,2
26753694,2,"Jefferson City, MO",10,6,4,0.6666666666666666,Other or type unknown,2
27405593,2,"Napa, CA",16,6,4,0.6666666666666666,Strangulation - hanging,2
31592739,1,"Harrisburg-Carlisle, PA",4,6,4,0.6666666666666666,Fire,2
33636138,2,"Raleigh-Cary, NC",4,6,4,0.6666666666666666,Fire,2
35037405,2,Rural Oklahoma,2,6,4,0.6666666666666666,Drowning,2
39247006,1,"Champaign-Urbana, IL",10,6,4,0.6666666666666666,Other or type unknown,2
39910096,2,"Jacksonville, FL",9,6,4,0.6666666666666666,Other gun,2
40577607,2,"Dallas-Fort Worth-Arlington, TX",12,6,4,0.6666666666666666,Poison - does not include gas,2
41541871,2,"Fort Walton Beach-Destin, FL",8,6,4,0.6666666666666666,"Narcotics or drugs, sleeping pills",2
43661449,2,"Waterloo-Cedar Falls, IA",7,6,4,0.6666666666666666,Knife or cutting instrument,2
46208505,2,"Portland-South Portland-Biddeford, ME",5,6,4,0.6666666666666666,"Firearm, type not stated",2
48426580,1,"Detroit-Warren-Livonia, MI",12,6,4,0.6666666666666666,Poison - does not include gas,2
49858905,2,"Wichita, KS",4,6,4,0.6666666666666666,Fire,2
52971259,2,"Oklahoma City, OK",8,6,4,0.6666666666666666,"Narcotics or drugs, sleeping pills",2
57151078,2,"Kingston, NY",14,6,4,0.6666666666666666,Rifle,2
59829060,1,"Vallejo-Fairfield, CA",16,6,4,0.6666666666666666,Strangulation - hanging,2
64601304,2,"Allentown-Bethlehem-Easton, PA-NJ",4,6,4,0.6666666666666666,Fire,2
65287410,1,Rural North Carolina,0,6,4,0.6666666666666666,Asphyxiation - includes death by gas,2
65823687,2,Rural Kansas,16,6,4,0.6666666666666666,Strangulation - hanging,2
66218145,1,"Fort Collins-Loveland, CO",1,6,4,0.6666666666666666,"Blunt object - hammer, club, etc",2
66269499,2,"Springfield, MO",5,6,4,0.6666666666666666,"Firearm, type not stated",2
67328727,1,"Toledo, OH",9,6,4,0.6666666666666666,Other gun,2
67434132,1,"Utica-Rome, NY",17,6,4,0.6666666666666666,Weapon Not Reported,2
69001802,2,"Medford, OR",16,6,4,0.6666666666666666,Strangulation - hanging,2
69633864,1,"Idaho Falls, ID",5,6,4,0.6666666666666666,"Firearm, type not stated",2
70756042,1,Rural Arizona,4,6,4,0.6666666666666666,Fire,2
73107595,2,"Lafayette, IN",10,6,4,0.6666666666666666,Other or type unknown,2
74233800,2,"Cleveland, TN",5,6,4,0.6666666666666666,"Firearm, type not stated",2
79277351,1,"Poughkeepsie-Newburgh-Middletown, NY",4,6,4,0.6666666666666666,Fire,2
79550219,1,"Albany-Schenectady-Troy, NY",0,6,4,0.6666666666666666,Asphyxiation - includes death by gas,2
81571880,2,"Boulder, CO",1,6,4,0.6666666666666666,"Blunt object - hammer, club, etc",2
82939133,1,"Elkhart-Goshen, IN",14,6,4,0.6666666666666666,Rifle,2
83723112,2,"Augusta-Richmond County, GA-SC",16,6,4,0.6666666666666666,Strangulation - hanging,2
83988998,2,"Fort Walton Beach-Destin, FL",1,6,4,0.6666666666666666,"Blunt object - hammer, club, etc",2
92240972,2,"Terre Haute, IN",7,6,4,0.6666666666666666,Knife or cutting instrument,2
94096008,1,"Macon, GA",4,6,4,0.6666666666666666,Fire,2
95527682,2,"Florence-Muscle Shoals, AL",11,6,4,0.6666666666666666,"Personal weapons, includes beating",2
96001838,1,"Athens-Clarke County, GA",1,6,4,0.6666666666666666,"Blunt object - hammer, club, etc",2
97627882,9,Rural Tennessee,6,6,4,0.6666666666666666,"Handgun - pistol, revolver, etc",2
97850213,1,"Charleston, WV",0,6,4,0.6666666666666666,Asphyxiation - includes death by gas,2
99229169,2,"Jacksonville, FL",0,6,4,0.6666666666666666,Asphyxiation - includes death by gas,2
82919,2,"Albuquerque, NM",4,5,3,0.6,Fire,2
893795,1,"Hot Springs, AR",4,5,3,0.6,Fire,2
933453,1,"Prescott, AZ",10,5,3,0.6,Other or type unknown,2
3254067,1,"Johnstown, PA",4,5,3,0.6,Fire,2
3310196,1,"Terre Haute, IN",5,5,3,0.6,"Firearm, type not stated",2
4981396,1,"Rochester, NY",16,5,3,0.6,Strangulation - hanging,2
5653273,2,"Joplin, MO",11,5,3,0.6,"Personal weapons, includes beating",2
5774604,2,"Sumter, SC",10,5,3,0.6,Other or type unknown,2
7502974,2,"Chico, CA",5,5,3,0.6,"Firearm, type not stated",2
13496875,2,"Atlantic City, NJ",5,5,3,0.6,"Firearm, type not stated",2
14393696,2,"Columbia, SC",16,5,3,0.6,Strangulation - hanging,2
15230603,1,"Evansville, IN-KY",4,5,3,0.6,Fire,2
15390093,2,"Ithaca, NY",6,5,3,0.6,"Handgun - pistol, revolver, etc",2
17263042,2,"Salisbury, MD",16,5,3,0.6,Strangulation - hanging,2
23766381,2,"Idaho Falls, ID",10,5,3,0.6,Other or type unknown,2
26532619,2,"Las Cruces, NM",1,5,3,0.6,"Blunt object - hammer, club, etc",2
27609194,1,"Barnstable Town, MA",4,5,3,0.6,Fire,2
31189599,2,Rural Tennessee,16,5,3,0.6,Strangulation - hanging,2
31222474,2,"Portland-Vancouver-Beaverton, OR-WA",9,5,3,0.6,Other gun,2
32426957,1,"Grand Rapids-Wyoming, MI",12,5,3,0.6,Poison - does not include gas,2
32579526,2,"Baltimore-Towson, MD",9,5,3,0.6,Other gun,2
35815981,2,"Norwich-New London, CT",4,5,3,0.6,Fire,2
35840624,2,"Blacksburg-Christiansburg, VA",15,5,3,0.6,Shotgun,2
36433724,2,"Mobile, AL",4,5,3,0.6,Fire,2
38076419,1,"Santa Cruz-Watsonville, CA",16,5,3,0.6,Strangulation - hanging,2
39021494,1,Rural Indiana,16,5,3,0.6,Strangulation - hanging,2
39864925,2,"Montgomery, AL",16,5,3,0.6,Strangulation - hanging,2
41202421,2,"Santa Barbara-Santa Maria, CA",16,5,3,0.6,Strangulation - hanging,2
44731987,2,"Warner Robins, GA",1,5,3,0.6,"Blunt object - hammer, club, etc",2
46576733,2,"Sumter, SC",5,5,3,0.6,"Firearm, type not stated",2
48625366,2,"Lima, OH",10,5,3,0.6,Other or type unknown,2
48746976,9,"Chattanooga, TN-GA",10,5,3,0.6,Other or type unknown,2
49676026,2,"Lansing-East Lansing, MI",16,5,3,0.6,Strangulation - hanging,2
50695731,1,"Bend, OR",5,5,3,0.6,"Firearm, type not stated",2
53165213,1,"Lafayette, LA",0,5,3,0.6,Asphyxiation - includes death by gas,2
53374833,1,"Las Cruces, NM",11,5,3,0.6,"Personal weapons, includes beating",2
55565787,2,"Parkersburg-Marietta-Vienna, WV-OH",4,5,3,0.6,Fire,2
56783901,2,"Prescott, AZ",16,5,3,0.6,Strangulation - hanging,2
56954825,2,"Saginaw, MI",16,5,3,0.6,Strangulation - hanging,2
58453094,1,"Waco, TX",4,5,3,0.6,Fire,2
60072570,2,"Lima, OH",16,5,3,0.6,Strangulation - hanging,2
60392288,2,"Kankakee-Bradley, IL",1,5,3,0.6,"Blunt object - hammer, club, etc",2
60798347,2,"Dalton, GA",15,5,3,0.6,Shotgun,2
63015468,2,"Pueblo, CO",16,5,3,0.6,Strangulation - hanging,2
64127185,2,"Bellingham, WA",10,5,3,0.6,Other or type unknown,2
67228365,1,"Wausau, WI",14,5,3,0.6,Rifle,2
68082492,2,"Glens Falls, NY",1,5,3,0.6,"Blunt object - hammer, club, etc",2
75069288,2,"Los Angeles-Long Beach, CA",3,5,3,0.6,Explosives,2
81742927,1,"Holland-Grand Haven, MI",1,5,3,0.6,"Blunt object - hammer, club, etc",2
83561037,1,"Phoenix-Mesa-Scottsdale, AZ",3,5,3,0.6,Explosives,2
85027863,1,Rural West Virginia,9,5,3,0.6,Other gun,2
85421374,2,"Hanford-Corcoran, CA",1,5,3,0.6,"Blunt object - hammer, club, etc",2
85670068,1,"Saginaw, MI",4,5,3,0.6,Fire,2
89969298,2,"La Crosse, WI-MN",7,5,3,0.6,Knife or cutting instrument,2
90924617,1,"Lima, OH",15,5,3,0.6,Shotgun,2
92037571,1,"Casper, WY",10,5,3,0.6,Other or type unknown,2
92773924,9,"Richmond, VA",10,5,3,0.6,Other or type unknown,2
94706162,2,"Detroit-Warren-Livonia, MI",12,5,3,0.6,Poison - does not include gas,2
749881,2,"Spartanburg, SC",0,4,2,0.5,Asphyxiation - includes death by gas,2
1137866,2,"Vallejo-Fairfield, CA",5,4,2,0.5,"Firearm, type not stated",2
1984587,1,Rural Hawaii,4,4,2,0.5,Fire,2
2265295,1,"Sioux City, IA-NE-SD",10,4,2,0.5,Other or type unknown,2
4337971,1,"Danville, VA",16,4,2,0.5,Strangulation - hanging,2
7249280,2,Rural Kentucky,9,4,2,0.5,Other gun,2
7599466,1,"Stockton, CA",8,4,2,0.5,"Narcotics or drugs, sleeping pills",2
8196597,1,"Modesto, CA",4,4,2,0.5,Fire,2
9228299,2,"College Station-Bryan, TX",1,4,2,0.5,"Blunt object - hammer, club, etc",2
9823858,9,"Houston-Sugar Land-Baytown, TX",5,4,2,0.5,"Firearm, type not stated",2
10808818,2,"Auburn-Opelika, AL",11,4,2,0.5,"Personal weapons, includes beating",2
12430357,2,"Salinas, CA",8,4,2,0.5,"Narcotics or drugs, sleeping pills",2
13926890,2,"Vineland-Millville-Bridgeton, NJ",1,4,2,0.5,"Blunt object - hammer, club, etc",2
19245314,2,"Lake Charles, LA",16,4,2,0.5,Strangulation - hanging,2
23424969,1,"Grand Rapids-Wyoming, MI",16,4,2,0.5,Strangulation - hanging,2
23851848,9,Rural West Virginia,10,4,2,0.5,Other or type unknown,2
24504777,1,"Springfield, OH",4,4,2,0.5,Fire,2
25461729,2,"Atlanta-Sandy Springs-Marietta, GA",9,4,2,0.5,Other gun,2
27549716,2,"Yakima, WA",4,4,2,0.5,Fire,2
27602420,2,"Bangor, ME",1,4,2,0.5,"Blunt object - hammer, club, etc",2
31726215,1,"Weirton-Steubenville, WV-OH",5,4,2,0.5,"Firearm, type not stated",2
32333036,1,"Kingston, NY",10,4,2,0.5,Other or type unknown,2
36860712,9,"Birmingham-Hoover, AL",11,4,2,0.5,"Personal weapons, includes beating",2
36873283,2,"Ocean City, NJ",10,4,2,0.5,Other or type unknown,2
38769982,1,"Lansing-East Lansing, MI",0,4,2,0.5,Asphyxiation - includes death by gas,2
39112212,1,"Texarkana, TX-Texarkana, AR",9,4,2,0.5,Other gun,2
39828559,1,"Burlington, NC",4,4,2,0.5,Fire,2
41062636,2,"Louisville, KY-IN",9,4,2,0.5,Other gun,2
43013286,1,"Colorado Springs, CO",16,4,2,0.5,Strangulation - hanging,2
43694147,1,"Houma-Bayou Cane-Thibodaux, LA",4,4,2,0.5,Fire,2
44437795,2,"Waterloo-Cedar Falls, IA",15,4,2,0.5,Shotgun,2
44867252,2,"Napa, CA",0,4,2,0.5,Asphyxiation - includes death by gas,2
45064792,2,Rural Louisiana,9,4,2,0.5,Other gun,2
46705012,1,"Atlanta-Sandy Springs-Marietta, GA",12,4,2,0.5,Poison - does not include gas,2
47069817,1,"Providence-New Bedford-Fall River, RI-MA",9,4,2,0.5,Other gun,2
48769010,1,"Eau Claire, WI",8,4,2,0.5,"Narcotics or drugs, sleeping pills",2
52909455,1,"Greenville, SC",16,4,2,0.5,Strangulation - hanging,2
55196673,1,"Detroit-Warren-Livonia, MI",13,4,2,0.5,Pushed or thrown out window,2
55754275,2,"Erie, PA",5,4,2,0.5,"Firearm, type not stated",2
57897506,1,"Beaumont-Port Arthur, TX",0,4,2,0.5,Asphyxiation - includes death by gas,2
61667577,2,"Pensacola-Ferry Pass-Brent, FL",4,4,2,0.5,Fire,2
62088828,1,Rural Wyoming,0,4,2,0.5,Asphyxiation - includes death by gas,2
64686844,2,"Pittsburgh, PA",13,4,2,0.5,Pushed or thrown out window,2
65198577,2,"Sherman-Denison, TX",16,4,2,0.5,Strangulation - hanging,2
67351728,2,Rural Wyoming,4,4,2,0.5,Fire,2
69743623,2,"Virginia Beach-Norfolk-Newport News, VA-NC",9,4,2,0.5,Other gun,2
70807767,1,"Kansas City, MO-KS",12,4,2,0.5,Poison - does not include gas,2
73032171,2,"Anniston-Oxford, AL",15,4,2,0.5,Shotgun,2
73911551,2,"Johnstown, PA",14,4,2,0.5,Rifle,2
73990781,1,"Racine, WI",0,4,2,0.5,Asphyxiation - includes death by gas,2
75570276,2,"Las Cruces, NM",5,4,2,0.5,"Firearm, type not stated",2
76470629,1,"Ames, IA",6,4,2,0.5,"Handgun - pistol, revolver, etc",2
77165997,2,"State College, PA",5,4,2,0.5,"Firearm, type not stated",2
79129691,1,Rural Illinois,2,4,2,0.5,Drowning,2
80177536,2,"Visalia-Porterville, CA",4,4,2,0.5,Fire,2
80229214,1,"Barnstable Town, MA",15,4,2,0.5,Shotgun,2
81170184,1,"McAllen-Edinburg-Mission, TX",16,4,2,0.5,Strangulation - hanging,2
81202315,1,"Ann Arbor, MI",0,4,2,0.5,Asphyxiation - includes death by gas,2
81706501,2,"Wheeling, WV-OH",16,4,2,0.5,Strangulation - hanging,2
82450086,2,"Atlantic City, NJ",4,4,2,0.5,Fire,2
83913293,2,Rural Delaware,5,4,2,0.5,"Firearm, type not stated",2
85938254,1,"Augusta-Richmond County, GA-SC",16,4,2,0.5,Strangulation - hanging,2
88314687,1,"Syracuse, NY",16,4,2,0.5,Strangulation - hanging,2
91997771,2,"Merced, CA",0,4,2,0.5,Asphyxiation - includes death by gas,2
92356574,2,"La Crosse, WI-MN",1,4,2,0.5,"Blunt object - hammer, club, etc",2
92405869,9,"Tulsa, OK",10,4,2,0.5,Other or type unknown,2
94647930,2,"Ann Arbor, MI",16,4,2,0.5,Strangulation - hanging,2
95301964,1,"Shreveport-Bossier City, LA",4,4,2,0.5,Fire,2
96034846,1,"Charlotte-Gastonia-Concord, NC-SC",16,4,2,0.5,Strangulation - hanging,2
96746857,2,"San Francisco-Oakland-Fremont, CA",9,4,2,0.5,Other gun,2
99055924,2,"Poughkeepsie-Newburgh-Middletown, NY",0,4,2,0.5,Asphyxiation - includes death by gas,2
1158533,9,Rural Arkansas,10,3,1,0.3333333333333333,Other or type unknown,2
1494428,1,"York-Hanover, PA",16,3,1,0.3333333333333333,Strangulation - hanging,2
3868287,2,"Napa, CA",1,3,1,0.3333333333333333,"Blunt object - hammer, club, etc",2
5004213,9,"Phoenix-Mesa-Scottsdale, AZ",5,3,1,0.3333333333333333,"Firearm, type not stated",2
5101708,2,"Elkhart-Goshen, IN",4,3,1,0.3333333333333333,Fire,2
6118878,1,"Coeur d Alene, ID",0,3,1,0.3333333333333333,Asphyxiation - includes death by gas,2
6933791,2,"Sarasota-Bradenton-Venice, FL",16,3,1,0.3333333333333333,Strangulation - hanging,2
7798813,9,"Philadelphia-Camden-Wilmington, PA-NJ-DE",10,3,1,0.3333333333333333,Other or type unknown,2
8777340,1,"Greeley, CO",16,3,1,0.3333333333333333,Strangulation - hanging,2
8938157,2,"Flint, MI",9,3,1,0.3333333333333333,Other gun,2
9647073,2,"St. Louis, MO-IL",13,3,1,0.3333333333333333,Pushed or thrown out window,2
10016578,1,"Peoria, IL",16,3,1,0.3333333333333333,Strangulation - hanging,2
10143184,1,"Houma-Bayou Cane-Thibodaux, LA",16,3,1,0.3333333333333333,Strangulation - hanging,2
11328407,1,Rural Indiana,8,3,1,0.3333333333333333,"Narcotics or drugs, sleeping pills",2
11819120,1,"Santa Fe, NM",4,3,1,0.3333333333333333,Fire,2
12317394,1,"Janesville, WI",4,3,1,0.3333333333333333,Fire,2
13811395,1,"Trenton-Ewing, NJ",9,3,1,0.3333333333333333,Other gun,2
15080039,1,"Tucson, AZ",4,3,1,0.3333333333333333,Fire,2
15502862,2,"Miami-Fort Lauderdale, FL",12,3,1,0.3333333333333333,Poison - does not include gas,2
19338702,9,"Atlanta-Sandy Springs-Marietta, GA",4,3,1,0.3333333333333333,Fire,2
20639724,2,"Little Rock-North Little Rock, AR",9,3,1,0.3333333333333333,Other gun,2
21099134,1,"Anderson, IN",1,3,1,0.3333333333333333,"Blunt object - hammer, club, etc",2
21999780,1,"Greenville, SC",2,3,1,0.3333333333333333,Drowning,2
24072143,1,"Alexandria, LA",4,3,1,0.3333333333333333,Fire,2
24932264,2,"Huntsville, AL",16,3,1,0.3333333333333333,Strangulation - hanging,2
27738369,1,Rural Illinois,4,3,1,0.3333333333333333,Fire,2
28144714,2,"Pittsfield, MA",10,3,1,0.3333333333333333,Other or type unknown,2
28500295,2,"Hot Springs, AR",16,3,1,0.3333333333333333,Strangulation - hanging,2
29556261,9,"Tuscaloosa, AL",10,3,1,0.3333333333333333,Other or type unknown,2
33868201,1,"Colorado Springs, CO",3,3,1,0.3333333333333333,Explosives,2
35377187,2,"Evansville, IN-KY",4,3,1,0.3333333333333333,Fire,2
36621436,2,"Roanoke, VA",16,3,1,0.3333333333333333,Strangulation - hanging,2
36636588,9,"Orlando-Kissimmee, FL",10,3,1,0.3333333333333333,Other or type unknown,2
37783250,1,"Miami-Fort Lauderdale, FL",3,3,1,0.3333333333333333,Explosives,2
38647356,2,"Flagstaff, AZ",15,3,1,0.3333333333333333,Shotgun,2
41237878,9,"Baltimore-Towson, MD",5,3,1,0.3333333333333333,"Firearm, type not stated",2
42386080,1,"Amarillo, TX",16,3,1,0.3333333333333333,Strangulation - hanging,2
42690013,1,Rural Indiana,12,3,1,0.3333333333333333,Poison - does not include gas,2
45338396,1,"Savannah, GA",9,3,1,0.3333333333333333,Other gun,2
45906902,1,"Macon, GA",9,3,1,0.3333333333333333,Other gun,2
46367236,1,"Olympia, WA",16,3,1,0.3333333333333333,Strangulation - hanging,2
47091472,2,"Barnstable Town, MA",5,3,1,0.3333333333333333,"Firearm, type not stated",2
48169052,9,"Decatur, AL",6,3,1,0.3333333333333333,"Handgun - pistol, revolver, etc",2
50128919,2,"Johnstown, PA",5,3,1,0.3333333333333333,"Firearm, type not stated",2
50820187,1,"Memphis, TN-MS-AR",2,3,1,0.3333333333333333,Drowning,2
53835022,2,"Janesville, WI",0,3,1,0.3333333333333333,Asphyxiation - includes death by gas,2
54260014,1,"Bloomington-Normal, IL",5,3,1,0.3333333333333333,"Firearm, type not stated",2
56793558,2,"Yuba City, CA",5,3,1,0.3333333333333333,"Firearm, type not stated",2
57015876,2,"Muncie, IN",16,3,1,0.3333333333333333,Strangulation - hanging,2
57603611,9,"Dallas-Fort Worth-Arlington, TX",7,3,1,0.3333333333333333,Knife or cutting instrument,2
58985650,1,"Anchorage, AK",8,3,1,0.3333333333333333,"Narcotics or drugs, sleeping pills",2
59803220,1,Rural Colorado,4,3,1,0.3333333333333333,Fire,2
59896521,2,"El Centro, CA",0,3,1,0.3333333333333333,Asphyxiation - includes death by gas,2
62380154,2,"Monroe, MI",16,3,1,0.3333333333333333,Strangulation - hanging,2
62465690,9,Rural Tennessee,5,3,1,0.3333333333333333,"Firearm, type not stated",2
64936179,2,"Jackson, TN",16,3,1,0.3333333333333333,Strangulation - hanging,2
66744359,2,"Macon, GA",9,3,1,0.3333333333333333,Other gun,2
67774574,1,"Amarillo, TX",4,3,1,0.3333333333333333,Fire,2
68923964,2,"Wausau, WI",1,3,1,0.3333333333333333,"Blunt object - hammer, club, etc",2
69586447,2,"Louisville, KY-IN",8,3,1,0.3333333333333333,"Narcotics or drugs, sleeping pills",2
69663936,2,Rural Texas,9,3,1,0.3333333333333333,Other gun,2
71199561,1,"Erie, PA",4,3,1,0.3333333333333333,Fire,2
73238526,2,"Sioux City, IA-NE-SD",1,3,1,0.3333333333333333,"Blunt object - hammer, club, etc",2
73480985,2,"Glens Falls, NY",5,3,1,0.3333333333333333,"Firearm, type not stated",2
74233653,2,"Colorado Springs, CO",4,3,1,0.3333333333333333,Fire,2
76617100,1,"Huntington-Ashland, WV-KY-OH",9,3,1,0.3333333333333333,Other gun,2
77440557,9,Rural Mississippi,7,3,1,0.3333333333333333,Knife or cutting instrument,2
78791551,1,"Decatur, IL",1,3,1,0.3333333333333333,"Blunt object - hammer, club, etc",2
80148635,2,"Morristown, TN",1,3,1,0.3333333333333333,"Blunt object - hammer, club, etc",2
80677698,2,"Hot Springs, AR",4,3,1,0.3333333333333333,Fire,2
83608058,1,"Salinas, CA",4,3,1,0.3333333333333333,Fire,2
83855061,1,"Shreveport-Bossier City, LA",9,3,1,0.3333333333333333,Other gun,2
84501728,1,"Lewiston-Auburn, ME",10,3,1,0.3333333333333333,Other or type unknown,2
84790874,9,"Greensboro-High Point, NC",10,3,1,0.3333333333333333,Other or type unknown,2
86524942,2,"Wenatchee, WA",10,3,1,0.3333333333333333,Other or type unknown,2
87446840,1,"Dubuque, IA",5,3,1,0.3333333333333333,"Firearm, type not stated",2
89076498,2,Rural Utah,1,3,1,0.3333333333333333,"Blunt object - hammer, club, etc",2
91090044,1,"Altoona, PA",1,3,1,0.3333333333333333,"Blunt object - hammer, club, etc",2
91173867,2,"Monroe, MI",1,3,1,0.3333333333333333,"Blunt object - hammer, club, etc",2
92762597,1,"Cleveland-Elyria-Mentor, OH",3,3,1,0.3333333333333333,Explosives,2
93770668,2,Rural Nevada,16,3,1,0.3333333333333333,Strangulation - hanging,2
94646587,2,"Cleveland-Elyria-Mentor, OH",9,3,1,0.3333333333333333,Other gun,2
94848636,2,"Saginaw, MI",0,3,1,0.3333333333333333,Asphyxiation - includes death by gas,2
96944013,2,"Portland-South Portland-Biddeford, ME",4,3,1,0.3333333333333333,Fire,2
97445322,1,"Miami-Fort Lauderdale, FL",12,3,1,0.3333333333333333,Poison - does not include gas,2
97676733,2,Rural Alabama,8,3,1,0.3333333333333333,"Narcotics or drugs, sleeping pills",2
98064497,9,"St. Louis, MO-IL",5,3,1,0.3333333333333333,"Firearm, type not stated",2
98853265,2,"Lawton, OK",5,3,1,0.3333333333333333,"Firearm, type not stated",2
241337,1,"Spokane, WA",4,2,0,0.0,Fire,2
438610,2,Rural Wyoming,17,2,0,0.0,Weapon Not Reported,2
580621,9,"Houston-Sugar Land-Baytown, TX",1,2,0,0.0,"Blunt object - hammer, club, etc",2
1669084,2,"Longview, TX",17,2,0,0.0,Weapon Not Reported,2
1803705,2,"Springfield, OH",1,2,0,0.0,"Blunt object - hammer, club, etc",2
2510419,1,"Florence-Muscle Shoals, AL",1,2,0,0.0,"Blunt object - hammer, club, etc",2
2779420,9,"Auburn-Opelika, AL",10,2,0,0.0,Other or type unknown,2
2877022,2,"Bowling Green, KY",17,2,0,0.0,Weapon Not Reported,2
3763539,2,"Seattle-Tacoma-Bellevue, WA",12,2,0,0.0,Poison - does not include gas,2
5113785,9,"Memphis, TN-MS-AR",6,2,0,0.0,"Handgun - pistol, revolver, etc",2
6603590,1,"Wichita Falls, TX",16,2,0,0.0,Strangulation - hanging,2
7196564,2,"Seattle-Tacoma-Bellevue, WA",17,2,0,0.0,Weapon Not Reported,2
7639284,1,"Sacramento-Roseville, CA",3,2,0,0.0,Explosives,2
9004743,1,"Denver-Aurora, CO",12,2,0,0.0,Poison - does not include gas,2
9218002,2,"Kankakee-Bradley, IL",16,2,0,0.0,Strangulation - hanging,2
10107684,2,"Elkhart-Goshen, IN",16,2,0,0.0,Strangulation - hanging,2
10158518,2,"Killeen-Temple-Fort Hood, TX",17,2,0,0.0,Weapon Not Reported,2
10793830,2,"Fayetteville-Springdale-Rogers, AR-MO",4,2,0,0.0,Fire,2
11141814,1,"Redding, CA",17,2,0,0.0,Weapon Not Reported,2
11875817,2,"Augusta-Richmond County, GA-SC",17,2,0,0.0,Weapon Not Reported,2
12480791,2,"Alexandria, LA",17,2,0,0.0,Weapon Not Reported,2
12496288,2,"Cape Coral-Fort Myers, FL",0,2,0,0.0,Asphyxiation - includes death by gas,2
12743218,2,"Stockton, CA",17,2,0,0.0,Weapon Not Reported,2
12917500,1,"San Antonio, TX",3,2,0,0.0,Explosives,2
13574605,1,"South Bend-Mishawaka, IN-MI",17,2,0,0.0,Weapon Not Reported,2
13974746,2,"Greensboro-High Point, NC",17,2,0,0.0,Weapon Not Reported,2
14125748,1,Rural Nevada,4,2,0,0.0,Fire,2
14304502,2,"Kansas City, MO-KS",17,2,0,0.0,Weapon Not Reported,2
14682689,9,"Naples-Marco Island, FL",5,2,0,0.0,"Firearm, type not stated",2
15098254,9,"Charlotte-Gastonia-Concord, NC-SC",5,2,0,0.0,"Firearm, type not stated",2
15188755,1,"Clarksville, TN-KY",9,2,0,0.0,Other gun,2
15263119,1,Rural West Virginia,17,2,0,0.0,Weapon Not Reported,2
15276715,1,"Bakersfield, CA",17,2,0,0.0,Weapon Not Reported,2
15990100,1,"Nashville-Davidson-Murfreesboro, TN",17,2,0,0.0,Weapon Not Reported,2
17089681,1,"Raleigh-Cary, NC",17,2,0,0.0,Weapon Not Reported,2
18869596,2,"Bakersfield, CA",17,2,0,0.0,Weapon Not Reported,2
18881473,1,"Vero Beach, FL",9,2,0,0.0,Other gun,2
18898419,2,"Virginia Beach-Norfolk-Newport News, VA-NC",17,2,0,0.0,Weapon Not Reported,2
19046508,9,"St. Louis, MO-IL",6,2,0,0.0,"Handgun - pistol, revolver, etc",2
19165424,1,"Chico, CA",17,2,0,0.0,Weapon Not Reported,2
19775362,2,"Wausau, WI",14,2,0,0.0,Rifle,2
19860269,2,"Laredo, TX",17,2,0,0.0,Weapon Not Reported,2
19999218,9,"Kansas City, MO-KS",5,2,0,0.0,"Firearm, type not stated",2
20172304,2,"Springfield, OH",16,2,0,0.0,Strangulation - hanging,2
21476458,9,"Flint, MI",11,2,0,0.0,"Personal weapons, includes beating",2
21593916,1,"Trenton-Ewing, NJ",3,2,0,0.0,Explosives,2
21885767,2,"Racine, WI",4,2,0,0.0,Fire,2
21978923,1,"Waco, TX",0,2,0,0.0,Asphyxiation - includes death by gas,2
22898955,9,"San Jose-Sunnyvale-Santa Clara, CA",10,2,0,0.0,Other or type unknown,2
24479182,2,Rural South Carolina,2,2,0,0.0,Drowning,2
24622552,1,"Greenville, NC",17,2,0,0.0,Weapon Not Reported,2
26336668,9,"Columbus, OH",14,2,0,0.0,Rifle,2
27652102,2,"Allentown-Bethlehem-Easton, PA-NJ",17,2,0,0.0,Weapon Not Reported,2
27685914,1,Rural Colorado,17,2,0,0.0,Weapon Not Reported,2
28444924,2,Rural South Dakota,17,2,0,0.0,Weapon Not Reported,2
28540190,2,"Champaign-Urbana, IL",10,2,0,0.0,Other or type unknown,2
29549904,9,"Phoenix-Mesa-Scottsdale, AZ",1,2,0,0.0,"Blunt object - hammer, club, etc",2
31102456,1,"San Francisco-Oakland-Fremont, CA",17,2,0,0.0,Weapon Not Reported,2
31154197,2,"El Centro, CA",5,2,0,0.0,"Firearm, type not stated",2
32821574,1,"Racine, WI",17,2,0,0.0,Weapon Not Reported,2
33628789,9,Rural Alabama,7,2,0,0.0,Knife or cutting instrument,2
33637380,2,"Appleton, WI",16,2,0,0.0,Strangulation - hanging,2
34167827,1,Rural Texas,17,2,0,0.0,Weapon Not Reported,2
34404499,2,"Anderson, SC",17,2,0,0.0,Weapon Not Reported,2
34536158,1,"Davenport-Moline-Rock Island, IA-IL",17,2,0,0.0,Weapon Not Reported,2
34722253,1,"Columbus, GA-AL",17,2,0,0.0,Weapon Not Reported,2
34863898,9,"Jackson, MI",10,2,0,0.0,Other or type unknown,2
35676352,2,"Lansing-East Lansing, MI",9,2,0,0.0,Other gun,2
36213551,2,"Michigan City-La Porte, IN",17,2,0,0.0,Weapon Not Reported,2
36880981,1,"Birmingham-Hoover, AL",3,2,0,0.0,Explosives,2
37328419,2,"Reno-Sparks, NV",17,2,0,0.0,Weapon Not Reported,2
37734292,1,"Youngstown-Warren-Boardman, OH-PA",17,2,0,0.0,Weapon Not Reported,2
38121822,1,"Greenville, SC",17,2,0,0.0,Weapon Not Reported,2
38355109,1,"Stockton, CA",17,2,0,0.0,Weapon Not Reported,2
38687412,1,"Fayetteville-Springdale-Rogers, AR-MO",17,2,0,0.0,Weapon Not Reported,2
38891250,2,"Boulder, CO",16,2,0,0.0,Strangulation - hanging,2
40772844,1,"Richmond, VA",17,2,0,0.0,Weapon Not Reported,2
40900983,2,"Brunswick, GA",17,2,0,0.0,Weapon Not Reported,2
41850767,1,"Portland-Vancouver-Beaverton, OR-WA",17,2,0,0.0,Weapon Not Reported,2
41945932,2,"Anchorage, AK",17,2,0,0.0,Weapon Not Reported,2
42624347,1,"Birmingham-Hoover, AL",0,2,0,0.0,Asphyxiation - includes death by gas,2
43001389,1,"Santa Cruz-Watsonville, CA",0,2,0,0.0,Asphyxiation - includes death by gas,2
43282409,9,"Virginia Beach-Norfolk-Newport News, VA-NC",10,2,0,0.0,Other or type unknown,2
43336823,2,"Las Vegas-Paradise, NV",9,2,0,0.0,Other gun,2
45374988,9,"Minneapolis-St. Paul-Bloomington, MN-WI",7,2,0,0.0,Knife or cutting instrument,2
45799165,9,"Riverside-San Bernardino, CA",5,2,0,0.0,"Firearm, type not stated",2
46012018,2,"Racine, WI",17,2,0,0.0,Weapon Not Reported,2
46742360,9,"Bridgeport-Stamford-Norwalk, CT",4,2,0,0.0,Fire,2
47883183,1,"Savannah, GA",17,2,0,0.0,Weapon Not Reported,2
47991739,1,Rural Colorado,16,2,0,0.0,Strangulation - hanging,2
48847645,1,Rural Tennessee,17,2,0,0.0,Weapon Not Reported,2
48912638,2,Rural Hawaii,0,2,0,0.0,Asphyxiation - includes death by gas,2
49696202,2,Rural Utah,0,2,0,0.0,Asphyxiation - includes death by gas,2
50304143,1,"Lansing-East Lansing, MI",17,2,0,0.0,Weapon Not Reported,2
50715371,2,"Macon, GA",17,2,0,0.0,Weapon Not Reported,2
50803459,1,"Manchester-Nashua, NH",9,2,0,0.0,Other gun,2
50914116,2,"Canton-Massillon, OH",8,2,0,0.0,"Narcotics or drugs, sleeping pills",2
51290312,1,"Hanford-Corcoran, CA",4,2,0,0.0,Fire,2
52914225,1,"Michigan City-La Porte, IN",17,2,0,0.0,Weapon Not Reported,2
55151041,1,"Toledo, OH",17,2,0,0.0,Weapon Not Reported,2
55232387,2,"Charleston-North Charleston, SC",17,2,0,0.0,Weapon Not Reported,2
55765226,1,"Longview, TX",2,2,0,0.0,Drowning,2
56750732,1,"Reading, PA",9,2,0,0.0,Other gun,2
57181298,2,"Pueblo, CO",1,2,0,0.0,"Blunt object - hammer, club, etc",2
57403484,2,"Provo-Orem, UT",17,2,0,0.0,Weapon Not Reported,2
58300096,9,"Tampa-St. Petersburg-Clearwater, FL",1,2,0,0.0,"Blunt object - hammer, club, etc",2
58780515,1,"Rochester, MN",10,2,0,0.0,Other or type unknown,2
59104697,2,"Gainesville, FL",16,2,0,0.0,Strangulation - hanging,2
60027183,2,"Birmingham-Hoover, AL",17,2,0,0.0,Weapon Not Reported,2
60397987,1,"Charleston-North Charleston, SC",17,2,0,0.0,Weapon Not Reported,2
60890574,1,"Bridgeport-Stamford-Norwalk, CT",17,2,0,0.0,Weapon Not Reported,2
60981137,9,"Florence, SC",10,2,0,0.0,Other or type unknown,2
61067655,2,"Alexandria, LA",4,2,0,0.0,Fire,2
61734883,2,"Champaign-Urbana, IL",17,2,0,0.0,Weapon Not Reported,2
62123896,1,"Winston-Salem, NC",17,2,0,0.0,Weapon Not Reported,2
62388606,1,"Reading, PA",16,2,0,0.0,Strangulation - hanging,2
62957083,2,"Cleveland, TN",10,2,0,0.0,Other or type unknown,2
63051156,9,Rural Ohio,10,2,0,0.0,Other or type unknown,2
66175954,2,Rural Georgia,17,2,0,0.0,Weapon Not Reported,2
66642534,2,"Bakersfield, CA",2,2,0,0.0,Drowning,2
67019747,9,"New Orleans-Metairie-Kenner, LA",5,2,0,0.0,"Firearm, type not stated",2
69341327,9,"Riverside-San Bernardino, CA",15,2,0,0.0,Shotgun,2
70633984,2,"Huntington-Ashland, WV-KY-OH",0,2,0,0.0,Asphyxiation - includes death by gas,2
70817076,1,"South Bend-Mishawaka, IN-MI",4,2,0,0.0,Fire,2
70820911,9,"Riverside-San Bernardino, CA",7,2,0,0.0,Knife or cutting instrument,2
72181362,2,"Jackson, MS",2,2,0,0.0,Drowning,2
72221341,1,"Racine, WI",9,2,0,0.0,Other gun,2
72680131,2,"Grand Junction, CO",16,2,0,0.0,Strangulation - hanging,2
73867497,1,"Chattanooga, TN-GA",17,2,0,0.0,Weapon Not Reported,2
74200303,1,"Rapid City, SD",0,2,0,0.0,Asphyxiation - includes death by gas,2
76009995,2,"Columbia, MO",17,2,0,0.0,Weapon Not Reported,2
76537992,1,Rural Montana,4,2,0,0.0,Fire,2
76888850,9,"Gadsden, AL",10,2,0,0.0,Other or type unknown,2
77765315,2,"Abilene, TX",2,2,0,0.0,Drowning,2
81237191,2,Rural Iowa,17,2,0,0.0,Weapon Not Reported,2
81280096,9,"Bridgeport-Stamford-Norwalk, CT",6,2,0,0.0,"Handgun - pistol, revolver, etc",2
81517090,1,Rural New Mexico,9,2,0,0.0,Other gun,2
82141873,2,"Las Vegas-Paradise, NV",17,2,0,0.0,Weapon Not Reported,2
82188509,1,"Greeley, CO",17,2,0,0.0,Weapon Not Reported,2
83511426,1,"Laredo, TX",17,2,0,0.0,Weapon Not Reported,2
84315210,9,"Los Angeles-Long Beach, CA",4,2,0,0.0,Fire,2
84451271,2,"Tuscaloosa, AL",0,2,0,0.0,Asphyxiation - includes death by gas,2
85366193,9,"Raleigh-Cary, NC",10,2,0,0.0,Other or type unknown,2
85567718,1,"Port St. Lucie-Fort Pierce, FL",2,2,0,0.0,Drowning,2
86875711,9,"Peoria, IL",10,2,0,0.0,Other or type unknown,2
86933348,9,Rural Pennsylvania,6,2,0,0.0,"Handgun - pistol, revolver, etc",2
87031076,1,"Wilmington, NC",17,2,0,0.0,Weapon Not Reported,2
87648771,1,"Lafayette, IN",17,2,0,0.0,Weapon Not Reported,2
87686391,2,"Deltona-Daytona Beach-Ormond Beach, FL",16,2,0,0.0,Strangulation - hanging,2
87749910,2,"Baltimore-Towson, MD",17,2,0,0.0,Weapon Not Reported,2
89058540,1,"Jackson, TN",16,2,0,0.0,Strangulation - hanging,2
89316971,9,"Riverside-San Bernardino, CA",6,2,0,0.0,"Handgun - pistol, revolver, etc",2
89622681,9,"Youngstown-Warren-Boardman, OH-PA",6,2,0,0.0,"Handgun - pistol, revolver, etc",2
90469694,2,"Minneapolis-St. Paul-Bloomington, MN-WI",17,2,0,0.0,Weapon Not Reported,2
90933642,1,"Cumberland, MD-WV",4,2,0,0.0,Fire,2
91120695,2,Rural New York,9,2,0,0.0,Other gun,2
91400713,9,Rural Missouri,6,2,0,0.0,"Handgun - pistol, revolver, etc",2
94867964,9,Rural Texas,5,2,0,0.0,"Firearm, type not stated",2
94932460,1,"Anderson, SC",17,2,0,0.0,Weapon Not Reported,2
95115261,1,"Cedar Rapids, IA",17,2,0,0.0,Weapon Not Reported,2
95230994,2,"Pittsburgh, PA",3,2,0,0.0,Explosives,2
96399107,1,Rural Michigan,17,2,0,0.0,Weapon Not Reported,2
96918771,2,"McAllen-Edinburg-Mission, TX",17,2,0,0.0,Weapon Not Reported,2
98879061,9,"Pittsburgh, PA",6,2,0,0.0,"Handgun - pistol, revolver, etc",2
99220451,9,"Lafayette, LA",10,2,0,0.0,Other or type unknown,2
40784037,2,Rural Arkansas,14,76,75,0.9868421052631579,Rifle,1
72336039,2,Rural Oklahoma,15,67,66,0.9850746268656716,Shotgun,1
9969569,2,"Lake Charles, LA",6,63,62,0.9841269841269841,"Handgun - pistol, revolver, etc",1
17944654,2,Rural Missouri,14,62,61,0.9838709677419355,Rifle,1
64673736,1,"Greenville, SC",14,62,61,0.9838709677419355,Rifle,1
65232609,1,Rural Minnesota,14,62,61,0.9838709677419355,Rifle,1
99518988,2,"Kingsport-Bristol-Bristol, TN-VA",6,60,59,0.9833333333333333,"Handgun - pistol, revolver, etc",1
63771555,1,Rural Idaho,14,59,58,0.9830508474576272,Rifle,1
73462896,2,"Colorado Springs, CO",11,59,58,0.9830508474576272,"Personal weapons, includes beating",1
15568490,1,"Medford, OR",6,57,56,0.9824561403508771,"Handgun - pistol, revolver, etc",1
61917537,2,"Huntington-Ashland, WV-KY-OH",6,55,54,0.9818181818181818,"Handgun - pistol, revolver, etc",1
61353035,1,"Kalamazoo-Portage, MI",7,54,53,0.9814814814814815,Knife or cutting instrument,1
39035002,2,Rural New York,15,53,52,0.9811320754716981,Shotgun,1
30091746,2,"Minneapolis-St. Paul-Bloomington, MN-WI",15,51,50,0.9803921568627451,Shotgun,1
67848120,2,Rural Colorado,7,51,50,0.9803921568627451,Knife or cutting instrument,1
98667454,1,"Kingsport-Bristol-Bristol, TN-VA",7,51,50,0.9803921568627451,Knife or cutting instrument,1
28650484,2,"Brownsville-Harlingen, TX",6,49,48,0.9795918367346939,"Handgun - pistol, revolver, etc",1
44595777,1,"El Paso, TX",14,49,48,0.9795918367346939,Rifle,1
30697773,2,Rural Florida,15,48,47,0.9791666666666666,Shotgun,1
47601726,1,Rural Kansas,14,48,47,0.9791666666666666,Rifle,1
30909310,2,"Kennewick-Richland-Pasco, WA",6,47,46,0.9787234042553191,"Handgun - pistol, revolver, etc",1
41422442,2,"Panama City-Lynn Haven, FL",6,47,46,0.9787234042553191,"Handgun - pistol, revolver, etc",1
4145756,1,Rural Maine,7,46,45,0.9782608695652174,Knife or cutting instrument,1
41066247,2,"Richmond, VA",14,46,45,0.9782608695652174,Rifle,1
47121713,1,"Omaha-Council Bluffs, NE-IA",11,46,45,0.9782608695652174,"Personal weapons, includes beating",1
26987519,2,"Palm Bay-Melbourne-Titusville, FL",11,45,44,0.9777777777777777,"Personal weapons, includes beating",1
30620092,2,Rural Utah,6,45,44,0.9777777777777777,"Handgun - pistol, revolver, etc",1
42833486,2,Rural West Virginia,11,45,44,0.9777777777777777,"Personal weapons, includes beating",1
99373353,2,"College Station-Bryan, TX",6,45,44,0.9777777777777777,"Handgun - pistol, revolver, etc",1
80100066,2,Rural Vermont,6,44,43,0.9772727272727273,"Handgun - pistol, revolver, etc",1
17037243,1,Rural Iowa,11,43,42,0.9767441860465116,"Personal weapons, includes beating",1
14274199,1,"Kingsport-Bristol-Bristol, TN-VA",15,42,41,0.9761904761904762,Shotgun,1
15201973,2,"Tulsa, OK",15,42,41,0.9761904761904762,Shotgun,1
28837077,1,"Tallahassee, FL",15,42,41,0.9761904761904762,Shotgun,1
24767133,2,Rural Oregon,14,41,40,0.975609756097561,Rifle,1
91346345,1,"Morristown, TN",6,41,40,0.975609756097561,"Handgun - pistol, revolver, etc",1
95554825,2,"Corpus Christi, TX",11,41,40,0.975609756097561,"Personal weapons, includes beating",1
22216583,2,Rural Wisconsin,15,40,39,0.975,Shotgun,1
47112872,2,"Blacksburg-Christiansburg, VA",6,40,39,0.975,"Handgun - pistol, revolver, etc",1
73850787,1,"Lexington-Fayette, KY",15,40,39,0.975,Shotgun,1
33800975,1,"Kennewick-Richland-Pasco, WA",7,39,38,0.9743589743589743,Knife or cutting instrument,1
39499227,2,"Charlottesville, VA",6,39,38,0.9743589743589743,"Handgun - pistol, revolver, etc",1
39470292,1,"Minneapolis-St. Paul-Bloomington, MN-WI",8,37,36,0.972972972972973,"Narcotics or drugs, sleeping pills",1
39963472,2,"Portland-South Portland-Biddeford, ME",6,37,36,0.972972972972973,"Handgun - pistol, revolver, etc",1
51467187,1,"Springfield, MO",14,37,36,0.972972972972973,Rifle,1
90374668,1,"Macon, GA",11,37,36,0.972972972972973,"Personal weapons, includes beating",1
13959547,1,"Lexington-Fayette, KY",11,36,35,0.9722222222222222,"Personal weapons, includes beating",1
28335504,2,"Eugene-Springfield, OR",6,36,35,0.9722222222222222,"Handgun - pistol, revolver, etc",1
31263331,2,Rural North Dakota,6,36,35,0.9722222222222222,"Handgun - pistol, revolver, etc",1
36942999,2,Rural Iowa,15,36,35,0.9722222222222222,Shotgun,1
93206096,1,"Coeur d Alene, ID",6,36,35,0.9722222222222222,"Handgun - pistol, revolver, etc",1
29081089,1,"Boulder, CO",7,35,34,0.9714285714285714,Knife or cutting instrument,1
62290693,2,"Midland, TX",6,35,34,0.9714285714285714,"Handgun - pistol, revolver, etc",1
80471694,2,"Fort Collins-Loveland, CO",6,35,34,0.9714285714285714,"Handgun - pistol, revolver, etc",1
19906869,2,Rural Indiana,14,34,33,0.9705882352941176,Rifle,1
25617788,1,"Colorado Springs, CO",14,34,33,0.9705882352941176,Rifle,1
36367397,1,Rural Colorado,15,34,33,0.9705882352941176,Shotgun,1
74541636,1,"Parkersburg-Marietta-Vienna, WV-OH",6,34,33,0.9705882352941176,"Handgun - pistol, revolver, etc",1
7202937,2,"Greenville, SC",15,33,32,0.9696969696969697,Shotgun,1
11764313,2,Rural Nebraska,11,33,32,0.9696969696969697,"Personal weapons, includes beating",1
50359788,1,"Great Falls, MT",6,33,32,0.9696969696969697,"Handgun - pistol, revolver, etc",1
58852614,1,"Lawton, OK",11,33,32,0.9696969696969697,"Personal weapons, includes beating",1
4672269,1,"Warner Robins, GA",7,32,31,0.96875,Knife or cutting instrument,1
18733870,1,"Odessa, TX",14,32,31,0.96875,Rifle,1
39644736,1,"Raleigh-Cary, NC",5,32,31,0.96875,"Firearm, type not stated",1
60538333,1,"Sioux Falls, SD",6,32,31,0.96875,"Handgun - pistol, revolver, etc",1
60565827,1,Rural Maryland,11,32,31,0.96875,"Personal weapons, includes beating",1
67578156,2,"Albany, GA",7,32,31,0.96875,Knife or cutting instrument,1
70126261,1,Rural Nebraska,15,32,31,0.96875,Shotgun,1
83684686,1,"Hagerstown-Martinsburg, MD-WV",11,32,31,0.96875,"Personal weapons, includes beating",1
84259121,2,"Charleston-North Charleston, SC",1,32,31,0.96875,"Blunt object - hammer, club, etc",1
389839,1,"Fayetteville-Springdale-Rogers, AR-MO",14,31,30,0.967741935483871,Rifle,1
56395639,2,"Athens-Clarke County, GA",6,31,30,0.967741935483871,"Handgun - pistol, revolver, etc",1
77904011,1,"Florence-Muscle Shoals, AL",15,31,30,0.967741935483871,Shotgun,1
93644520,1,Rural Illinois,14,31,30,0.967741935483871,Rifle,1
3074889,1,Rural Hawaii,15,30,29,0.9666666666666667,Shotgun,1
10838399,1,"Springfield, MO",15,30,29,0.9666666666666667,Shotgun,1
12685064,1,Rural South Dakota,11,30,29,0.9666666666666667,"Personal weapons, includes beating",1
30949447,2,"Medford, OR",6,30,29,0.9666666666666667,"Handgun - pistol, revolver, etc",1
13666902,1,"San Antonio, TX",0,29,28,0.9655172413793104,Asphyxiation - includes death by gas,1
26829455,2,"Cleveland-Elyria-Mentor, OH",14,29,28,0.9655172413793104,Rifle,1
30703742,1,"Allentown-Bethlehem-Easton, PA-NJ",14,29,28,0.9655172413793104,Rifle,1
37935841,1,"Florence, SC",11,29,28,0.9655172413793104,"Personal weapons, includes beating",1
46206976,2,"Tampa-St. Petersburg-Clearwater, FL",14,29,28,0.9655172413793104,Rifle,1
53400106,2,"Rocky Mount, NC",7,29,28,0.9655172413793104,Knife or cutting instrument,1
76174519,1,"Phoenix-Mesa-Scottsdale, AZ",8,29,28,0.9655172413793104,"Narcotics or drugs, sleeping pills",1
84245245,2,"Brownsville-Harlingen, TX",7,29,28,0.9655172413793104,Knife or cutting instrument,1
90982035,1,"Providence-New Bedford-Fall River, RI-MA",14,29,28,0.9655172413793104,Rifle,1
94072292,1,Rural Tennessee,8,29,28,0.9655172413793104,"Narcotics or drugs, sleeping pills",1
7431279,2,"Davenport-Moline-Rock Island, IA-IL",6,28,27,0.9642857142857143,"Handgun - pistol, revolver, etc",1
10781651,1,"Tyler, TX",14,28,27,0.9642857142857143,Rifle,1
31971093,1,"Scranton--Wilkes-Barre, PA",15,28,27,0.9642857142857143,Shotgun,1
49157159,1,"Green Bay, WI",7,28,27,0.9642857142857143,Knife or cutting instrument,1
60147176,1,"Charleston, WV",11,28,27,0.9642857142857143,"Personal weapons, includes beating",1
60737506,1,"Worcester, MA",11,28,27,0.9642857142857143,"Personal weapons, includes beating",1
6735830,1,"Spartanburg, SC",14,27,26,0.9629629629629629,Rifle,1
8704324,2,"Columbia, MO",6,27,26,0.9629629629629629,"Handgun - pistol, revolver, etc",1
23317420,2,"Farmington, NM",6,27,26,0.9629629629629629,"Handgun - pistol, revolver, etc",1
25389149,2,"Boulder, CO",6,27,26,0.9629629629629629,"Handgun - pistol, revolver, etc",1
29349255,1,"Eau Claire, WI",6,27,26,0.9629629629629629,"Handgun - pistol, revolver, etc",1
31802529,1,"Roanoke, VA",14,27,26,0.9629629629629629,Rifle,1
38044835,1,"Bangor, ME",6,27,26,0.9629629629629629,"Handgun - pistol, revolver, etc",1
69880036,1,"Roanoke, VA",10,27,26,0.9629629629629629,Other or type unknown,1
78762094,1,Rural Idaho,11,27,26,0.9629629629629629,"Personal weapons, includes beating",1
388430,2,"Champaign-Urbana, IL",6,26,25,0.9615384615384616,"Handgun - pistol, revolver, etc",1
27477149,2,"Las Cruces, NM",6,26,25,0.9615384615384616,"Handgun - pistol, revolver, etc",1
28723316,2,"Peoria, IL",7,26,25,0.9615384615384616,Knife or cutting instrument,1
40722353,2,Rural Montana,10,26,25,0.9615384615384616,Other or type unknown,1
45421941,2,"Boston-Cambridge-Quincy, MA-NH",14,26,25,0.9615384615384616,Rifle,1
46034471,1,"Davenport-Moline-Rock Island, IA-IL",11,26,25,0.9615384615384616,"Personal weapons, includes beating",1
51487996,1,"Manchester-Nashua, NH",11,26,25,0.9615384615384616,"Personal weapons, includes beating",1
52173165,2,"Montgomery, AL",15,26,25,0.9615384615384616,Shotgun,1
58405117,1,"Texarkana, TX-Texarkana, AR",15,26,25,0.9615384615384616,Shotgun,1
89721814,1,"Spokane, WA",14,26,25,0.9615384615384616,Rifle,1
19279916,1,"Cincinnati-Middletown, OH-KY-IN",8,25,24,0.96,"Narcotics or drugs, sleeping pills",1
90284651,1,Rural Montana,1,25,24,0.96,"Blunt object - hammer, club, etc",1
23508240,1,"Champaign-Urbana, IL",7,24,23,0.9583333333333334,Knife or cutting instrument,1
33568257,2,"Grand Junction, CO",6,24,23,0.9583333333333334,"Handgun - pistol, revolver, etc",1
50566155,1,"Davenport-Moline-Rock Island, IA-IL",10,24,23,0.9583333333333334,Other or type unknown,1
72194481,2,"St. Joseph, MO-KS",6,24,23,0.9583333333333334,"Handgun - pistol, revolver, etc",1
81342923,1,"Vero Beach, FL",7,24,23,0.9583333333333334,Knife or cutting instrument,1
87189098,2,Rural Vermont,14,24,23,0.9583333333333334,Rifle,1
91396583,1,"Burlington, NC",14,24,23,0.9583333333333334,Rifle,1
95142114,2,Rural South Carolina,4,24,23,0.9583333333333334,Fire,1
9382051,2,"Topeka, KS",7,23,22,0.9565217391304348,Knife or cutting instrument,1
24933445,1,"Lancaster, PA",11,23,22,0.9565217391304348,"Personal weapons, includes beating",1
28897431,1,"Joplin, MO",11,23,22,0.9565217391304348,"Personal weapons, includes beating",1
33470172,2,"Youngstown-Warren-Boardman, OH-PA",15,23,22,0.9565217391304348,Shotgun,1
36767568,1,"Dalton, GA",7,23,22,0.9565217391304348,Knife or cutting instrument,1
45307025,2,Rural Kansas,14,23,22,0.9565217391304348,Rifle,1
46659979,1,"Flagstaff, AZ",11,23,22,0.9565217391304348,"Personal weapons, includes beating",1
51331436,1,"Lafayette, IN",7,23,22,0.9565217391304348,Knife or cutting instrument,1
55617122,2,"Cleveland, TN",6,23,22,0.9565217391304348,"Handgun - pistol, revolver, etc",1
62038294,1,"Brownsville-Harlingen, TX",11,23,22,0.9565217391304348,"Personal weapons, includes beating",1
65409543,1,"Lynchburg, VA",14,23,22,0.9565217391304348,Rifle,1
77951817,1,"Madison, WI",14,23,22,0.9565217391304348,Rifle,1
85121250,1,"Saginaw, MI",11,23,22,0.9565217391304348,"Personal weapons, includes beating",1
87019616,2,"Worcester, MA",6,23,22,0.9565217391304348,"Handgun - pistol, revolver, etc",1
1796573,1,"Huntsville, AL",11,22,21,0.9545454545454546,"Personal weapons, includes beating",1
8717978,1,"Battle Creek, MI",11,22,21,0.9545454545454546,"Personal weapons, includes beating",1
12793415,1,"Fort Collins-Loveland, CO",5,22,21,0.9545454545454546,"Firearm, type not stated",1
22920829,2,Rural Delaware,6,22,21,0.9545454545454546,"Handgun - pistol, revolver, etc",1
23425952,2,"Boise City-Nampa, ID",11,22,21,0.9545454545454546,"Personal weapons, includes beating",1
27302593,1,"Danville, VA",15,22,21,0.9545454545454546,Shotgun,1
32817852,1,"Milwaukee-Waukesha-West Allis, WI",0,22,21,0.9545454545454546,Asphyxiation - includes death by gas,1
41254322,2,Rural New Mexico,14,22,21,0.9545454545454546,Rifle,1
42692637,2,"Raleigh-Cary, NC",14,22,21,0.9545454545454546,Rifle,1
47407365,2,"Laredo, TX",7,22,21,0.9545454545454546,Knife or cutting instrument,1
88780138,2,Rural Florida,14,22,21,0.9545454545454546,Rifle,1
8888591,2,"Lynchburg, VA",7,21,20,0.9523809523809523,Knife or cutting instrument,1
18022512,2,"Medford, OR",7,21,20,0.9523809523809523,Knife or cutting instrument,1
28208454,1,"Morristown, TN",15,21,20,0.9523809523809523,Shotgun,1
31418046,2,Rural Nevada,7,21,20,0.9523809523809523,Knife or cutting instrument,1
35978735,1,"Hattiesburg, MS",15,21,20,0.9523809523809523,Shotgun,1
36596736,1,"Lake Charles, LA",11,21,20,0.9523809523809523,"Personal weapons, includes beating",1
44169603,2,"Bloomington, IN",6,21,20,0.9523809523809523,"Handgun - pistol, revolver, etc",1
46310028,2,"Morgantown, WV",6,21,20,0.9523809523809523,"Handgun - pistol, revolver, etc",1
53479839,2,"Roanoke, VA",11,21,20,0.9523809523809523,"Personal weapons, includes beating",1
54402344,2,"Denver-Aurora, CO",8,21,20,0.9523809523809523,"Narcotics or drugs, sleeping pills",1
78277433,1,"Redding, CA",15,21,20,0.9523809523809523,Shotgun,1
82589786,1,Rural Montana,15,21,20,0.9523809523809523,Shotgun,1
89219448,1,"Sandusky, OH",6,21,20,0.9523809523809523,"Handgun - pistol, revolver, etc",1
89732744,2,"Louisville, KY-IN",15,21,20,0.9523809523809523,Shotgun,1
91007009,1,"Palm Bay-Melbourne-Titusville, FL",14,21,20,0.9523809523809523,Rifle,1
7607450,2,"Asheville, NC",11,20,19,0.95,"Personal weapons, includes beating",1
8600743,2,Rural Alaska,15,20,19,0.95,Shotgun,1
22334445,2,"Augusta-Richmond County, GA-SC",14,20,19,0.95,Rifle,1
23512416,1,"Fort Smith, AR-OK",1,20,19,0.95,"Blunt object - hammer, club, etc",1
23821447,1,"Fayetteville-Springdale-Rogers, AR-MO",15,20,19,0.95,Shotgun,1
36417591,2,"Knoxville, TN",15,20,19,0.95,Shotgun,1
37197868,1,"Texarkana, TX-Texarkana, AR",11,20,19,0.95,"Personal weapons, includes beating",1
46952575,2,"Dalton, GA",6,20,19,0.95,"Handgun - pistol, revolver, etc",1
48720231,2,"Green Bay, WI",6,20,19,0.95,"Handgun - pistol, revolver, etc",1
52257007,1,"Huntsville, AL",14,20,19,0.95,Rifle,1
71906636,2,"Mobile, AL",14,20,19,0.95,Rifle,1
80398729,2,"Columbia, SC",14,20,19,0.95,Rifle,1
88411721,2,"Fairbanks, AK",6,20,19,0.95,"Handgun - pistol, revolver, etc",1
91306222,1,"Grand Junction, CO",11,20,19,0.95,"Personal weapons, includes beating",1
2147218,1,"Lexington-Fayette, KY",14,19,18,0.9473684210526315,Rifle,1
13561085,2,"Fayetteville-Springdale-Rogers, AR-MO",11,19,18,0.9473684210526315,"Personal weapons, includes beating",1
23005303,1,"Ocean City, NJ",6,19,18,0.9473684210526315,"Handgun - pistol, revolver, etc",1
45849504,1,"Naples-Marco Island, FL",14,19,18,0.9473684210526315,Rifle,1
48502615,1,"Ocala, FL",14,19,18,0.9473684210526315,Rifle,1
49538046,2,"Poughkeepsie-Newburgh-Middletown, NY",15,19,18,0.9473684210526315,Shotgun,1
55351657,1,"Panama City-Lynn Haven, FL",5,19,18,0.9473684210526315,"Firearm, type not stated",1
69078003,1,Rural North Dakota,14,19,18,0.9473684210526315,Rifle,1
70161882,1,Rural Arkansas,4,19,18,0.9473684210526315,Fire,1
73697500,1,"Kingsport-Bristol-Bristol, TN-VA",1,19,18,0.9473684210526315,"Blunt object - hammer, club, etc",1
76856928,1,"Greeley, CO",11,19,18,0.9473684210526315,"Personal weapons, includes beating",1
81303816,2,"Rocky Mount, NC",15,19,18,0.9473684210526315,Shotgun,1
85367686,1,"Gainesville, FL",11,19,18,0.9473684210526315,"Personal weapons, includes beating",1
87518755,2,"Jackson, MI",7,19,18,0.9473684210526315,Knife or cutting instrument,1
88181938,1,"Niles-Benton Harbor, MI",15,19,18,0.9473684210526315,Shotgun,1
93797117,1,Rural Utah,15,19,18,0.9473684210526315,Shotgun,1
93830863,1,Rural West Virginia,4,19,18,0.9473684210526315,Fire,1
96207744,2,"Kalamazoo-Portage, MI",5,19,18,0.9473684210526315,"Firearm, type not stated",1
97912322,2,"Durham, NC",15,19,18,0.9473684210526315,Shotgun,1
98737735,1,"Binghamton, NY",11,19,18,0.9473684210526315,"Personal weapons, includes beating",1
1785550,1,"Eugene-Springfield, OR",11,18,17,0.9444444444444444,"Personal weapons, includes beating",1
2284996,2,"Dothan, AL",11,18,17,0.9444444444444444,"Personal weapons, includes beating",1
3792090,2,"Longview, TX",14,18,17,0.9444444444444444,Rifle,1
14252071,1,"Hot Springs, AR",14,18,17,0.9444444444444444,Rifle,1
23458700,2,"Brunswick, GA",7,18,17,0.9444444444444444,Knife or cutting instrument,1
28762197,2,"Coeur d Alene, ID",6,18,17,0.9444444444444444,"Handgun - pistol, revolver, etc",1
34956538,2,"Syracuse, NY",14,18,17,0.9444444444444444,Rifle,1
37939571,2,"Jacksonville, NC",7,18,17,0.9444444444444444,Knife or cutting instrument,1
39869968,2,"Anderson, SC",11,18,17,0.9444444444444444,"Personal weapons, includes beating",1
46093796,1,"Utica-Rome, NY",14,18,17,0.9444444444444444,Rifle,1
55421920,2,"Wilmington, NC",15,18,17,0.9444444444444444,Shotgun,1
57540257,1,"Provo-Orem, UT",7,18,17,0.9444444444444444,Knife or cutting instrument,1
57728020,1,"Kennewick-Richland-Pasco, WA",14,18,17,0.9444444444444444,Rifle,1
65971662,2,"Mansfield, OH",11,18,17,0.9444444444444444,"Personal weapons, includes beating",1
67666233,2,"Charleston, WV",1,18,17,0.9444444444444444,"Blunt object - hammer, club, etc",1
79262518,1,"Victoria, TX",14,18,17,0.9444444444444444,Rifle,1
81215364,2,Rural Nebraska,1,18,17,0.9444444444444444,"Blunt object - hammer, club, etc",1
82530483,2,"Cedar Rapids, IA",6,18,17,0.9444444444444444,"Handgun - pistol, revolver, etc",1
1756802,1,"Springfield, OH",11,17,16,0.9411764705882353,"Personal weapons, includes beating",1
4738013,1,"Lewiston-Auburn, ME",7,17,16,0.9411764705882353,Knife or cutting instrument,1
4905289,1,"Akron, OH",8,17,16,0.9411764705882353,"Narcotics or drugs, sleeping pills",1
8681881,2,"Springfield, MO",11,17,16,0.9411764705882353,"Personal weapons, includes beating",1
9277810,2,"Kingsport-Bristol-Bristol, TN-VA",14,17,16,0.9411764705882353,Rifle,1
16596320,1,"Fargo, ND-MN",7,17,16,0.9411764705882353,Knife or cutting instrument,1
17181933,1,Rural Vermont,15,17,16,0.9411764705882353,Shotgun,1
20549451,1,"Albany, GA",14,17,16,0.9411764705882353,Rifle,1
21178950,2,"New Haven-Milford, CT",14,17,16,0.9411764705882353,Rifle,1
32909607,2,"Lynchburg, VA",10,17,16,0.9411764705882353,Other or type unknown,1
33510101,1,"Harrisonburg, VA",7,17,16,0.9411764705882353,Knife or cutting instrument,1
41625264,1,"Jackson, TN",1,17,16,0.9411764705882353,"Blunt object - hammer, club, etc",1
42594629,2,Rural Washington,15,17,16,0.9411764705882353,Shotgun,1
44884957,1,"Albany-Schenectady-Troy, NY",4,17,16,0.9411764705882353,Fire,1
46681552,1,"Farmington, NM",11,17,16,0.9411764705882353,"Personal weapons, includes beating",1
48612355,1,"Brunswick, GA",15,17,16,0.9411764705882353,Shotgun,1
50450608,1,"Hot Springs, AR",15,17,16,0.9411764705882353,Shotgun,1
60185847,2,"Des Moines, IA",15,17,16,0.9411764705882353,Shotgun,1
77359329,1,"College Station-Bryan, TX",14,17,16,0.9411764705882353,Rifle,1
78052589,1,"Sioux Falls, SD",5,17,16,0.9411764705882353,"Firearm, type not stated",1
80148113,2,"Lansing-East Lansing, MI",15,17,16,0.9411764705882353,Shotgun,1
86319675,2,"Canton-Massillon, OH",11,17,16,0.9411764705882353,"Personal weapons, includes beating",1
87191174,1,"Provo-Orem, UT",11,17,16,0.9411764705882353,"Personal weapons, includes beating",1
87609422,2,"Panama City-Lynn Haven, FL",11,17,16,0.9411764705882353,"Personal weapons, includes beating",1
90353137,2,"Columbus, GA-AL",15,17,16,0.9411764705882353,Shotgun,1
92583947,2,Rural Washington,8,17,16,0.9411764705882353,"Narcotics or drugs, sleeping pills",1
95777038,1,"Fort Walton Beach-Destin, FL",15,17,16,0.9411764705882353,Shotgun,1
7038086,1,"Kokomo, IN",7,16,15,0.9375,Knife or cutting instrument,1
10926825,2,"Little Rock-North Little Rock, AR",4,16,15,0.9375,Fire,1
25176473,1,"Tampa-St. Petersburg-Clearwater, FL",8,16,15,0.9375,"Narcotics or drugs, sleeping pills",1
33877310,2,"Lawton, OK",11,16,15,0.9375,"Personal weapons, includes beating",1
44867787,1,"Carson City, NV",6,16,15,0.9375,"Handgun - pistol, revolver, etc",1
47261676,1,"El Centro, CA",15,16,15,0.9375,Shotgun,1
48503320,1,"Parkersburg-Marietta-Vienna, WV-OH",7,16,15,0.9375,Knife or cutting instrument,1
53405661,1,"Lafayette, LA",14,16,15,0.9375,Rifle,1
55048911,2,Rural Wisconsin,8,16,15,0.9375,"Narcotics or drugs, sleeping pills",1
58678227,2,"Clarksville, TN-KY",11,16,15,0.9375,"Personal weapons, includes beating",1
63035554,2,"Bellingham, WA",6,16,15,0.9375,"Handgun - pistol, revolver, etc",1
64244457,2,"Jefferson City, MO",6,16,15,0.9375,"Handgun - pistol, revolver, etc",1
66024370,2,"Lincoln, NE",10,16,15,0.9375,Other or type unknown,1
73497966,1,"Greeley, CO",1,16,15,0.9375,"Blunt object - hammer, club, etc",1
73867285,2,"Pine Bluff, AR",14,16,15,0.9375,Rifle,1
78413283,1,"Poughkeepsie-Newburgh-Middletown, NY",14,16,15,0.9375,Rifle,1
83470241,2,"Sarasota-Bradenton-Venice, FL",15,16,15,0.9375,Shotgun,1
83552307,1,Rural Texas,8,16,15,0.9375,"Narcotics or drugs, sleeping pills",1
88066742,2,"Modesto, CA",1,16,15,0.9375,"Blunt object - hammer, club, etc",1
89531324,2,"Toledo, OH",4,16,15,0.9375,Fire,1
89633553,2,Rural Wisconsin,0,16,15,0.9375,Asphyxiation - includes death by gas,1
89986383,2,"Janesville, WI",6,16,15,0.9375,"Handgun - pistol, revolver, etc",1
90609067,1,"Clarksville, TN-KY",11,16,15,0.9375,"Personal weapons, includes beating",1
98956650,1,"Virginia Beach-Norfolk-Newport News, VA-NC",0,16,15,0.9375,Asphyxiation - includes death by gas,1
18933446,2,"Yuma, AZ",11,15,14,0.9333333333333333,"Personal weapons, includes beating",1
21477216,2,"Warner Robins, GA",7,15,14,0.9333333333333333,Knife or cutting instrument,1
23101013,1,"Charlottesville, VA",11,15,14,0.9333333333333333,"Personal weapons, includes beating",1
26303406,1,"Goldsboro, NC",14,15,14,0.9333333333333333,Rifle,1
27837844,1,"Pensacola-Ferry Pass-Brent, FL",14,15,14,0.9333333333333333,Rifle,1
31930058,1,"Duluth, MN-WI",10,15,14,0.9333333333333333,Other or type unknown,1
42750953,1,"Jacksonville, NC",15,15,14,0.9333333333333333,Shotgun,1
42822755,1,"Jacksonville, NC",14,15,14,0.9333333333333333,Rifle,1
44915715,2,"Abilene, TX",11,15,14,0.9333333333333333,"Personal weapons, includes beating",1
49033367,2,"St. George, UT",6,15,14,0.9333333333333333,"Handgun - pistol, revolver, etc",1
50344945,2,"Milwaukee-Waukesha-West Allis, WI",8,15,14,0.9333333333333333,"Narcotics or drugs, sleeping pills",1
58375172,2,"Rapid City, SD",11,15,14,0.9333333333333333,"Personal weapons, includes beating",1
59386468,2,"Davenport-Moline-Rock Island, IA-IL",10,15,14,0.9333333333333333,Other or type unknown,1
61273465,2,Rural Colorado,15,15,14,0.9333333333333333,Shotgun,1
62851608,2,"Charleston-North Charleston, SC",14,15,14,0.9333333333333333,Rifle,1
65597806,1,"Medford, OR",14,15,14,0.9333333333333333,Rifle,1
68941269,1,"Boulder, CO",11,15,14,0.9333333333333333,"Personal weapons, includes beating",1
70404802,2,Rural Louisiana,4,15,14,0.9333333333333333,Fire,1
72430214,2,"Oxnard-Thousand Oaks-Ventura, CA",14,15,14,0.9333333333333333,Rifle,1
73920846,2,"Peoria, IL",11,15,14,0.9333333333333333,"Personal weapons, includes beating",1
74266151,1,"New Haven-Milford, CT",0,15,14,0.9333333333333333,Asphyxiation - includes death by gas,1
74438393,2,"McAllen-Edinburg-Mission, TX",14,15,14,0.9333333333333333,Rifle,1
75320784,1,"San Angelo, TX",11,15,14,0.9333333333333333,"Personal weapons, includes beating",1
82989412,2,"Asheville, NC",14,15,14,0.9333333333333333,Rifle,1
83176508,1,"Billings, MT",11,15,14,0.9333333333333333,"Personal weapons, includes beating",1
83715508,1,"Chicago-Naperville-Joliet, IL-IN-WI",13,15,14,0.9333333333333333,Pushed or thrown out window,1
98063761,2,"Wenatchee, WA",6,15,14,0.9333333333333333,"Handgun - pistol, revolver, etc",1
98807256,1,"Hinesville-Fort Stewart, GA",7,15,14,0.9333333333333333,Knife or cutting instrument,1
98948494,2,"Charleston-North Charleston, SC",0,15,14,0.9333333333333333,Asphyxiation - includes death by gas,1
4257771,1,"Fargo, ND-MN",11,14,13,0.9285714285714286,"Personal weapons, includes beating",1
5008411,2,Rural North Dakota,7,14,13,0.9285714285714286,Knife or cutting instrument,1
5563341,2,"Lynchburg, VA",11,14,13,0.9285714285714286,"Personal weapons, includes beating",1
10573413,1,"Springfield, MA",4,14,13,0.9285714285714286,Fire,1
10943767,2,"Chattanooga, TN-GA",15,14,13,0.9285714285714286,Shotgun,1
11239148,2,"Allentown-Bethlehem-Easton, PA-NJ",16,14,13,0.9285714285714286,Strangulation - hanging,1
11853054,2,"Lebanon, PA",6,14,13,0.9285714285714286,"Handgun - pistol, revolver, etc",1
14124431,1,"Victoria, TX",11,14,13,0.9285714285714286,"Personal weapons, includes beating",1
17427869,1,"Kansas City, MO-KS",8,14,13,0.9285714285714286,"Narcotics or drugs, sleeping pills",1
19180977,1,"Santa Cruz-Watsonville, CA",11,14,13,0.9285714285714286,"Personal weapons, includes beating",1
20423813,2,Rural New York,16,14,13,0.9285714285714286,Strangulation - hanging,1
21452187,2,"Midland, TX",7,14,13,0.9285714285714286,Knife or cutting instrument,1
23434778,1,"Ithaca, NY",7,14,13,0.9285714285714286,Knife or cutting instrument,1
33368970,1,"Muskegon-Norton Shores, MI",14,14,13,0.9285714285714286,Rifle,1
34691264,1,Rural New Hampshire,14,14,13,0.9285714285714286,Rifle,1
39801103,1,"Lincoln, NE",1,14,13,0.9285714285714286,"Blunt object - hammer, club, etc",1
43905877,1,"Prescott, AZ",11,14,13,0.9285714285714286,"Personal weapons, includes beating",1
45814886,2,"Charlotte-Gastonia-Concord, NC-SC",8,14,13,0.9285714285714286,"Narcotics or drugs, sleeping pills",1
51791935,1,"Dallas-Fort Worth-Arlington, TX",2,14,13,0.9285714285714286,Drowning,1
52698189,2,"Monroe, LA",11,14,13,0.9285714285714286,"Personal weapons, includes beating",1
61927666,2,"Florence, SC",1,14,13,0.9285714285714286,"Blunt object - hammer, club, etc",1
64576733,2,"Fort Smith, AR-OK",15,14,13,0.9285714285714286,Shotgun,1
65438415,1,"Lawton, OK",1,14,13,0.9285714285714286,"Blunt object - hammer, club, etc",1
70559530,2,"San Francisco-Oakland-Fremont, CA",2,14,13,0.9285714285714286,Drowning,1
71646216,1,"Racine, WI",15,14,13,0.9285714285714286,Shotgun,1
74002234,2,"Pine Bluff, AR",11,14,13,0.9285714285714286,"Personal weapons, includes beating",1
76534313,1,Rural Nevada,1,14,13,0.9285714285714286,"Blunt object - hammer, club, etc",1
88141109,2,"Naples-Marco Island, FL",11,14,13,0.9285714285714286,"Personal weapons, includes beating",1
88631368,1,"Rapid City, SD",11,14,13,0.9285714285714286,"Personal weapons, includes beating",1
91858756,1,"Erie, PA",15,14,13,0.9285714285714286,Shotgun,1
97287386,2,"Salt Lake City, UT",15,14,13,0.9285714285714286,Shotgun,1
98922870,1,"Anderson, SC",11,14,13,0.9285714285714286,"Personal weapons, includes beating",1
99020046,2,Rural Connecticut,7,14,13,0.9285714285714286,Knife or cutting instrument,1
1409597,1,"Hartford, CT",4,13,12,0.9230769230769231,Fire,1
4169313,1,"Pittsfield, MA",7,13,12,0.9230769230769231,Knife or cutting instrument,1
4844746,2,"Blacksburg-Christiansburg, VA",7,13,12,0.9230769230769231,Knife or cutting instrument,1
7636495,1,"Reno-Sparks, NV",4,13,12,0.9230769230769231,Fire,1
14018139,2,"Chico, CA",11,13,12,0.9230769230769231,"Personal weapons, includes beating",1
15247014,1,"Monroe, MI",7,13,12,0.9230769230769231,Knife or cutting instrument,1
19293408,2,"Jackson, TN",7,13,12,0.9230769230769231,Knife or cutting instrument,1
19498290,2,"Fort Walton Beach-Destin, FL",11,13,12,0.9230769230769231,"Personal weapons, includes beating",1
22117888,2,Rural Maryland,1,13,12,0.9230769230769231,"Blunt object - hammer, club, etc",1
23360319,2,"Barnstable Town, MA",6,13,12,0.9230769230769231,"Handgun - pistol, revolver, etc",1
26242971,1,"Wilmington, NC",1,13,12,0.9230769230769231,"Blunt object - hammer, club, etc",1
28538949,1,"Port St. Lucie-Fort Pierce, FL",14,13,12,0.9230769230769231,Rifle,1
31596438,2,"Allentown-Bethlehem-Easton, PA-NJ",15,13,12,0.9230769230769231,Shotgun,1
34818778,2,Rural Idaho,15,13,12,0.9230769230769231,Shotgun,1
37948644,2,"Lima, OH",7,13,12,0.9230769230769231,Knife or cutting instrument,1
38838836,1,"Peoria, IL",15,13,12,0.9230769230769231,Shotgun,1
39924659,1,"Ocala, FL",15,13,12,0.9230769230769231,Shotgun,1
41226001,2,"Charlottesville, VA",7,13,12,0.9230769230769231,Knife or cutting instrument,1
43788984,1,"College Station-Bryan, TX",11,13,12,0.9230769230769231,"Personal weapons, includes beating",1
43843853,2,"Jackson, MS",14,13,12,0.9230769230769231,Rifle,1
45168926,2,"Sioux Falls, SD",7,13,12,0.9230769230769231,Knife or cutting instrument,1
45596851,2,"Niles-Benton Harbor, MI",11,13,12,0.9230769230769231,"Personal weapons, includes beating",1
45599815,2,"Santa Barbara-Santa Maria, CA",10,13,12,0.9230769230769231,Other or type unknown,1
47094665,1,"Idaho Falls, ID",7,13,12,0.9230769230769231,Knife or cutting instrument,1
51153542,2,"Tampa-St. Petersburg-Clearwater, FL",8,13,12,0.9230769230769231,"Narcotics or drugs, sleeping pills",1
51515948,2,"Alexandria, LA",15,13,12,0.9230769230769231,Shotgun,1
61977627,2,Rural Oregon,0,13,12,0.9230769230769231,Asphyxiation - includes death by gas,1
63182582,1,"Hattiesburg, MS",14,13,12,0.9230769230769231,Rifle,1
64294582,2,"Odessa, TX",11,13,12,0.9230769230769231,"Personal weapons, includes beating",1
69200093,2,"Kennewick-Richland-Pasco, WA",11,13,12,0.9230769230769231,"Personal weapons, includes beating",1
69202884,1,"Victoria, TX",5,13,12,0.9230769230769231,"Firearm, type not stated",1
74287191,2,"Duluth, MN-WI",11,13,12,0.9230769230769231,"Personal weapons, includes beating",1
75123660,1,"Salisbury, MD",1,13,12,0.9230769230769231,"Blunt object - hammer, club, etc",1
76042130,2,"Charlotte-Gastonia-Concord, NC-SC",4,13,12,0.9230769230769231,Fire,1
79121654,1,"Missoula, MT",7,13,12,0.9230769230769231,Knife or cutting instrument,1
80076025,1,"Worcester, MA",15,13,12,0.9230769230769231,Shotgun,1
94103365,1,"Boulder, CO",5,13,12,0.9230769230769231,"Firearm, type not stated",1
536277,2,"Reading, PA",1,12,11,0.9166666666666666,"Blunt object - hammer, club, etc",1
8065737,2,"Honolulu, HI",14,12,11,0.9166666666666666,Rifle,1
10315905,2,"Cleveland, TN",7,12,11,0.9166666666666666,Knife or cutting instrument,1
10333702,1,"Decatur, AL",14,12,11,0.9166666666666666,Rifle,1
11292243,2,"Fayetteville-Springdale-Rogers, AR-MO",15,12,11,0.9166666666666666,Shotgun,1
11558041,2,"Punta Gorda, FL",7,12,11,0.9166666666666666,Knife or cutting instrument,1
13854994,2,"San Angelo, TX",7,12,11,0.9166666666666666,Knife or cutting instrument,1
15503647,2,"Amarillo, TX",15,12,11,0.9166666666666666,Shotgun,1
19803959,2,"Burlington, NC",7,12,11,0.9166666666666666,Knife or cutting instrument,1
20452333,2,"Santa Barbara-Santa Maria, CA",11,12,11,0.9166666666666666,"Personal weapons, includes beating",1
22863706,2,"Manchester-Nashua, NH",1,12,11,0.9166666666666666,"Blunt object - hammer, club, etc",1
23110783,1,"Tulsa, OK",0,12,11,0.9166666666666666,Asphyxiation - includes death by gas,1
23360888,1,"Dalton, GA",5,12,11,0.9166666666666666,"Firearm, type not stated",1
24474033,1,Rural Oklahoma,0,12,11,0.9166666666666666,Asphyxiation - includes death by gas,1
24644161,1,"Gainesville, GA",14,12,11,0.9166666666666666,Rifle,1
30829834,1,"Greenville, NC",14,12,11,0.9166666666666666,Rifle,1
34298495,2,"Raleigh-Cary, NC",9,12,11,0.9166666666666666,Other gun,1
35825499,2,"Wilmington, NC",14,12,11,0.9166666666666666,Rifle,1
38542232,2,"Sioux Falls, SD",11,12,11,0.9166666666666666,"Personal weapons, includes beating",1
38637035,2,"Tuscaloosa, AL",11,12,11,0.9166666666666666,"Personal weapons, includes beating",1
39170841,2,"Lynchburg, VA",1,12,11,0.9166666666666666,"Blunt object - hammer, club, etc",1
40415056,2,Rural Georgia,4,12,11,0.9166666666666666,Fire,1
41396015,1,Rural Nevada,15,12,11,0.9166666666666666,Shotgun,1
41681010,1,"Oklahoma City, OK",8,12,11,0.9166666666666666,"Narcotics or drugs, sleeping pills",1
42322012,1,"Hanford-Corcoran, CA",11,12,11,0.9166666666666666,"Personal weapons, includes beating",1
43600557,2,"Appleton, WI",7,12,11,0.9166666666666666,Knife or cutting instrument,1
43621524,2,"Riverside-San Bernardino, CA",8,12,11,0.9166666666666666,"Narcotics or drugs, sleeping pills",1
47136567,1,"State College, PA",6,12,11,0.9166666666666666,"Handgun - pistol, revolver, etc",1
50338483,2,Rural South Dakota,1,12,11,0.9166666666666666,"Blunt object - hammer, club, etc",1
51999176,1,"Columbia, SC",0,12,11,0.9166666666666666,Asphyxiation - includes death by gas,1
52291547,2,Rural Tennessee,0,12,11,0.9166666666666666,Asphyxiation - includes death by gas,1
53211536,2,Rural New Mexico,15,12,11,0.9166666666666666,Shotgun,1
58616433,1,"St. Cloud, MN",7,12,11,0.9166666666666666,Knife or cutting instrument,1
59557403,2,"Chicago-Naperville-Joliet, IL-IN-WI",13,12,11,0.9166666666666666,Pushed or thrown out window,1
61969077,2,"Kingston, NY",11,12,11,0.9166666666666666,"Personal weapons, includes beating",1
69330075,1,"Chico, CA",11,12,11,0.9166666666666666,"Personal weapons, includes beating",1
69692680,1,"Provo-Orem, UT",10,12,11,0.9166666666666666,Other or type unknown,1
71630503,2,"Johnson City, TN",10,12,11,0.9166666666666666,Other or type unknown,1
73530003,1,"York-Hanover, PA",14,12,11,0.9166666666666666,Rifle,1
74818293,1,"Muncie, IN",15,12,11,0.9166666666666666,Shotgun,1
78935688,1,"Louisville, KY-IN",0,12,11,0.9166666666666666,Asphyxiation - includes death by gas,1
79276496,1,"Rockford, IL",15,12,11,0.9166666666666666,Shotgun,1
80017257,2,"Columbia, MO",11,12,11,0.9166666666666666,"Personal weapons, includes beating",1
81155237,2,"Hinesville-Fort Stewart, GA",11,12,11,0.9166666666666666,"Personal weapons, includes beating",1
81249880,1,"Rockford, IL",14,12,11,0.9166666666666666,Rifle,1
81718215,1,"San Angelo, TX",14,12,11,0.9166666666666666,Rifle,1
82533673,2,"Las Vegas-Paradise, NV",8,12,11,0.9166666666666666,"Narcotics or drugs, sleeping pills",1
84496225,1,"St. Louis, MO-IL",2,12,11,0.9166666666666666,Drowning,1
84513182,2,"Longview, TX",1,12,11,0.9166666666666666,"Blunt object - hammer, club, etc",1
89275744,2,"Tucson, AZ",0,12,11,0.9166666666666666,Asphyxiation - includes death by gas,1
90643602,1,"Monroe, MI",15,12,11,0.9166666666666666,Shotgun,1
90649940,2,Rural Virginia,8,12,11,0.9166666666666666,"Narcotics or drugs, sleeping pills",1
91331948,1,Rural Connecticut,7,12,11,0.9166666666666666,Knife or cutting instrument,1
95479278,2,"Manchester-Nashua, NH",11,12,11,0.9166666666666666,"Personal weapons, includes beating",1
98003734,2,Rural Louisiana,0,12,11,0.9166666666666666,Asphyxiation - includes death by gas,1
98034097,1,"Rapid City, SD",1,12,11,0.9166666666666666,"Blunt object - hammer, club, etc",1
957504,2,"Rocky Mount, NC",14,11,10,0.9090909090909091,Rifle,1
1678438,1,"Huntsville, AL",1,11,10,0.9090909090909091,"Blunt object - hammer, club, etc",1
4908532,2,"College Station-Bryan, TX",11,11,10,0.9090909090909091,"Personal weapons, includes beating",1
10798811,1,"State College, PA",7,11,10,0.9090909090909091,Knife or cutting instrument,1
13326735,1,"Pittsburgh, PA",2,11,10,0.9090909090909091,Drowning,1
14117234,1,"San Antonio, TX",9,11,10,0.9090909090909091,Other gun,1
15132766,2,"Bloomington, IN",7,11,10,0.9090909090909091,Knife or cutting instrument,1
18759504,1,"Jefferson City, MO",14,11,10,0.9090909090909091,Rifle,1
19077609,2,"Hagerstown-Martinsburg, MD-WV",11,11,10,0.9090909090909091,"Personal weapons, includes beating",1
21229842,1,"Phoenix-Mesa-Scottsdale, AZ",2,11,10,0.9090909090909091,Drowning,1
22214076,1,Rural Oregon,0,11,10,0.9090909090909091,Asphyxiation - includes death by gas,1
22533164,1,"Terre Haute, IN",10,11,10,0.9090909090909091,Other or type unknown,1
22604748,2,"Dothan, AL",10,11,10,0.9090909090909091,Other or type unknown,1
26830752,1,"Allentown-Bethlehem-Easton, PA-NJ",4,11,10,0.9090909090909091,Fire,1
30693378,1,"Bend, OR",10,11,10,0.9090909090909091,Other or type unknown,1
31975228,2,"Sherman-Denison, TX",11,11,10,0.9090909090909091,"Personal weapons, includes beating",1
32296017,2,"Cedar Rapids, IA",10,11,10,0.9090909090909091,Other or type unknown,1
37814936,1,"Iowa City, IA",5,11,10,0.9090909090909091,"Firearm, type not stated",1
41669355,2,"Blacksburg-Christiansburg, VA",5,11,10,0.9090909090909091,"Firearm, type not stated",1
42550090,2,"Sioux Falls, SD",6,11,10,0.9090909090909091,"Handgun - pistol, revolver, etc",1
45665190,1,Rural South Carolina,8,11,10,0.9090909090909091,"Narcotics or drugs, sleeping pills",1
46707294,1,"Longview, WA",10,11,10,0.9090909090909091,Other or type unknown,1
47907751,2,"Saginaw, MI",4,11,10,0.9090909090909091,Fire,1
48182614,1,Rural Alaska,0,11,10,0.9090909090909091,Asphyxiation - includes death by gas,1
48800500,1,"Midland, TX",1,11,10,0.9090909090909091,"Blunt object - hammer, club, etc",1
49223853,2,"Greenville, NC",11,11,10,0.9090909090909091,"Personal weapons, includes beating",1
50434431,2,"Duluth, MN-WI",14,11,10,0.9090909090909091,Rifle,1
51307759,2,"Mount Vernon-Anacortes, WA",6,11,10,0.9090909090909091,"Handgun - pistol, revolver, etc",1
51370847,2,"Waterloo-Cedar Falls, IA",11,11,10,0.9090909090909091,"Personal weapons, includes beating",1
52636350,2,Rural Oklahoma,0,11,10,0.9090909090909091,Asphyxiation - includes death by gas,1
54407457,1,"Kingston, NY",1,11,10,0.9090909090909091,"Blunt object - hammer, club, etc",1
55460827,2,"Medford, OR",1,11,10,0.9090909090909091,"Blunt object - hammer, club, etc",1
58048129,2,"Santa Barbara-Santa Maria, CA",1,11,10,0.9090909090909091,"Blunt object - hammer, club, etc",1
62499959,1,"Green Bay, WI",1,11,10,0.9090909090909091,"Blunt object - hammer, club, etc",1
66285218,2,"Akron, OH",15,11,10,0.9090909090909091,Shotgun,1
67236322,2,"Wichita Falls, TX",11,11,10,0.9090909090909091,"Personal weapons, includes beating",1
68984255,2,"Mansfield, OH",6,11,10,0.9090909090909091,"Handgun - pistol, revolver, etc",1
71506042,2,"Great Falls, MT",7,11,10,0.9090909090909091,Knife or cutting instrument,1
71798868,1,"Lebanon, PA",7,11,10,0.9090909090909091,Knife or cutting instrument,1
72662358,2,Rural Vermont,1,11,10,0.9090909090909091,"Blunt object - hammer, club, etc",1
72893931,1,"Flagstaff, AZ",14,11,10,0.9090909090909091,Rifle,1
72958253,2,"Nashville-Davidson-Murfreesboro, TN",0,11,10,0.9090909090909091,Asphyxiation - includes death by gas,1
79414869,1,"Rome, GA",1,11,10,0.9090909090909091,"Blunt object - hammer, club, etc",1
80745328,2,"Prescott, AZ",1,11,10,0.9090909090909091,"Blunt object - hammer, club, etc",1
81434006,2,"Tuscaloosa, AL",15,11,10,0.9090909090909091,Shotgun,1
83063329,2,"Springfield, MA",1,11,10,0.9090909090909091,"Blunt object - hammer, club, etc",1
86943923,1,"Gainesville, GA",11,11,10,0.9090909090909091,"Personal weapons, includes beating",1
88011803,2,"Syracuse, NY",4,11,10,0.9090909090909091,Fire,1
88207024,1,"Johnson City, TN",10,11,10,0.9090909090909091,Other or type unknown,1
90101983,2,"Wichita Falls, TX",10,11,10,0.9090909090909091,Other or type unknown,1
91173165,2,"Akron, OH",8,11,10,0.9090909090909091,"Narcotics or drugs, sleeping pills",1
94201984,2,"Madison, WI",1,11,10,0.9090909090909091,"Blunt object - hammer, club, etc",1
97889078,2,"Eugene-Springfield, OR",1,11,10,0.9090909090909091,"Blunt object - hammer, club, etc",1
99621833,2,"Wheeling, WV-OH",7,11,10,0.9090909090909091,Knife or cutting instrument,1
2021147,2,"Danville, VA",11,10,9,0.9,"Personal weapons, includes beating",1
3140128,2,"Jackson, TN",1,10,9,0.9,"Blunt object - hammer, club, etc",1
4464874,2,"Topeka, KS",1,10,9,0.9,"Blunt object - hammer, club, etc",1
8987840,2,"Greenville, SC",4,10,9,0.9,Fire,1
12863764,2,"San Angelo, TX",15,10,9,0.9,Shotgun,1
16322236,1,"Fort Walton Beach-Destin, FL",10,10,9,0.9,Other or type unknown,1
18333521,1,Rural Kentucky,0,10,9,0.9,Asphyxiation - includes death by gas,1
18755536,1,"Morristown, TN",1,10,9,0.9,"Blunt object - hammer, club, etc",1
19273175,2,"Rocky Mount, NC",1,10,9,0.9,"Blunt object - hammer, club, etc",1
21375755,1,"Pueblo, CO",14,10,9,0.9,Rifle,1
22946063,1,"Morgantown, WV",10,10,9,0.9,Other or type unknown,1
25609631,1,"Topeka, KS",14,10,9,0.9,Rifle,1
29256072,1,"Holland-Grand Haven, MI",11,10,9,0.9,"Personal weapons, includes beating",1
30538863,2,"Hanford-Corcoran, CA",11,10,9,0.9,"Personal weapons, includes beating",1
30737187,2,"La Crosse, WI-MN",6,10,9,0.9,"Handgun - pistol, revolver, etc",1
31653539,1,"Nashville-Davidson-Murfreesboro, TN",0,10,9,0.9,Asphyxiation - includes death by gas,1
33191443,2,"Visalia-Porterville, CA",0,10,9,0.9,Asphyxiation - includes death by gas,1
34178490,1,"Sacramento-Roseville, CA",2,10,9,0.9,Drowning,1
34661536,2,"Bangor, ME",7,10,9,0.9,Knife or cutting instrument,1
36041140,2,Rural Colorado,5,10,9,0.9,"Firearm, type not stated",1
39354627,1,"Coeur d Alene, ID",11,10,9,0.9,"Personal weapons, includes beating",1
40837565,2,"Fort Smith, AR-OK",14,10,9,0.9,Rifle,1
43092741,9,"Cincinnati-Middletown, OH-KY-IN",6,10,9,0.9,"Handgun - pistol, revolver, etc",1
47354043,2,Rural Texas,8,10,9,0.9,"Narcotics or drugs, sleeping pills",1
47495678,2,"Hattiesburg, MS",7,10,9,0.9,Knife or cutting instrument,1
48636942,2,"Topeka, KS",15,10,9,0.9,Shotgun,1
49570710,2,Rural Utah,11,10,9,0.9,"Personal weapons, includes beating",1
50118192,2,"Houma-Bayou Cane-Thibodaux, LA",15,10,9,0.9,Shotgun,1
58699182,1,Rural South Carolina,9,10,9,0.9,Other gun,1
61981385,1,"Anniston-Oxford, AL",14,10,9,0.9,Rifle,1
63807746,2,Rural Arizona,15,10,9,0.9,Shotgun,1
66076501,2,"Davenport-Moline-Rock Island, IA-IL",1,10,9,0.9,"Blunt object - hammer, club, etc",1
67552718,2,"Santa Rosa-Petaluma, CA",14,10,9,0.9,Rifle,1
67669568,1,"Laredo, TX",11,10,9,0.9,"Personal weapons, includes beating",1
68163429,1,"Rome, GA",5,10,9,0.9,"Firearm, type not stated",1
68730229,2,"Reno-Sparks, NV",14,10,9,0.9,Rifle,1
70125792,1,"Brunswick, GA",5,10,9,0.9,"Firearm, type not stated",1
71489914,2,"Reno-Sparks, NV",16,10,9,0.9,Strangulation - hanging,1
72248626,1,"Bismarck, ND",7,10,9,0.9,Knife or cutting instrument,1
73666454,1,Rural Arizona,9,10,9,0.9,Other gun,1
74324795,2,Rural New Hampshire,5,10,9,0.9,"Firearm, type not stated",1
76049808,1,"Las Cruces, NM",1,10,9,0.9,"Blunt object - hammer, club, etc",1
76138081,1,"Green Bay, WI",15,10,9,0.9,Shotgun,1
78356360,2,"Lancaster, PA",16,10,9,0.9,Strangulation - hanging,1
82316324,1,"Louisville, KY-IN",4,10,9,0.9,Fire,1
82520298,1,"Lafayette, IN",1,10,9,0.9,"Blunt object - hammer, club, etc",1
83453351,2,"Kokomo, IN",11,10,9,0.9,"Personal weapons, includes beating",1
85265720,2,"Gainesville, GA",5,10,9,0.9,"Firearm, type not stated",1
86959720,2,"Lansing-East Lansing, MI",14,10,9,0.9,Rifle,1
89910380,2,"South Bend-Mishawaka, IN-MI",15,10,9,0.9,Shotgun,1
90544060,2,"Corpus Christi, TX",14,10,9,0.9,Rifle,1
91102884,1,"Sandusky, OH",11,10,9,0.9,"Personal weapons, includes beating",1
93513890,2,"Tulsa, OK",0,10,9,0.9,Asphyxiation - includes death by gas,1
94156313,1,Rural Virginia,9,10,9,0.9,Other gun,1
95570382,2,Rural Colorado,0,10,9,0.9,Asphyxiation - includes death by gas,1
99042831,2,"Erie, PA",1,10,9,0.9,"Blunt object - hammer, club, etc",1
1164696,1,"Providence-New Bedford-Fall River, RI-MA",8,9,8,0.8888888888888888,"Narcotics or drugs, sleeping pills",1
1656317,2,"Santa Barbara-Santa Maria, CA",14,9,8,0.8888888888888888,Rifle,1
3814778,2,"Springfield, MA",15,9,8,0.8888888888888888,Shotgun,1
4005051,2,Rural Pennsylvania,2,9,8,0.8888888888888888,Drowning,1
4678696,2,"Omaha-Council Bluffs, NE-IA",4,9,8,0.8888888888888888,Fire,1
5505376,1,"Eau Claire, WI",7,9,8,0.8888888888888888,Knife or cutting instrument,1
8498581,2,"Anderson, SC",1,9,8,0.8888888888888888,"Blunt object - hammer, club, etc",1
9288041,2,Rural Kansas,4,9,8,0.8888888888888888,Fire,1
10192063,2,"Dayton, OH",0,9,8,0.8888888888888888,Asphyxiation - includes death by gas,1
10300018,1,"Olympia, WA",1,9,8,0.8888888888888888,"Blunt object - hammer, club, etc",1
11010975,2,"Fort Collins-Loveland, CO",11,9,8,0.8888888888888888,"Personal weapons, includes beating",1
11697764,2,"Binghamton, NY",6,9,8,0.8888888888888888,"Handgun - pistol, revolver, etc",1
19168376,2,"Burlington-South Burlington, VT",7,9,8,0.8888888888888888,Knife or cutting instrument,1
19541756,2,"Rochester, MN",11,9,8,0.8888888888888888,"Personal weapons, includes beating",1
19698192,2,"Lima, OH",11,9,8,0.8888888888888888,"Personal weapons, includes beating",1
21974801,1,"Bremerton-Silverdale, WA",1,9,8,0.8888888888888888,"Blunt object - hammer, club, etc",1
22014112,1,"Cumberland, MD-WV",14,9,8,0.8888888888888888,Rifle,1
23721164,1,"Cheyenne, WY",11,9,8,0.8888888888888888,"Personal weapons, includes beating",1
24638083,1,"St. Cloud, MN",14,9,8,0.8888888888888888,Rifle,1
25005489,2,"Clarksville, TN-KY",1,9,8,0.8888888888888888,"Blunt object - hammer, club, etc",1
25464982,2,"Barnstable Town, MA",1,9,8,0.8888888888888888,"Blunt object - hammer, club, etc",1
26199658,2,"Salisbury, MD",15,9,8,0.8888888888888888,Shotgun,1
28568590,1,"Stockton, CA",2,9,8,0.8888888888888888,Drowning,1
29210906,1,"Joplin, MO",15,9,8,0.8888888888888888,Shotgun,1
29383464,1,"Glens Falls, NY",15,9,8,0.8888888888888888,Shotgun,1
30633935,2,"Jacksonville, FL",4,9,8,0.8888888888888888,Fire,1
34257287,2,"Blacksburg-Christiansburg, VA",10,9,8,0.8888888888888888,Other or type unknown,1
34513698,1,"Monroe, MI",14,9,8,0.8888888888888888,Rifle,1
36797229,2,"Kalamazoo-Portage, MI",14,9,8,0.8888888888888888,Rifle,1
41813167,2,"Dothan, AL",15,9,8,0.8888888888888888,Shotgun,1
43047349,2,"Atlanta-Sandy Springs-Marietta, GA",2,9,8,0.8888888888888888,Drowning,1
44984544,1,"Toledo, OH",4,9,8,0.8888888888888888,Fire,1
45219549,2,"Rochester, MN",7,9,8,0.8888888888888888,Knife or cutting instrument,1
46568163,1,"Harrisonburg, VA",10,9,8,0.8888888888888888,Other or type unknown,1
48520629,1,"Allentown-Bethlehem-Easton, PA-NJ",8,9,8,0.8888888888888888,"Narcotics or drugs, sleeping pills",1
53065819,2,"Waterloo-Cedar Falls, IA",6,9,8,0.8888888888888888,"Handgun - pistol, revolver, etc",1
53672041,2,"New Haven-Milford, CT",8,9,8,0.8888888888888888,"Narcotics or drugs, sleeping pills",1
53991947,2,Rural Wyoming,0,9,8,0.8888888888888888,Asphyxiation - includes death by gas,1
54188950,1,"State College, PA",10,9,8,0.8888888888888888,Other or type unknown,1
56054893,1,"Erie, PA",11,9,8,0.8888888888888888,"Personal weapons, includes beating",1
57892795,2,"Akron, OH",14,9,8,0.8888888888888888,Rifle,1
58953560,2,"Charlottesville, VA",1,9,8,0.8888888888888888,"Blunt object - hammer, club, etc",1
60394101,1,"Wheeling, WV-OH",15,9,8,0.8888888888888888,Shotgun,1
60930241,2,"Iowa City, IA",6,9,8,0.8888888888888888,"Handgun - pistol, revolver, etc",1
61110346,2,"Brownsville-Harlingen, TX",14,9,8,0.8888888888888888,Rifle,1
64003225,1,"Prescott, AZ",14,9,8,0.8888888888888888,Rifle,1
64787818,1,Rural Georgia,16,9,8,0.8888888888888888,Strangulation - hanging,1
65642241,2,"Yuma, AZ",1,9,8,0.8888888888888888,"Blunt object - hammer, club, etc",1
65706414,1,"Hanford-Corcoran, CA",14,9,8,0.8888888888888888,Rifle,1
66337606,1,Rural New Hampshire,15,9,8,0.8888888888888888,Shotgun,1
66397468,2,"Des Moines, IA",4,9,8,0.8888888888888888,Fire,1
66843229,2,"Coeur d Alene, ID",10,9,8,0.8888888888888888,Other or type unknown,1
68175497,2,"Dothan, AL",5,9,8,0.8888888888888888,"Firearm, type not stated",1
70385347,2,"Gainesville, GA",1,9,8,0.8888888888888888,"Blunt object - hammer, club, etc",1
71600330,2,"Tyler, TX",14,9,8,0.8888888888888888,Rifle,1
71921795,1,"Hinesville-Fort Stewart, GA",10,9,8,0.8888888888888888,Other or type unknown,1
71990638,1,"Iowa City, IA",10,9,8,0.8888888888888888,Other or type unknown,1
72015245,2,"Topeka, KS",14,9,8,0.8888888888888888,Rifle,1
77834591,1,"Athens-Clarke County, GA",14,9,8,0.8888888888888888,Rifle,1
81120698,2,"Panama City-Lynn Haven, FL",1,9,8,0.8888888888888888,"Blunt object - hammer, club, etc",1
83196252,1,"Stockton, CA",16,9,8,0.8888888888888888,Strangulation - hanging,1
87013041,1,"Johnstown, PA",10,9,8,0.8888888888888888,Other or type unknown,1
87933526,2,"Grand Junction, CO",11,9,8,0.8888888888888888,"Personal weapons, includes beating",1
89012991,2,"Florence-Muscle Shoals, AL",10,9,8,0.8888888888888888,Other or type unknown,1
89850993,1,"Tampa-St. Petersburg-Clearwater, FL",0,9,8,0.8888888888888888,Asphyxiation - includes death by gas,1
94755988,2,"Lancaster, PA",1,9,8,0.8888888888888888,"Blunt object - hammer, club, etc",1
96503467,1,"Norwich-New London, CT",10,9,8,0.8888888888888888,Other or type unknown,1
96946069,1,"Burlington-South Burlington, VT",14,9,8,0.8888888888888888,Rifle,1
98376522,1,"Mobile, AL",4,9,8,0.8888888888888888,Fire,1
55428,2,"Hanford-Corcoran, CA",10,8,7,0.875,Other or type unknown,1
815234,1,"Dayton, OH",0,8,7,0.875,Asphyxiation - includes death by gas,1
4484289,2,"Iowa City, IA",1,8,7,0.875,"Blunt object - hammer, club, etc",1
5891305,2,"Texarkana, TX-Texarkana, AR",5,8,7,0.875,"Firearm, type not stated",1
5940052,2,"St. Joseph, MO-KS",11,8,7,0.875,"Personal weapons, includes beating",1
8420320,2,"Hartford, CT",14,8,7,0.875,Rifle,1
9104958,1,"Bismarck, ND",5,8,7,0.875,"Firearm, type not stated",1
9189094,2,"Providence-New Bedford-Fall River, RI-MA",4,8,7,0.875,Fire,1
11123169,2,"New York-New Jersey-Long Island, NY-NJ",9,8,7,0.875,Other gun,1
14435581,2,"Auburn-Opelika, AL",5,8,7,0.875,"Firearm, type not stated",1
15230051,2,"Cumberland, MD-WV",7,8,7,0.875,Knife or cutting instrument,1
19156601,1,"Portland-South Portland-Biddeford, ME",4,8,7,0.875,Fire,1
20273467,1,"Winchester, VA-WV",10,8,7,0.875,Other or type unknown,1
21986710,2,"Omaha-Council Bluffs, NE-IA",14,8,7,0.875,Rifle,1
23105014,1,Rural Louisiana,16,8,7,0.875,Strangulation - hanging,1
23961512,2,"Wichita, KS",0,8,7,0.875,Asphyxiation - includes death by gas,1
25751446,2,"Bellingham, WA",16,8,7,0.875,Strangulation - hanging,1
28189196,2,"Columbus, GA-AL",14,8,7,0.875,Rifle,1
28418940,2,Rural Georgia,0,8,7,0.875,Asphyxiation - includes death by gas,1
30180625,2,"Olympia, WA",11,8,7,0.875,"Personal weapons, includes beating",1
32714680,2,"El Centro, CA",14,8,7,0.875,Rifle,1
33831995,2,"Evansville, IN-KY",14,8,7,0.875,Rifle,1
34318211,1,"Tulsa, OK",2,8,7,0.875,Drowning,1
34943313,2,"Macon, GA",14,8,7,0.875,Rifle,1
36912550,2,"Salinas, CA",14,8,7,0.875,Rifle,1
38493452,2,"Harrisburg-Carlisle, PA",15,8,7,0.875,Shotgun,1
39513655,2,"San Angelo, TX",11,8,7,0.875,"Personal weapons, includes beating",1
40733700,1,"Napa, CA",14,8,7,0.875,Rifle,1
41349180,1,Rural Maryland,4,8,7,0.875,Fire,1
42920292,2,"Burlington, NC",14,8,7,0.875,Rifle,1
43326237,1,"Cedar Rapids, IA",10,8,7,0.875,Other or type unknown,1
44636128,2,"Brownsville-Harlingen, TX",15,8,7,0.875,Shotgun,1
46904166,2,"Missoula, MT",6,8,7,0.875,"Handgun - pistol, revolver, etc",1
47853500,2,"Winchester, VA-WV",15,8,7,0.875,Shotgun,1
48774139,2,"Knoxville, TN",0,8,7,0.875,Asphyxiation - includes death by gas,1
49479423,2,"Great Falls, MT",11,8,7,0.875,"Personal weapons, includes beating",1
50007800,1,"Eau Claire, WI",14,8,7,0.875,Rifle,1
51259088,2,"Hinesville-Fort Stewart, GA",7,8,7,0.875,Knife or cutting instrument,1
52029234,1,"Yuma, AZ",15,8,7,0.875,Shotgun,1
53135869,1,"Hanford-Corcoran, CA",15,8,7,0.875,Shotgun,1
55460490,1,"Sherman-Denison, TX",11,8,7,0.875,"Personal weapons, includes beating",1
55727187,2,"Fairbanks, AK",11,8,7,0.875,"Personal weapons, includes beating",1
57083375,1,"Brunswick, GA",14,8,7,0.875,Rifle,1
59141498,2,"Cape Coral-Fort Myers, FL",14,8,7,0.875,Rifle,1
59261378,1,"Lima, OH",11,8,7,0.875,"Personal weapons, includes beating",1
59270426,2,"Hot Springs, AR",10,8,7,0.875,Other or type unknown,1
61998200,2,"Manchester-Nashua, NH",5,8,7,0.875,"Firearm, type not stated",1
63599083,1,"Warner Robins, GA",15,8,7,0.875,Shotgun,1
66771770,2,"Bloomington, IN",11,8,7,0.875,"Personal weapons, includes beating",1
68092271,1,"Sioux City, IA-NE-SD",5,8,7,0.875,"Firearm, type not stated",1
68896335,1,"Cheyenne, WY",5,8,7,0.875,"Firearm, type not stated",1
69950045,1,"Danville, IL",7,8,7,0.875,Knife or cutting instrument,1
70334197,1,"Mount Vernon-Anacortes, WA",14,8,7,0.875,Rifle,1
70780374,1,"Elizabethtown, KY",14,8,7,0.875,Rifle,1
71648961,2,"Pueblo, CO",11,8,7,0.875,"Personal weapons, includes beating",1
71745899,2,"Savannah, GA",14,8,7,0.875,Rifle,1
71854739,1,"Michigan City-La Porte, IN",15,8,7,0.875,Shotgun,1
73500047,1,"Kennewick-Richland-Pasco, WA",8,8,7,0.875,"Narcotics or drugs, sleeping pills",1
75513580,2,"Vero Beach, FL",5,8,7,0.875,"Firearm, type not stated",1
79922490,2,Rural North Carolina,0,8,7,0.875,Asphyxiation - includes death by gas,1
84657716,2,"Hattiesburg, MS",11,8,7,0.875,"Personal weapons, includes beating",1
85704384,2,"Norwich-New London, CT",6,8,7,0.875,"Handgun - pistol, revolver, etc",1
85849215,1,Rural New York,8,8,7,0.875,"Narcotics or drugs, sleeping pills",1
88961090,2,"Columbus, IN",7,8,7,0.875,Knife or cutting instrument,1
89389087,1,"Richmond, VA",0,8,7,0.875,Asphyxiation - includes death by gas,1
91092069,1,"Cheyenne, WY",15,8,7,0.875,Shotgun,1
91648373,2,Rural Montana,5,8,7,0.875,"Firearm, type not stated",1
93122437,1,Rural Kansas,4,8,7,0.875,Fire,1
96136380,2,"Cedar Rapids, IA",1,8,7,0.875,"Blunt object - hammer, club, etc",1
99234576,1,"Wenatchee, WA",15,8,7,0.875,Shotgun,1
113107,2,Rural Idaho,0,7,6,0.8571428571428571,Asphyxiation - includes death by gas,1
2113793,2,"Santa Rosa-Petaluma, CA",15,7,6,0.8571428571428571,Shotgun,1
3097448,2,Rural Alabama,4,7,6,0.8571428571428571,Fire,1
3341852,1,"Modesto, CA",16,7,6,0.8571428571428571,Strangulation - hanging,1
3615109,1,"New Orleans-Metairie-Kenner, LA",2,7,6,0.8571428571428571,Drowning,1
4664178,2,"Tucson, AZ",8,7,6,0.8571428571428571,"Narcotics or drugs, sleeping pills",1
9415141,2,"Rapid City, SD",10,7,6,0.8571428571428571,Other or type unknown,1
11540843,2,"Bellingham, WA",11,7,6,0.8571428571428571,"Personal weapons, includes beating",1
11785292,2,"Fayetteville, NC",4,7,6,0.8571428571428571,Fire,1
11976929,1,Rural Alabama,4,7,6,0.8571428571428571,Fire,1
13528689,2,Rural Connecticut,10,7,6,0.8571428571428571,Other or type unknown,1
13714889,2,"Cheyenne, WY",10,7,6,0.8571428571428571,Other or type unknown,1
14004803,1,"Roanoke, VA",4,7,6,0.8571428571428571,Fire,1
14150408,2,"Muskegon-Norton Shores, MI",5,7,6,0.8571428571428571,"Firearm, type not stated",1
15960904,2,"Lubbock, TX",16,7,6,0.8571428571428571,Strangulation - hanging,1
16329010,1,"Blacksburg-Christiansburg, VA",1,7,6,0.8571428571428571,"Blunt object - hammer, club, etc",1
16590812,2,"Charleston, WV",4,7,6,0.8571428571428571,Fire,1
19250342,1,"Holland-Grand Haven, MI",15,7,6,0.8571428571428571,Shotgun,1
20461567,2,"Niles-Benton Harbor, MI",15,7,6,0.8571428571428571,Shotgun,1
23390531,2,"Lynchburg, VA",16,7,6,0.8571428571428571,Strangulation - hanging,1
23493919,2,"Pueblo, CO",14,7,6,0.8571428571428571,Rifle,1
23747988,2,"Little Rock-North Little Rock, AR",0,7,6,0.8571428571428571,Asphyxiation - includes death by gas,1
23822981,2,"Cheyenne, WY",7,7,6,0.8571428571428571,Knife or cutting instrument,1
24074941,1,Rural Delaware,14,7,6,0.8571428571428571,Rifle,1
24436375,2,Rural New Hampshire,14,7,6,0.8571428571428571,Rifle,1
25598028,1,"Dubuque, IA",6,7,6,0.8571428571428571,"Handgun - pistol, revolver, etc",1
26537025,2,"Knoxville, TN",4,7,6,0.8571428571428571,Fire,1
27100231,2,"Asheville, NC",9,7,6,0.8571428571428571,Other gun,1
27361997,2,"Lebanon, PA",10,7,6,0.8571428571428571,Other or type unknown,1
28657834,2,"Barnstable Town, MA",10,7,6,0.8571428571428571,Other or type unknown,1
29027707,2,"Ocala, FL",1,7,6,0.8571428571428571,"Blunt object - hammer, club, etc",1
29540651,1,"St. Joseph, MO-KS",1,7,6,0.8571428571428571,"Blunt object - hammer, club, etc",1
32342863,1,"Boulder, CO",15,7,6,0.8571428571428571,Shotgun,1
33104899,1,"Coeur d Alene, ID",10,7,6,0.8571428571428571,Other or type unknown,1
33591487,2,"Fort Wayne, IN",14,7,6,0.8571428571428571,Rifle,1
34686098,2,"Montgomery, AL",4,7,6,0.8571428571428571,Fire,1
35302641,2,Rural Minnesota,5,7,6,0.8571428571428571,"Firearm, type not stated",1
36399421,1,"Sherman-Denison, TX",1,7,6,0.8571428571428571,"Blunt object - hammer, club, etc",1
40237956,1,"Weirton-Steubenville, WV-OH",15,7,6,0.8571428571428571,Shotgun,1
40590906,2,"Muncie, IN",7,7,6,0.8571428571428571,Knife or cutting instrument,1
40862978,2,"Poughkeepsie-Newburgh-Middletown, NY",5,7,6,0.8571428571428571,"Firearm, type not stated",1
41477566,2,"Santa Rosa-Petaluma, CA",0,7,6,0.8571428571428571,Asphyxiation - includes death by gas,1
42940876,1,"Fort Collins-Loveland, CO",15,7,6,0.8571428571428571,Shotgun,1
42971172,2,"Green Bay, WI",15,7,6,0.8571428571428571,Shotgun,1
43921529,1,Rural Mississippi,16,7,6,0.8571428571428571,Strangulation - hanging,1
44495931,1,"Salisbury, MD",10,7,6,0.8571428571428571,Other or type unknown,1
44762552,2,"Rome, GA",11,7,6,0.8571428571428571,"Personal weapons, includes beating",1
44937550,2,Rural California,4,7,6,0.8571428571428571,Fire,1
45527033,2,"Bowling Green, KY",11,7,6,0.8571428571428571,"Personal weapons, includes beating",1
46665223,2,"Clarksville, TN-KY",8,7,6,0.8571428571428571,"Narcotics or drugs, sleeping pills",1
46753397,2,"Madera, CA",11,7,6,0.8571428571428571,"Personal weapons, includes beating",1
48842915,2,"Sioux City, IA-NE-SD",15,7,6,0.8571428571428571,Shotgun,1
49819405,1,"Williamsport, PA",11,7,6,0.8571428571428571,"Personal weapons, includes beating",1
51008822,1,Rural Nevada,8,7,6,0.8571428571428571,"Narcotics or drugs, sleeping pills",1
51471374,2,Rural Montana,0,7,6,0.8571428571428571,Asphyxiation - includes death by gas,1
52200705,2,"Chico, CA",10,7,6,0.8571428571428571,Other or type unknown,1
52778226,1,"Valdosta, GA",11,7,6,0.8571428571428571,"Personal weapons, includes beating",1
53299538,1,"Santa Cruz-Watsonville, CA",14,7,6,0.8571428571428571,Rifle,1
53481303,1,Rural Minnesota,4,7,6,0.8571428571428571,Fire,1
54190646,2,"Lebanon, PA",7,7,6,0.8571428571428571,Knife or cutting instrument,1
55550599,2,"Oshkosh-Neenah, WI",6,7,6,0.8571428571428571,"Handgun - pistol, revolver, etc",1
56114388,2,"St. Cloud, MN",7,7,6,0.8571428571428571,Knife or cutting instrument,1
57014606,1,Rural Alaska,2,7,6,0.8571428571428571,Drowning,1
57394403,1,Rural Colorado,8,7,6,0.8571428571428571,"Narcotics or drugs, sleeping pills",1
57836318,2,"Eugene-Springfield, OR",0,7,6,0.8571428571428571,Asphyxiation - includes death by gas,1
59005917,2,"Wichita Falls, TX",1,7,6,0.8571428571428571,"Blunt object - hammer, club, etc",1
59064691,1,"Owensboro, KY",5,7,6,0.8571428571428571,"Firearm, type not stated",1
59382096,1,"El Paso, TX",0,7,6,0.8571428571428571,Asphyxiation - includes death by gas,1
60010575,2,"Sioux City, IA-NE-SD",10,7,6,0.8571428571428571,Other or type unknown,1
61092675,2,"Niles-Benton Harbor, MI",5,7,6,0.8571428571428571,"Firearm, type not stated",1
61506727,2,Rural Nevada,15,7,6,0.8571428571428571,Shotgun,1
62604124,2,"Danville, VA",1,7,6,0.8571428571428571,"Blunt object - hammer, club, etc",1
62786001,2,"Allentown-Bethlehem-Easton, PA-NJ",8,7,6,0.8571428571428571,"Narcotics or drugs, sleeping pills",1
63412262,2,"Elmira, NY",7,7,6,0.8571428571428571,Knife or cutting instrument,1
64378357,1,"Athens-Clarke County, GA",15,7,6,0.8571428571428571,Shotgun,1
64775404,1,"Iowa City, IA",6,7,6,0.8571428571428571,"Handgun - pistol, revolver, etc",1
66210375,2,"Decatur, AL",11,7,6,0.8571428571428571,"Personal weapons, includes beating",1
66619366,2,"San Angelo, TX",10,7,6,0.8571428571428571,Other or type unknown,1
67481719,1,"Pensacola-Ferry Pass-Brent, FL",9,7,6,0.8571428571428571,Other gun,1
70990296,1,"Bellingham, WA",8,7,6,0.8571428571428571,"Narcotics or drugs, sleeping pills",1
72730338,2,"Utica-Rome, NY",1,7,6,0.8571428571428571,"Blunt object - hammer, club, etc",1
73112385,2,"Winston-Salem, NC",9,7,6,0.8571428571428571,Other gun,1
74387494,1,"Spartanburg, SC",9,7,6,0.8571428571428571,Other gun,1
76259787,2,"San Jose-Sunnyvale-Santa Clara, CA",4,7,6,0.8571428571428571,Fire,1
76868954,1,Rural Kentucky,16,7,6,0.8571428571428571,Strangulation - hanging,1
77209527,2,"Charlottesville, VA",11,7,6,0.8571428571428571,"Personal weapons, includes beating",1
78378438,1,"Auburn-Opelika, AL",14,7,6,0.8571428571428571,Rifle,1
79616333,2,Rural Wyoming,16,7,6,0.8571428571428571,Strangulation - hanging,1
80063652,1,"Rapid City, SD",5,7,6,0.8571428571428571,"Firearm, type not stated",1
81221361,2,"Fort Smith, AR-OK",1,7,6,0.8571428571428571,"Blunt object - hammer, club, etc",1
81491093,2,"Athens-Clarke County, GA",5,7,6,0.8571428571428571,"Firearm, type not stated",1
86374915,2,"Joplin, MO",1,7,6,0.8571428571428571,"Blunt object - hammer, club, etc",1
86451970,2,"Lancaster, PA",4,7,6,0.8571428571428571,Fire,1
86810896,1,"Poughkeepsie-Newburgh-Middletown, NY",17,7,6,0.8571428571428571,Weapon Not Reported,1
86836604,1,Rural Oregon,16,7,6,0.8571428571428571,Strangulation - hanging,1
87535340,2,"Brownsville-Harlingen, TX",16,7,6,0.8571428571428571,Strangulation - hanging,1
88498952,2,"Eau Claire, WI",7,7,6,0.8571428571428571,Knife or cutting instrument,1
89248877,2,"Lewiston-Auburn, ME",11,7,6,0.8571428571428571,"Personal weapons, includes beating",1
90918742,2,"Janesville, WI",10,7,6,0.8571428571428571,Other or type unknown,1
91166792,2,"Anchorage, AK",0,7,6,0.8571428571428571,Asphyxiation - includes death by gas,1
91860090,2,"Warner Robins, GA",10,7,6,0.8571428571428571,Other or type unknown,1
93250921,1,"Toledo, OH",0,7,6,0.8571428571428571,Asphyxiation - includes death by gas,1
95444187,2,"Wheeling, WV-OH",10,7,6,0.8571428571428571,Other or type unknown,1
96764115,2,"Provo-Orem, UT",8,7,6,0.8571428571428571,"Narcotics or drugs, sleeping pills",1
97379242,2,"Wheeling, WV-OH",5,7,6,0.8571428571428571,"Firearm, type not stated",1
97543844,1,Rural Alabama,8,7,6,0.8571428571428571,"Narcotics or drugs, sleeping pills",1
37551,1,"Little Rock-North Little Rock, AR",9,6,5,0.8333333333333334,Other gun,1
1984297,1,"Pocatello, ID",10,6,5,0.8333333333333334,Other or type unknown,1
2012448,2,"Savannah, GA",0,6,5,0.8333333333333334,Asphyxiation - includes death by gas,1
2472854,1,"Springfield, MO",0,6,5,0.8333333333333334,Asphyxiation - includes death by gas,1
3722680,1,"Indianapolis, IN",8,6,5,0.8333333333333334,"Narcotics or drugs, sleeping pills",1
4924574,2,"Pocatello, ID",7,6,5,0.8333333333333334,Knife or cutting instrument,1
5689766,1,Rural Florida,9,6,5,0.8333333333333334,Other gun,1
8611147,1,"Boston-Cambridge-Quincy, MA-NH",2,6,5,0.8333333333333334,Drowning,1
10345726,1,"Morgantown, WV",1,6,5,0.8333333333333334,"Blunt object - hammer, club, etc",1
10356666,2,Rural Alaska,4,6,5,0.8333333333333334,Fire,1
10360660,1,"Bloomington, IN",5,6,5,0.8333333333333334,"Firearm, type not stated",1
12175406,2,Rural New Hampshire,15,6,5,0.8333333333333334,Shotgun,1
12355706,2,"Santa Barbara-Santa Maria, CA",0,6,5,0.8333333333333334,Asphyxiation - includes death by gas,1
12621628,1,"Dubuque, IA",11,6,5,0.8333333333333334,"Personal weapons, includes beating",1
12954169,1,"Philadelphia-Camden-Wilmington, PA-NJ-DE",13,6,5,0.8333333333333334,Pushed or thrown out window,1
16833598,2,Rural New Mexico,0,6,5,0.8333333333333334,Asphyxiation - includes death by gas,1
17186483,1,"Jonesboro, AR",1,6,5,0.8333333333333334,"Blunt object - hammer, club, etc",1
17705916,1,"Anchorage, AK",4,6,5,0.8333333333333334,Fire,1
18387673,1,"Holland-Grand Haven, MI",5,6,5,0.8333333333333334,"Firearm, type not stated",1
18414250,2,"Johnstown, PA",10,6,5,0.8333333333333334,Other or type unknown,1
18719013,2,"Lansing-East Lansing, MI",8,6,5,0.8333333333333334,"Narcotics or drugs, sleeping pills",1
18777713,2,"Parkersburg-Marietta-Vienna, WV-OH",5,6,5,0.8333333333333334,"Firearm, type not stated",1
20478964,2,"San Diego-Carlsbad-San Marcos, CA",12,6,5,0.8333333333333334,Poison - does not include gas,1
22762698,1,Rural Maine,4,6,5,0.8333333333333334,Fire,1
24615530,1,"Lebanon, PA",11,6,5,0.8333333333333334,"Personal weapons, includes beating",1
25978898,1,"San Francisco-Oakland-Fremont, CA",3,6,5,0.8333333333333334,Explosives,1
26703459,2,"Rockford, IL",15,6,5,0.8333333333333334,Shotgun,1
26821029,2,"Huntsville, AL",1,6,5,0.8333333333333334,"Blunt object - hammer, club, etc",1
27868746,1,"Bay City, MI",11,6,5,0.8333333333333334,"Personal weapons, includes beating",1
28688446,2,"Minneapolis-St. Paul-Bloomington, MN-WI",2,6,5,0.8333333333333334,Drowning,1
28739158,2,"Victoria, TX",15,6,5,0.8333333333333334,Shotgun,1
30145537,2,Rural Indiana,0,6,5,0.8333333333333334,Asphyxiation - includes death by gas,1
31455578,2,Rural Delaware,1,6,5,0.8333333333333334,"Blunt object - hammer, club, etc",1
32839024,1,"Sioux Falls, SD",10,6,5,0.8333333333333334,Other or type unknown,1
33313101,2,"Parkersburg-Marietta-Vienna, WV-OH",11,6,5,0.8333333333333334,"Personal weapons, includes beating",1
34159115,2,"Reading, PA",14,6,5,0.8333333333333334,Rifle,1
34217789,1,Rural Arizona,8,6,5,0.8333333333333334,"Narcotics or drugs, sleeping pills",1
35529878,2,"Lincoln, NE",0,6,5,0.8333333333333334,Asphyxiation - includes death by gas,1
35650538,1,"Chattanooga, TN-GA",0,6,5,0.8333333333333334,Asphyxiation - includes death by gas,1
39894264,2,"Panama City-Lynn Haven, FL",5,6,5,0.8333333333333334,"Firearm, type not stated",1
41480725,2,"Longview, TX",16,6,5,0.8333333333333334,Strangulation - hanging,1
41685126,2,"Grand Forks, ND-MN",7,6,5,0.8333333333333334,Knife or cutting instrument,1
44137046,2,"Fresno, CA",2,6,5,0.8333333333333334,Drowning,1
44246537,1,"Monroe, MI",5,6,5,0.8333333333333334,"Firearm, type not stated",1
44381622,1,"Owensboro, KY",10,6,5,0.8333333333333334,Other or type unknown,1
44566454,2,"Anderson, IN",5,6,5,0.8333333333333334,"Firearm, type not stated",1
46863708,2,"Olympia, WA",1,6,5,0.8333333333333334,"Blunt object - hammer, club, etc",1
47030507,1,"Grand Rapids-Wyoming, MI",0,6,5,0.8333333333333334,Asphyxiation - includes death by gas,1
49707335,2,"Athens-Clarke County, GA",1,6,5,0.8333333333333334,"Blunt object - hammer, club, etc",1
50389324,1,"Peoria, IL",4,6,5,0.8333333333333334,Fire,1
50438033,2,"Casper, WY",7,6,5,0.8333333333333334,Knife or cutting instrument,1
51718363,1,"Green Bay, WI",5,6,5,0.8333333333333334,"Firearm, type not stated",1
53259140,1,"Kalamazoo-Portage, MI",8,6,5,0.8333333333333334,"Narcotics or drugs, sleeping pills",1
54731676,2,"Sherman-Denison, TX",1,6,5,0.8333333333333334,"Blunt object - hammer, club, etc",1
54789767,2,"Saginaw, MI",14,6,5,0.8333333333333334,Rifle,1
55067071,2,"Tulsa, OK",8,6,5,0.8333333333333334,"Narcotics or drugs, sleeping pills",1
56094823,2,Rural Kansas,8,6,5,0.8333333333333334,"Narcotics or drugs, sleeping pills",1
56130699,2,"Punta Gorda, FL",11,6,5,0.8333333333333334,"Personal weapons, includes beating",1
57340164,2,"Scranton--Wilkes-Barre, PA",16,6,5,0.8333333333333334,Strangulation - hanging,1
57549703,2,"Mount Vernon-Anacortes, WA",10,6,5,0.8333333333333334,Other or type unknown,1
58179044,1,"Holland-Grand Haven, MI",14,6,5,0.8333333333333334,Rifle,1
58692843,2,"Albuquerque, NM",8,6,5,0.8333333333333334,"Narcotics or drugs, sleeping pills",1
61406736,2,"Lafayette, IN",7,6,5,0.8333333333333334,Knife or cutting instrument,1
61992714,1,"Janesville, WI",10,6,5,0.8333333333333334,Other or type unknown,1
63004652,2,"Bowling Green, KY",1,6,5,0.8333333333333334,"Blunt object - hammer, club, etc",1
63924382,2,"Syracuse, NY",5,6,5,0.8333333333333334,"Firearm, type not stated",1
64557011,1,"San Antonio, TX",2,6,5,0.8333333333333334,Drowning,1
66116590,2,"Redding, CA",1,6,5,0.8333333333333334,"Blunt object - hammer, club, etc",1
66639352,1,"Dalton, GA",1,6,5,0.8333333333333334,"Blunt object - hammer, club, etc",1
66757314,2,"Las Cruces, NM",14,6,5,0.8333333333333334,Rifle,1
67361792,1,"Fort Smith, AR-OK",16,6,5,0.8333333333333334,Strangulation - hanging,1
68271234,1,"Clarksville, TN-KY",0,6,5,0.8333333333333334,Asphyxiation - includes death by gas,1
69144377,2,"Madison, WI",8,6,5,0.8333333333333334,"Narcotics or drugs, sleeping pills",1
69787318,2,"Killeen-Temple-Fort Hood, TX",16,6,5,0.8333333333333334,Strangulation - hanging,1
71198026,2,Rural Iowa,0,6,5,0.8333333333333334,Asphyxiation - includes death by gas,1
71330647,1,"Binghamton, NY",15,6,5,0.8333333333333334,Shotgun,1
71782026,2,"Eau Claire, WI",10,6,5,0.8333333333333334,Other or type unknown,1
71968851,1,"Punta Gorda, FL",1,6,5,0.8333333333333334,"Blunt object - hammer, club, etc",1
73420876,2,"Winchester, VA-WV",7,6,5,0.8333333333333334,Knife or cutting instrument,1
73568100,1,"Clarksville, TN-KY",1,6,5,0.8333333333333334,"Blunt object - hammer, club, etc",1
74126028,2,"Valdosta, GA",11,6,5,0.8333333333333334,"Personal weapons, includes beating",1
75846662,1,"Morristown, TN",10,6,5,0.8333333333333334,Other or type unknown,1
75889725,1,"Brownsville-Harlingen, TX",16,6,5,0.8333333333333334,Strangulation - hanging,1
75934590,2,"Harrisburg-Carlisle, PA",4,6,5,0.8333333333333334,Fire,1
77024399,2,"Huntington-Ashland, WV-KY-OH",1,6,5,0.8333333333333334,"Blunt object - hammer, club, etc",1
77813391,2,"Appleton, WI",11,6,5,0.8333333333333334,"Personal weapons, includes beating",1
78463192,1,"Mount Vernon-Anacortes, WA",8,6,5,0.8333333333333334,"Narcotics or drugs, sleeping pills",1
78494403,1,"Harrisonburg, VA",5,6,5,0.8333333333333334,"Firearm, type not stated",1
78863649,2,Rural Vermont,5,6,5,0.8333333333333334,"Firearm, type not stated",1
79464510,1,Rural California,2,6,5,0.8333333333333334,Drowning,1
81210064,2,"Pittsburgh, PA",2,6,5,0.8333333333333334,Drowning,1
81361801,2,Rural California,2,6,5,0.8333333333333334,Drowning,1
83546209,1,"Rochester, MN",5,6,5,0.8333333333333334,"Firearm, type not stated",1
87890202,2,"Vineland-Millville-Bridgeton, NJ",10,6,5,0.8333333333333334,Other or type unknown,1
88377496,2,"Baton Rouge, LA",2,6,5,0.8333333333333334,Drowning,1
88899469,1,"Morgantown, WV",15,6,5,0.8333333333333334,Shotgun,1
89005858,1,Rural West Virginia,0,6,5,0.8333333333333334,Asphyxiation - includes death by gas,1
89701305,1,"Des Moines, IA",9,6,5,0.8333333333333334,Other gun,1
94544991,1,"Scranton--Wilkes-Barre, PA",9,6,5,0.8333333333333334,Other gun,1
95362482,1,"Louisville, KY-IN",8,6,5,0.8333333333333334,"Narcotics or drugs, sleeping pills",1
96410271,2,"Champaign-Urbana, IL",11,6,5,0.8333333333333334,"Personal weapons, includes beating",1
96955902,1,"Wheeling, WV-OH",14,6,5,0.8333333333333334,Rifle,1
98012556,2,"Norwich-New London, CT",1,6,5,0.8333333333333334,"Blunt object - hammer, club, etc",1
99388732,2,Rural Oregon,2,6,5,0.8333333333333334,Drowning,1
99553134,2,"Lebanon, PA",4,6,5,0.8333333333333334,Fire,1
10925,2,"Napa, CA",11,5,4,0.8,"Personal weapons, includes beating",1
399238,2,"McAllen-Edinburg-Mission, TX",0,5,4,0.8,Asphyxiation - includes death by gas,1
428114,2,"Altoona, PA",10,5,4,0.8,Other or type unknown,1
1620067,1,"Flagstaff, AZ",5,5,4,0.8,"Firearm, type not stated",1
1637775,2,"Hickory-Lenoir-Morganton, NC",5,5,4,0.8,"Firearm, type not stated",1
4604962,2,"Fort Walton Beach-Destin, FL",5,5,4,0.8,"Firearm, type not stated",1
5146163,2,"Fresno, CA",8,5,4,0.8,"Narcotics or drugs, sleeping pills",1
10394983,1,"Colorado Springs, CO",4,5,4,0.8,Fire,1
10855451,2,"Morgantown, WV",7,5,4,0.8,Knife or cutting instrument,1
11104220,1,Rural Iowa,4,5,4,0.8,Fire,1
11333831,2,"Albany-Schenectady-Troy, NY",17,5,4,0.8,Weapon Not Reported,1
11358196,2,"Grand Junction, CO",14,5,4,0.8,Rifle,1
12627340,2,"Farmington, NM",1,5,4,0.8,"Blunt object - hammer, club, etc",1
13894926,2,"El Centro, CA",10,5,4,0.8,Other or type unknown,1
14503005,1,Rural Iowa,9,5,4,0.8,Other gun,1
15562414,2,"Victoria, TX",14,5,4,0.8,Rifle,1
17161876,2,Rural Georgia,9,5,4,0.8,Other gun,1
17757156,1,"Lubbock, TX",4,5,4,0.8,Fire,1
20283027,2,Rural Georgia,8,5,4,0.8,"Narcotics or drugs, sleeping pills",1
20345826,1,"Lima, OH",8,5,4,0.8,"Narcotics or drugs, sleeping pills",1
20951500,2,"Springfield, OH",15,5,4,0.8,Shotgun,1
21634369,2,Rural Pennsylvania,9,5,4,0.8,Other gun,1
22384935,1,Rural Kentucky,12,5,4,0.8,Poison - does not include gas,1
22566591,2,Rural Nebraska,4,5,4,0.8,Fire,1
24319374,1,"Lake Charles, LA",4,5,4,0.8,Fire,1
24455855,9,"Washington-Arlington-Alexandria, DC-VA-MD-WV",6,5,4,0.8,"Handgun - pistol, revolver, etc",1
26929796,9,"Oklahoma City, OK",10,5,4,0.8,Other or type unknown,1
27285707,1,"Charleston, WV",8,5,4,0.8,"Narcotics or drugs, sleeping pills",1
31380158,1,"Madera, CA",2,5,4,0.8,Drowning,1
31715018,2,"Canton-Massillon, OH",14,5,4,0.8,Rifle,1
32172376,2,"Longview, WA",7,5,4,0.8,Knife or cutting instrument,1
32511476,1,"Spartanburg, SC",0,5,4,0.8,Asphyxiation - includes death by gas,1
34095274,1,"Harrisburg-Carlisle, PA",9,5,4,0.8,Other gun,1
34317922,1,"Decatur, AL",1,5,4,0.8,"Blunt object - hammer, club, etc",1
34522055,1,"Lafayette, IN",10,5,4,0.8,Other or type unknown,1
35784962,1,"Athens-Clarke County, GA",11,5,4,0.8,"Personal weapons, includes beating",1
36628401,2,"Sioux Falls, SD",0,5,4,0.8,Asphyxiation - includes death by gas,1
36771997,1,"Bridgeport-Stamford-Norwalk, CT",0,5,4,0.8,Asphyxiation - includes death by gas,1
36969504,1,"Punta Gorda, FL",10,5,4,0.8,Other or type unknown,1
37227015,2,"Sarasota-Bradenton-Venice, FL",14,5,4,0.8,Rifle,1
37478514,1,"Houma-Bayou Cane-Thibodaux, LA",9,5,4,0.8,Other gun,1
37708428,2,"Decatur, AL",15,5,4,0.8,Shotgun,1
40266046,2,"Colorado Springs, CO",8,5,4,0.8,"Narcotics or drugs, sleeping pills",1
41814470,1,"Asheville, NC",8,5,4,0.8,"Narcotics or drugs, sleeping pills",1
42061983,1,"Cleveland, TN",10,5,4,0.8,Other or type unknown,1
44941545,2,"Casper, WY",10,5,4,0.8,Other or type unknown,1
45872717,1,"Roanoke, VA",8,5,4,0.8,"Narcotics or drugs, sleeping pills",1
46446529,1,"Honolulu, HI",0,5,4,0.8,Asphyxiation - includes death by gas,1
46885035,2,"Redding, CA",5,5,4,0.8,"Firearm, type not stated",1
47740202,1,Rural Oregon,8,5,4,0.8,"Narcotics or drugs, sleeping pills",1
49428878,1,"Fresno, CA",2,5,4,0.8,Drowning,1
49786022,1,"Topeka, KS",0,5,4,0.8,Asphyxiation - includes death by gas,1
50552628,1,"Pensacola-Ferry Pass-Brent, FL",4,5,4,0.8,Fire,1
51165225,1,"Cumberland, MD-WV",16,5,4,0.8,Strangulation - hanging,1
51702009,1,"Corvallis, OR",10,5,4,0.8,Other or type unknown,1
52257932,1,"La Crosse, WI-MN",1,5,4,0.8,"Blunt object - hammer, club, etc",1
54116372,2,"Fond du Lac, WI",7,5,4,0.8,Knife or cutting instrument,1
56198421,2,"Lancaster, PA",5,5,4,0.8,"Firearm, type not stated",1
59227371,1,"Florence-Muscle Shoals, AL",11,5,4,0.8,"Personal weapons, includes beating",1
59686943,2,Rural Oregon,9,5,4,0.8,Other gun,1
59804467,2,"Ocean City, NJ",7,5,4,0.8,Knife or cutting instrument,1
60189913,1,"Rochester, MN",15,5,4,0.8,Shotgun,1
60328216,2,"Sherman-Denison, TX",15,5,4,0.8,Shotgun,1
60440881,2,"Glens Falls, NY",10,5,4,0.8,Other or type unknown,1
60472486,2,"Indianapolis, IN",8,5,4,0.8,"Narcotics or drugs, sleeping pills",1
61814733,2,"Kalamazoo-Portage, MI",4,5,4,0.8,Fire,1
61920588,2,Rural Wyoming,8,5,4,0.8,"Narcotics or drugs, sleeping pills",1
61932914,2,"Fargo, ND-MN",10,5,4,0.8,Other or type unknown,1
66426796,1,"Honolulu, HI",13,5,4,0.8,Pushed or thrown out window,1
66986794,2,"Owensboro, KY",11,5,4,0.8,"Personal weapons, includes beating",1
67353408,2,"Kingston, NY",16,5,4,0.8,Strangulation - hanging,1
68410112,2,"College Station-Bryan, TX",5,5,4,0.8,"Firearm, type not stated",1
69182726,2,"York-Hanover, PA",4,5,4,0.8,Fire,1
69211877,2,"Ogden-Clearfield, UT",16,5,4,0.8,Strangulation - hanging,1
69569226,2,"Burlington-South Burlington, VT",10,5,4,0.8,Other or type unknown,1
71471792,2,"Green Bay, WI",1,5,4,0.8,"Blunt object - hammer, club, etc",1
71609661,2,Rural Alaska,8,5,4,0.8,"Narcotics or drugs, sleeping pills",1
73723857,1,"St. Cloud, MN",1,5,4,0.8,"Blunt object - hammer, club, etc",1
74441945,1,"Cumberland, MD-WV",1,5,4,0.8,"Blunt object - hammer, club, etc",1
76170047,2,"Billings, MT",11,5,4,0.8,"Personal weapons, includes beating",1
76422885,2,"Longview, WA",10,5,4,0.8,Other or type unknown,1
77484383,2,"Bremerton-Silverdale, WA",10,5,4,0.8,Other or type unknown,1
77689862,1,"Mansfield, OH",1,5,4,0.8,"Blunt object - hammer, club, etc",1
77786050,1,"Modesto, CA",0,5,4,0.8,Asphyxiation - includes death by gas,1
79382931,2,"Mobile, AL",16,5,4,0.8,Strangulation - hanging,1
81160400,1,"Bakersfield, CA",8,5,4,0.8,"Narcotics or drugs, sleeping pills",1
81799913,2,"Ithaca, NY",11,5,4,0.8,"Personal weapons, includes beating",1
82430918,2,"Erie, PA",16,5,4,0.8,Strangulation - hanging,1
82620097,1,"Gulfport-Biloxi, MS",9,5,4,0.8,Other gun,1
85396917,2,"Macon, GA",0,5,4,0.8,Asphyxiation - includes death by gas,1
85806954,1,"Johnson City, TN",8,5,4,0.8,"Narcotics or drugs, sleeping pills",1
86157543,2,"Bloomington, IN",10,5,4,0.8,Other or type unknown,1
87407801,2,"San Luis Obispo-Paso Robles, CA",0,5,4,0.8,Asphyxiation - includes death by gas,1
88289325,2,"Wausau, WI",10,5,4,0.8,Other or type unknown,1
88763517,1,"Winchester, VA-WV",8,5,4,0.8,"Narcotics or drugs, sleeping pills",1
89991945,1,"Oxnard-Thousand Oaks-Ventura, CA",0,5,4,0.8,Asphyxiation - includes death by gas,1
90465787,2,"San Luis Obispo-Paso Robles, CA",10,5,4,0.8,Other or type unknown,1
90489254,1,"Punta Gorda, FL",11,5,4,0.8,"Personal weapons, includes beating",1
90820462,2,"Hartford, CT",8,5,4,0.8,"Narcotics or drugs, sleeping pills",1
91818362,1,"Tuscaloosa, AL",1,5,4,0.8,"Blunt object - hammer, club, etc",1
93026252,2,"Bangor, ME",10,5,4,0.8,Other or type unknown,1
93801861,1,"Glens Falls, NY",10,5,4,0.8,Other or type unknown,1
94888176,1,"Barnstable Town, MA",1,5,4,0.8,"Blunt object - hammer, club, etc",1
95277249,2,"Longview, WA",16,5,4,0.8,Strangulation - hanging,1
95697637,1,"Bloomington-Normal, IL",1,5,4,0.8,"Blunt object - hammer, club, etc",1
95988452,2,"Syracuse, NY",0,5,4,0.8,Asphyxiation - includes death by gas,1
96219443,2,"St. Joseph, MO-KS",1,5,4,0.8,"Blunt object - hammer, club, etc",1
98366629,2,"Dover, DE",10,5,4,0.8,Other or type unknown,1
99174093,2,"Fort Wayne, IN",8,5,4,0.8,"Narcotics or drugs, sleeping pills",1
99635418,1,"Palm Bay-Melbourne-Titusville, FL",8,5,4,0.8,"Narcotics or drugs, sleeping pills",1
286936,2,"Vineland-Millville-Bridgeton, NJ",16,4,3,0.75,Strangulation - hanging,1
689175,2,"College Station-Bryan, TX",16,4,3,0.75,Strangulation - hanging,1
1007998,2,"Charleston, WV",16,4,3,0.75,Strangulation - hanging,1
1150129,1,"Bay City, MI",10,4,3,0.75,Other or type unknown,1
2547496,2,"Jonesboro, AR",1,4,3,0.75,"Blunt object - hammer, club, etc",1
3066655,1,"Wausau, WI",5,4,3,0.75,"Firearm, type not stated",1
4190660,1,"Racine, WI",4,4,3,0.75,Fire,1
5063611,2,"Anniston-Oxford, AL",14,4,3,0.75,Rifle,1
5787230,1,"Charleston, WV",16,4,3,0.75,Strangulation - hanging,1
6001086,1,"Bellingham, WA",4,4,3,0.75,Fire,1
6029220,2,"Hinesville-Fort Stewart, GA",5,4,3,0.75,"Firearm, type not stated",1
6474539,2,"Laredo, TX",16,4,3,0.75,Strangulation - hanging,1
6551400,1,"Philadelphia-Camden-Wilmington, PA-NJ-DE",12,4,3,0.75,Poison - does not include gas,1
6603136,2,"Salisbury, MD",0,4,3,0.75,Asphyxiation - includes death by gas,1
6629553,1,"Poughkeepsie-Newburgh-Middletown, NY",0,4,3,0.75,Asphyxiation - includes death by gas,1
6761638,2,"Champaign-Urbana, IL",5,4,3,0.75,"Firearm, type not stated",1
7598406,1,"State College, PA",14,4,3,0.75,Rifle,1
7621841,2,"Fort Wayne, IN",0,4,3,0.75,Asphyxiation - includes death by gas,1
8465743,1,"Sioux City, IA-NE-SD",1,4,3,0.75,"Blunt object - hammer, club, etc",1
8491017,1,Rural Illinois,16,4,3,0.75,Strangulation - hanging,1
8588795,2,"Pueblo, CO",15,4,3,0.75,Shotgun,1
8696851,2,"Waco, TX",14,4,3,0.75,Rifle,1
10005361,2,"Olympia, WA",16,4,3,0.75,Strangulation - hanging,1
10912590,1,"Chattanooga, TN-GA",4,4,3,0.75,Fire,1
10936032,1,"Casper, WY",14,4,3,0.75,Rifle,1
13082571,1,"Ithaca, NY",11,4,3,0.75,"Personal weapons, includes beating",1
13244628,1,"Palm Bay-Melbourne-Titusville, FL",4,4,3,0.75,Fire,1
14269556,2,Rural Idaho,16,4,3,0.75,Strangulation - hanging,1
14359023,2,"Chattanooga, TN-GA",9,4,3,0.75,Other gun,1
14511937,1,"Santa Rosa-Petaluma, CA",0,4,3,0.75,Asphyxiation - includes death by gas,1
15040192,1,"Toledo, OH",2,4,3,0.75,Drowning,1
15897571,2,"Duluth, MN-WI",5,4,3,0.75,"Firearm, type not stated",1
16473761,1,"Hattiesburg, MS",1,4,3,0.75,"Blunt object - hammer, club, etc",1
17056857,2,"Lawrence, KS",7,4,3,0.75,Knife or cutting instrument,1
17910771,2,Rural Montana,8,4,3,0.75,"Narcotics or drugs, sleeping pills",1
18063108,1,"Bakersfield, CA",9,4,3,0.75,Other gun,1
18569624,1,Rural Indiana,0,4,3,0.75,Asphyxiation - includes death by gas,1
18954864,2,"Lexington-Fayette, KY",4,4,3,0.75,Fire,1
19110261,1,"Janesville, WI",1,4,3,0.75,"Blunt object - hammer, club, etc",1
19361023,9,"Indianapolis, IN",6,4,3,0.75,"Handgun - pistol, revolver, etc",1
20050656,2,"Macon, GA",4,4,3,0.75,Fire,1
22373464,1,"Corpus Christi, TX",0,4,3,0.75,Asphyxiation - includes death by gas,1
22542881,2,"Trenton-Ewing, NJ",14,4,3,0.75,Rifle,1
23618693,1,"Little Rock-North Little Rock, AR",2,4,3,0.75,Drowning,1
23843539,1,"Owensboro, KY",14,4,3,0.75,Rifle,1
24569140,1,Rural Maine,2,4,3,0.75,Drowning,1
25056719,2,"Provo-Orem, UT",5,4,3,0.75,"Firearm, type not stated",1
25721973,2,"Wheeling, WV-OH",11,4,3,0.75,"Personal weapons, includes beating",1
27021634,2,"State College, PA",7,4,3,0.75,Knife or cutting instrument,1
27021770,9,"Columbus, OH",6,4,3,0.75,"Handgun - pistol, revolver, etc",1
27135651,2,"Amarillo, TX",16,4,3,0.75,Strangulation - hanging,1
28149660,2,"Youngstown-Warren-Boardman, OH-PA",9,4,3,0.75,Other gun,1
28466394,1,"Kingston, NY",4,4,3,0.75,Fire,1
28562215,1,"Wausau, WI",1,4,3,0.75,"Blunt object - hammer, club, etc",1
29213249,2,"Dalton, GA",1,4,3,0.75,"Blunt object - hammer, club, etc",1
29541460,1,"Cedar Rapids, IA",1,4,3,0.75,"Blunt object - hammer, club, etc",1
29953749,2,Rural Florida,0,4,3,0.75,Asphyxiation - includes death by gas,1
30689391,1,"Austin-Round Rock, TX",2,4,3,0.75,Drowning,1
31787216,1,"Lubbock, TX",16,4,3,0.75,Strangulation - hanging,1
32054933,2,"Sandusky, OH",7,4,3,0.75,Knife or cutting instrument,1
32789856,1,"Pittsfield, MA",10,4,3,0.75,Other or type unknown,1
32819276,9,"McAllen-Edinburg-Mission, TX",6,4,3,0.75,"Handgun - pistol, revolver, etc",1
33454792,2,"Lewiston-Auburn, ME",1,4,3,0.75,"Blunt object - hammer, club, etc",1
33815757,2,"Beaumont-Port Arthur, TX",4,4,3,0.75,Fire,1
34271112,2,"Scranton--Wilkes-Barre, PA",8,4,3,0.75,"Narcotics or drugs, sleeping pills",1
36464673,2,"Akron, OH",16,4,3,0.75,Strangulation - hanging,1
37563056,2,"Philadelphia-Camden-Wilmington, PA-NJ-DE",3,4,3,0.75,Explosives,1
37862650,1,"Winston-Salem, NC",16,4,3,0.75,Strangulation - hanging,1
38328840,1,"Jacksonville, NC",8,4,3,0.75,"Narcotics or drugs, sleeping pills",1
38566047,1,"Weirton-Steubenville, WV-OH",14,4,3,0.75,Rifle,1
41444539,2,"Evansville, IN-KY",0,4,3,0.75,Asphyxiation - includes death by gas,1
41596318,2,"Lewiston, ID-WA",7,4,3,0.75,Knife or cutting instrument,1
41662406,1,"Charlotte-Gastonia-Concord, NC-SC",12,4,3,0.75,Poison - does not include gas,1
41886804,1,"Williamsport, PA",8,4,3,0.75,"Narcotics or drugs, sleeping pills",1
43244486,2,"Danville, VA",16,4,3,0.75,Strangulation - hanging,1
44633678,1,"Greenville, SC",0,4,3,0.75,Asphyxiation - includes death by gas,1
45440653,2,"Boulder, CO",10,4,3,0.75,Other or type unknown,1
45460469,1,"Ames, IA",10,4,3,0.75,Other or type unknown,1
46884716,2,"Anderson, IN",10,4,3,0.75,Other or type unknown,1
47026568,2,"Michigan City-La Porte, IN",1,4,3,0.75,"Blunt object - hammer, club, etc",1
47937945,2,"Amarillo, TX",0,4,3,0.75,Asphyxiation - includes death by gas,1
51118446,9,"Little Rock-North Little Rock, AR",6,4,3,0.75,"Handgun - pistol, revolver, etc",1
51186102,1,Rural Utah,8,4,3,0.75,"Narcotics or drugs, sleeping pills",1
51921618,1,"Cheyenne, WY",1,4,3,0.75,"Blunt object - hammer, club, etc",1
53700922,1,"Grand Forks, ND-MN",10,4,3,0.75,Other or type unknown,1
55086597,2,"Corvallis, OR",7,4,3,0.75,Knife or cutting instrument,1
56047637,1,"Anderson, IN",10,4,3,0.75,Other or type unknown,1
57272037,2,"Bloomington-Normal, IL",10,4,3,0.75,Other or type unknown,1
57470962,2,"Brownsville-Harlingen, TX",0,4,3,0.75,Asphyxiation - includes death by gas,1
57561577,1,"Lexington-Fayette, KY",16,4,3,0.75,Strangulation - hanging,1
57797194,2,Rural Pennsylvania,12,4,3,0.75,Poison - does not include gas,1
58078501,1,"Knoxville, TN",0,4,3,0.75,Asphyxiation - includes death by gas,1
58497400,1,Rural Ohio,16,4,3,0.75,Strangulation - hanging,1
58881330,2,"Lincoln, NE",16,4,3,0.75,Strangulation - hanging,1
59885933,2,"Sheboygan, WI",10,4,3,0.75,Other or type unknown,1
59973296,1,"Elmira, NY",14,4,3,0.75,Rifle,1
61291511,2,"Modesto, CA",4,4,3,0.75,Fire,1
61643769,1,"St. Louis, MO-IL",12,4,3,0.75,Poison - does not include gas,1
62013555,1,"Visalia-Porterville, CA",4,4,3,0.75,Fire,1
62403841,1,"Dothan, AL",1,4,3,0.75,"Blunt object - hammer, club, etc",1
62560444,2,"Athens-Clarke County, GA",11,4,3,0.75,"Personal weapons, includes beating",1
62936425,1,"Harrisburg-Carlisle, PA",16,4,3,0.75,Strangulation - hanging,1
63314759,1,"St. Cloud, MN",5,4,3,0.75,"Firearm, type not stated",1
63708659,2,Rural Idaho,12,4,3,0.75,Poison - does not include gas,1
64004213,1,"Olympia, WA",4,4,3,0.75,Fire,1
65269162,1,"Vero Beach, FL",1,4,3,0.75,"Blunt object - hammer, club, etc",1
65694675,1,"Longview, WA",8,4,3,0.75,"Narcotics or drugs, sleeping pills",1
66523385,2,"Bremerton-Silverdale, WA",15,4,3,0.75,Shotgun,1
67382248,2,"Lafayette, LA",0,4,3,0.75,Asphyxiation - includes death by gas,1
69847242,1,"Bay City, MI",4,4,3,0.75,Fire,1
70749373,1,"Oxnard-Thousand Oaks-Ventura, CA",4,4,3,0.75,Fire,1
70955514,1,"Portland-Vancouver-Beaverton, OR-WA",13,4,3,0.75,Pushed or thrown out window,1
72759180,2,"Cleveland, TN",14,4,3,0.75,Rifle,1
72868517,2,"Evansville, IN-KY",1,4,3,0.75,"Blunt object - hammer, club, etc",1
73415328,2,"Springfield, MO",0,4,3,0.75,Asphyxiation - includes death by gas,1
74396908,1,"Ann Arbor, MI",8,4,3,0.75,"Narcotics or drugs, sleeping pills",1
74531741,9,"Toledo, OH",6,4,3,0.75,"Handgun - pistol, revolver, etc",1
74943050,1,"Kingsport-Bristol-Bristol, TN-VA",16,4,3,0.75,Strangulation - hanging,1
74959258,1,Rural Montana,9,4,3,0.75,Other gun,1
76662686,1,"Altoona, PA",8,4,3,0.75,"Narcotics or drugs, sleeping pills",1
77552829,2,"Kokomo, IN",7,4,3,0.75,Knife or cutting instrument,1
78832150,1,"Pine Bluff, AR",4,4,3,0.75,Fire,1
79631480,2,"Bowling Green, KY",8,4,3,0.75,"Narcotics or drugs, sleeping pills",1
79763856,2,"Kokomo, IN",1,4,3,0.75,"Blunt object - hammer, club, etc",1
79963842,1,"Carson City, NV",5,4,3,0.75,"Firearm, type not stated",1
80116708,9,"Florence-Muscle Shoals, AL",10,4,3,0.75,Other or type unknown,1
80589034,1,"Waterloo-Cedar Falls, IA",1,4,3,0.75,"Blunt object - hammer, club, etc",1
80592804,2,"Lexington-Fayette, KY",0,4,3,0.75,Asphyxiation - includes death by gas,1
80995376,2,Rural Delaware,16,4,3,0.75,Strangulation - hanging,1
81168907,2,"Jackson, MI",4,4,3,0.75,Fire,1
81724343,1,"Baltimore-Towson, MD",12,4,3,0.75,Poison - does not include gas,1
81763025,2,"Dothan, AL",14,4,3,0.75,Rifle,1
81831944,2,"Charleston-North Charleston, SC",16,4,3,0.75,Strangulation - hanging,1
82154059,1,"Evansville, IN-KY",8,4,3,0.75,"Narcotics or drugs, sleeping pills",1
82250199,1,"Bangor, ME",10,4,3,0.75,Other or type unknown,1
83122277,2,"Harrisonburg, VA",1,4,3,0.75,"Blunt object - hammer, club, etc",1
84608610,2,"Colorado Springs, CO",9,4,3,0.75,Other gun,1
85708675,2,"Decatur, AL",1,4,3,0.75,"Blunt object - hammer, club, etc",1
86043814,1,"Wausau, WI",8,4,3,0.75,"Narcotics or drugs, sleeping pills",1
86364147,1,"Wilmington, NC",8,4,3,0.75,"Narcotics or drugs, sleeping pills",1
87739284,1,"Winchester, VA-WV",1,4,3,0.75,"Blunt object - hammer, club, etc",1
88061920,2,"Lawrence, KS",11,4,3,0.75,"Personal weapons, includes beating",1
88088889,2,Rural New York,17,4,3,0.75,Weapon Not Reported,1
88843196,1,"Albany-Schenectady-Troy, NY",8,4,3,0.75,"Narcotics or drugs, sleeping pills",1
88922100,2,"Phoenix-Mesa-Scottsdale, AZ",9,4,3,0.75,Other gun,1
88925671,1,"Saginaw, MI",8,4,3,0.75,"Narcotics or drugs, sleeping pills",1
89421010,2,"Pascagoula, MS",1,4,3,0.75,"Blunt object - hammer, club, etc",1
91264835,2,"El Centro, CA",16,4,3,0.75,Strangulation - hanging,1
92000613,1,"Vineland-Millville-Bridgeton, NJ",9,4,3,0.75,Other gun,1
92048522,2,Rural Florida,8,4,3,0.75,"Narcotics or drugs, sleeping pills",1
92146629,1,"Beaumont-Port Arthur, TX",16,4,3,0.75,Strangulation - hanging,1
92449074,2,"Altoona, PA",11,4,3,0.75,"Personal weapons, includes beating",1
92879191,2,"Fargo, ND-MN",15,4,3,0.75,Shotgun,1
94252776,2,"Salt Lake City, UT",2,4,3,0.75,Drowning,1
94583058,1,"Lexington-Fayette, KY",4,4,3,0.75,Fire,1
96081674,1,"Pittsfield, MA",1,4,3,0.75,"Blunt object - hammer, club, etc",1
96487430,2,"Austin-Round Rock, TX",8,4,3,0.75,"Narcotics or drugs, sleeping pills",1
96594240,2,"Utica-Rome, NY",4,4,3,0.75,Fire,1
96703903,2,"Anderson, IN",16,4,3,0.75,Strangulation - hanging,1
96832808,9,"Tulsa, OK",6,4,3,0.75,"Handgun - pistol, revolver, etc",1
96917701,2,"Bellingham, WA",4,4,3,0.75,Fire,1
98524911,1,"Merced, CA",16,4,3,0.75,Strangulation - hanging,1
98687051,2,"Lawrence, KS",10,4,3,0.75,Other or type unknown,1
99123445,2,"Hickory-Lenoir-Morganton, NC",16,4,3,0.75,Strangulation - hanging,1
99197899,9,"Nashville-Davidson-Murfreesboro, TN",6,4,3,0.75,"Handgun - pistol, revolver, etc",1
99350492,1,Rural Oklahoma,12,4,3,0.75,Poison - does not include gas,1
99686515,1,Rural South Dakota,4,4,3,0.75,Fire,1
208635,1,"Muncie, IN",14,3,2,0.6666666666666666,Rifle,1
572505,1,"Jacksonville, NC",4,3,2,0.6666666666666666,Fire,1
669341,2,"Youngstown-Warren-Boardman, OH-PA",8,3,2,0.6666666666666666,"Narcotics or drugs, sleeping pills",1
744274,1,"Yakima, WA",0,3,2,0.6666666666666666,Asphyxiation - includes death by gas,1
1088976,9,"Chicago-Naperville-Joliet, IL-IN-WI",11,3,2,0.6666666666666666,"Personal weapons, includes beating",1
1635936,1,"Lincoln, NE",0,3,2,0.6666666666666666,Asphyxiation - includes death by gas,1
1843542,2,"Columbia, MO",16,3,2,0.6666666666666666,Strangulation - hanging,1
2388193,1,"Columbus, IN",15,3,2,0.6666666666666666,Shotgun,1
2634769,1,Rural Pennsylvania,13,3,2,0.6666666666666666,Pushed or thrown out window,1
3353193,2,"Decatur, IL",1,3,2,0.6666666666666666,"Blunt object - hammer, club, etc",1
3522159,1,Rural New Hampshire,16,3,2,0.6666666666666666,Strangulation - hanging,1
4780503,1,"Dubuque, IA",14,3,2,0.6666666666666666,Rifle,1
4891024,9,"Baton Rouge, LA",6,3,2,0.6666666666666666,"Handgun - pistol, revolver, etc",1
5562888,2,"Ocean City, NJ",4,3,2,0.6666666666666666,Fire,1
6315127,9,Rural Tennessee,15,3,2,0.6666666666666666,Shotgun,1
6359191,2,"Racine, WI",0,3,2,0.6666666666666666,Asphyxiation - includes death by gas,1
6642786,9,"Boston-Cambridge-Quincy, MA-NH",10,3,2,0.6666666666666666,Other or type unknown,1
6893245,1,"Fayetteville, NC",16,3,2,0.6666666666666666,Strangulation - hanging,1
6943024,2,"Des Moines, IA",0,3,2,0.6666666666666666,Asphyxiation - includes death by gas,1
7112182,1,"Lansing-East Lansing, MI",9,3,2,0.6666666666666666,Other gun,1
7308086,2,"Fayetteville, NC",0,3,2,0.6666666666666666,Asphyxiation - includes death by gas,1
7750503,1,"Santa Fe, NM",16,3,2,0.6666666666666666,Strangulation - hanging,1
7896891,2,"Lake Charles, LA",1,3,2,0.6666666666666666,"Blunt object - hammer, club, etc",1
8265998,2,"Charleston-North Charleston, SC",8,3,2,0.6666666666666666,"Narcotics or drugs, sleeping pills",1
9430942,9,Rural North Carolina,7,3,2,0.6666666666666666,Knife or cutting instrument,1
9805701,2,"Fargo, ND-MN",5,3,2,0.6666666666666666,"Firearm, type not stated",1
9920938,2,"Atlanta-Sandy Springs-Marietta, GA",13,3,2,0.6666666666666666,Pushed or thrown out window,1
11178903,1,"Albany, GA",9,3,2,0.6666666666666666,Other gun,1
11223009,9,"Detroit-Warren-Livonia, MI",14,3,2,0.6666666666666666,Rifle,1
11854927,9,Rural Nevada,10,3,2,0.6666666666666666,Other or type unknown,1
11915948,2,"Battle Creek, MI",16,3,2,0.6666666666666666,Strangulation - hanging,1
12968389,2,Rural South Dakota,16,3,2,0.6666666666666666,Strangulation - hanging,1
13760623,1,"Washington-Arlington-Alexandria, DC-VA-MD-WV",13,3,2,0.6666666666666666,Pushed or thrown out window,1
13947518,1,"Sarasota-Bradenton-Venice, FL",9,3,2,0.6666666666666666,Other gun,1
14032947,2,"Hanford-Corcoran, CA",0,3,2,0.6666666666666666,Asphyxiation - includes death by gas,1
14575937,2,"Salt Lake City, UT",8,3,2,0.6666666666666666,"Narcotics or drugs, sleeping pills",1
15067574,1,"Casper, WY",5,3,2,0.6666666666666666,"Firearm, type not stated",1
15967672,2,"Battle Creek, MI",14,3,2,0.6666666666666666,Rifle,1
16303569,1,"Salt Lake City, UT",8,3,2,0.6666666666666666,"Narcotics or drugs, sleeping pills",1
16421388,1,"Springfield, IL",16,3,2,0.6666666666666666,Strangulation - hanging,1
16664301,1,"Sandusky, OH",10,3,2,0.6666666666666666,Other or type unknown,1
16836218,1,"Missoula, MT",1,3,2,0.6666666666666666,"Blunt object - hammer, club, etc",1
16955336,1,"Lexington-Fayette, KY",0,3,2,0.6666666666666666,Asphyxiation - includes death by gas,1
18393637,1,"Little Rock-North Little Rock, AR",3,3,2,0.6666666666666666,Explosives,1
19014095,9,"Richmond, VA",5,3,2,0.6666666666666666,"Firearm, type not stated",1
19257555,2,"Naples-Marco Island, FL",16,3,2,0.6666666666666666,Strangulation - hanging,1
20044146,1,"Manchester-Nashua, NH",8,3,2,0.6666666666666666,"Narcotics or drugs, sleeping pills",1
20455541,1,"Decatur, AL",4,3,2,0.6666666666666666,Fire,1
20611164,1,"Beaumont-Port Arthur, TX",2,3,2,0.6666666666666666,Drowning,1
21030467,1,"Rochester, NY",9,3,2,0.6666666666666666,Other gun,1
22120964,1,"Pueblo, CO",2,3,2,0.6666666666666666,Drowning,1
22477912,1,Rural Tennessee,9,3,2,0.6666666666666666,Other gun,1
22864961,1,"Riverside-San Bernardino, CA",12,3,2,0.6666666666666666,Poison - does not include gas,1
23032461,2,"Waco, TX",0,3,2,0.6666666666666666,Asphyxiation - includes death by gas,1
23274451,1,"State College, PA",8,3,2,0.6666666666666666,"Narcotics or drugs, sleeping pills",1
23382072,1,"Fort Smith, AR-OK",0,3,2,0.6666666666666666,Asphyxiation - includes death by gas,1
23574523,1,"Bowling Green, KY",14,3,2,0.6666666666666666,Rifle,1
24950911,1,"Alexandria, LA",9,3,2,0.6666666666666666,Other gun,1
24965167,2,Rural West Virginia,2,3,2,0.6666666666666666,Drowning,1
25433267,2,"Prescott, AZ",0,3,2,0.6666666666666666,Asphyxiation - includes death by gas,1
25435690,2,"Columbus, OH",3,3,2,0.6666666666666666,Explosives,1
25872082,2,"Lebanon, PA",5,3,2,0.6666666666666666,"Firearm, type not stated",1
25957026,1,"Lynchburg, VA",8,3,2,0.6666666666666666,"Narcotics or drugs, sleeping pills",1
25994339,2,"Billings, MT",14,3,2,0.6666666666666666,Rifle,1
26376159,1,"Hinesville-Fort Stewart, GA",14,3,2,0.6666666666666666,Rifle,1
27867626,1,Rural Alabama,2,3,2,0.6666666666666666,Drowning,1
28186543,1,"Chattanooga, TN-GA",9,3,2,0.6666666666666666,Other gun,1
28482674,2,"Boise City-Nampa, ID",16,3,2,0.6666666666666666,Strangulation - hanging,1
29382556,2,"Little Rock-North Little Rock, AR",12,3,2,0.6666666666666666,Poison - does not include gas,1
29410608,1,"Kalamazoo-Portage, MI",4,3,2,0.6666666666666666,Fire,1
29639662,2,"Longview, WA",1,3,2,0.6666666666666666,"Blunt object - hammer, club, etc",1
30949367,2,"Gadsden, AL",1,3,2,0.6666666666666666,"Blunt object - hammer, club, etc",1
31357977,1,Rural Louisiana,0,3,2,0.6666666666666666,Asphyxiation - includes death by gas,1
32190155,1,"Albuquerque, NM",2,3,2,0.6666666666666666,Drowning,1
33431726,2,"Jefferson City, MO",5,3,2,0.6666666666666666,"Firearm, type not stated",1
33622902,1,"Nashville-Davidson-Murfreesboro, TN",2,3,2,0.6666666666666666,Drowning,1
33629655,2,"Salisbury, MD",10,3,2,0.6666666666666666,Other or type unknown,1
33733823,2,"Stockton, CA",8,3,2,0.6666666666666666,"Narcotics or drugs, sleeping pills",1
33793659,1,"Lebanon, PA",1,3,2,0.6666666666666666,"Blunt object - hammer, club, etc",1
34311617,2,"Corvallis, OR",1,3,2,0.6666666666666666,"Blunt object - hammer, club, etc",1
34646822,9,Rural North Carolina,6,3,2,0.6666666666666666,"Handgun - pistol, revolver, etc",1
34805335,2,"Oklahoma City, OK",9,3,2,0.6666666666666666,Other gun,1
35258146,1,"Manchester-Nashua, NH",0,3,2,0.6666666666666666,Asphyxiation - includes death by gas,1
35441946,9,"Louisville, KY-IN",4,3,2,0.6666666666666666,Fire,1
35788699,2,"Pueblo, CO",0,3,2,0.6666666666666666,Asphyxiation - includes death by gas,1
36196703,2,"Hattiesburg, MS",1,3,2,0.6666666666666666,"Blunt object - hammer, club, etc",1
36636158,2,"Chicago-Naperville-Joliet, IL-IN-WI",3,3,2,0.6666666666666666,Explosives,1
37347993,1,"San Luis Obispo-Paso Robles, CA",16,3,2,0.6666666666666666,Strangulation - hanging,1
37417622,2,"Erie, PA",0,3,2,0.6666666666666666,Asphyxiation - includes death by gas,1
37599173,1,Rural Missouri,12,3,2,0.6666666666666666,Poison - does not include gas,1
38016939,1,"Corvallis, OR",15,3,2,0.6666666666666666,Shotgun,1
38181818,2,"Janesville, WI",4,3,2,0.6666666666666666,Fire,1
38823922,2,"San Angelo, TX",16,3,2,0.6666666666666666,Strangulation - hanging,1
39224271,1,"Lima, OH",9,3,2,0.6666666666666666,Other gun,1
39955110,2,"Washington-Arlington-Alexandria, DC-VA-MD-WV",13,3,2,0.6666666666666666,Pushed or thrown out window,1
40012123,2,"Lake Charles, LA",2,3,2,0.6666666666666666,Drowning,1
40753389,2,"Asheville, NC",4,3,2,0.6666666666666666,Fire,1
40831266,2,"Dover, DE",16,3,2,0.6666666666666666,Strangulation - hanging,1
40950846,2,"St. Cloud, MN",11,3,2,0.6666666666666666,"Personal weapons, includes beating",1
41713886,1,"Lancaster, PA",9,3,2,0.6666666666666666,Other gun,1
41720347,9,Rural Pennsylvania,10,3,2,0.6666666666666666,Other or type unknown,1
41820043,2,"Shreveport-Bossier City, LA",2,3,2,0.6666666666666666,Drowning,1
42076900,2,"Clarksville, TN-KY",0,3,2,0.6666666666666666,Asphyxiation - includes death by gas,1
42123599,1,"Sheboygan, WI",1,3,2,0.6666666666666666,"Blunt object - hammer, club, etc",1
42534766,1,"Williamsport, PA",5,3,2,0.6666666666666666,"Firearm, type not stated",1
43157706,1,"Lawton, OK",8,3,2,0.6666666666666666,"Narcotics or drugs, sleeping pills",1
44144787,2,"Altoona, PA",1,3,2,0.6666666666666666,"Blunt object - hammer, club, etc",1
44455875,2,"Wheeling, WV-OH",4,3,2,0.6666666666666666,Fire,1
46198978,1,"Champaign-Urbana, IL",15,3,2,0.6666666666666666,Shotgun,1
46275144,1,"Pocatello, ID",15,3,2,0.6666666666666666,Shotgun,1
47221617,1,"Monroe, MI",8,3,2,0.6666666666666666,"Narcotics or drugs, sleeping pills",1
48487685,2,"Fresno, CA",4,3,2,0.6666666666666666,Fire,1
48593881,1,"Greenville, SC",8,3,2,0.6666666666666666,"Narcotics or drugs, sleeping pills",1
48743317,9,"Hickory-Lenoir-Morganton, NC",6,3,2,0.6666666666666666,"Handgun - pistol, revolver, etc",1
49254562,2,"Hanford-Corcoran, CA",5,3,2,0.6666666666666666,"Firearm, type not stated",1
49698207,2,"Houma-Bayou Cane-Thibodaux, LA",1,3,2,0.6666666666666666,"Blunt object - hammer, club, etc",1
50634278,1,"Wenatchee, WA",5,3,2,0.6666666666666666,"Firearm, type not stated",1
51469797,1,"Fort Collins-Loveland, CO",0,3,2,0.6666666666666666,Asphyxiation - includes death by gas,1
51544940,1,"Santa Rosa-Petaluma, CA",8,3,2,0.6666666666666666,"Narcotics or drugs, sleeping pills",1
51938411,9,"Minneapolis-St. Paul-Bloomington, MN-WI",5,3,2,0.6666666666666666,"Firearm, type not stated",1
52002673,2,"St. Joseph, MO-KS",16,3,2,0.6666666666666666,Strangulation - hanging,1
52713941,1,"Winchester, VA-WV",11,3,2,0.6666666666666666,"Personal weapons, includes beating",1
52797612,1,"Chico, CA",16,3,2,0.6666666666666666,Strangulation - hanging,1
53768037,2,"Manchester-Nashua, NH",0,3,2,0.6666666666666666,Asphyxiation - includes death by gas,1
53773436,2,"Shreveport-Bossier City, LA",0,3,2,0.6666666666666666,Asphyxiation - includes death by gas,1
53966847,2,"Albuquerque, NM",12,3,2,0.6666666666666666,Poison - does not include gas,1
54032179,2,"Clarksville, TN-KY",16,3,2,0.6666666666666666,Strangulation - hanging,1
54044726,1,"Asheville, NC",0,3,2,0.6666666666666666,Asphyxiation - includes death by gas,1
54633599,2,"Asheville, NC",8,3,2,0.6666666666666666,"Narcotics or drugs, sleeping pills",1
55402216,1,"Decatur, IL",4,3,2,0.6666666666666666,Fire,1
55822953,2,"Cincinnati-Middletown, OH-KY-IN",2,3,2,0.6666666666666666,Drowning,1
55952819,1,"Lawton, OK",0,3,2,0.6666666666666666,Asphyxiation - includes death by gas,1
57092885,1,"Duluth, MN-WI",4,3,2,0.6666666666666666,Fire,1
57338603,1,"Billings, MT",15,3,2,0.6666666666666666,Shotgun,1
57679256,2,"Savannah, GA",4,3,2,0.6666666666666666,Fire,1
57759762,2,"Worcester, MA",0,3,2,0.6666666666666666,Asphyxiation - includes death by gas,1
58429944,2,Rural Maine,16,3,2,0.6666666666666666,Strangulation - hanging,1
59106621,2,"Yuma, AZ",0,3,2,0.6666666666666666,Asphyxiation - includes death by gas,1
59672721,2,"Yakima, WA",16,3,2,0.6666666666666666,Strangulation - hanging,1
59929527,9,"Cleveland-Elyria-Mentor, OH",11,3,2,0.6666666666666666,"Personal weapons, includes beating",1
60275555,9,"Dallas-Fort Worth-Arlington, TX",5,3,2,0.6666666666666666,"Firearm, type not stated",1
60467043,9,"Tampa-St. Petersburg-Clearwater, FL",6,3,2,0.6666666666666666,"Handgun - pistol, revolver, etc",1
61954657,9,"Jackson, MS",10,3,2,0.6666666666666666,Other or type unknown,1
61993240,2,"Michigan City-La Porte, IN",4,3,2,0.6666666666666666,Fire,1
62398246,2,"Boston-Cambridge-Quincy, MA-NH",2,3,2,0.6666666666666666,Drowning,1
62453239,2,"Athens-Clarke County, GA",15,3,2,0.6666666666666666,Shotgun,1
63459872,1,"Cedar Rapids, IA",14,3,2,0.6666666666666666,Rifle,1
64032857,2,"Jackson, MI",8,3,2,0.6666666666666666,"Narcotics or drugs, sleeping pills",1
64153168,2,"Boston-Cambridge-Quincy, MA-NH",9,3,2,0.6666666666666666,Other gun,1
64168688,1,"Wenatchee, WA",10,3,2,0.6666666666666666,Other or type unknown,1
64867162,2,"Appleton, WI",5,3,2,0.6666666666666666,"Firearm, type not stated",1
66225717,2,"Cleveland, TN",1,3,2,0.6666666666666666,"Blunt object - hammer, club, etc",1
66398014,2,"Niles-Benton Harbor, MI",16,3,2,0.6666666666666666,Strangulation - hanging,1
66509817,1,Rural Wyoming,16,3,2,0.6666666666666666,Strangulation - hanging,1
66769141,1,"Abilene, TX",0,3,2,0.6666666666666666,Asphyxiation - includes death by gas,1
67557292,1,"Erie, PA",8,3,2,0.6666666666666666,"Narcotics or drugs, sleeping pills",1
67681153,1,"Pine Bluff, AR",16,3,2,0.6666666666666666,Strangulation - hanging,1
68415216,2,"Morristown, TN",11,3,2,0.6666666666666666,"Personal weapons, includes beating",1
68481771,2,"Dayton, OH",2,3,2,0.6666666666666666,Drowning,1
68802355,2,"Brunswick, GA",11,3,2,0.6666666666666666,"Personal weapons, includes beating",1
69517901,1,"Norwich-New London, CT",14,3,2,0.6666666666666666,Rifle,1
69996496,2,"Memphis, TN-MS-AR",8,3,2,0.6666666666666666,"Narcotics or drugs, sleeping pills",1
71032074,1,Rural Montana,8,3,2,0.6666666666666666,"Narcotics or drugs, sleeping pills",1
71298930,1,"Fond du Lac, WI",1,3,2,0.6666666666666666,"Blunt object - hammer, club, etc",1
71338527,1,"Yuma, AZ",16,3,2,0.6666666666666666,Strangulation - hanging,1
71449675,1,"Fort Walton Beach-Destin, FL",8,3,2,0.6666666666666666,"Narcotics or drugs, sleeping pills",1
72128706,9,"Fort Smith, AR-OK",10,3,2,0.6666666666666666,Other or type unknown,1
73160636,1,"Coeur d Alene, ID",5,3,2,0.6666666666666666,"Firearm, type not stated",1
73438450,1,Rural Utah,4,3,2,0.6666666666666666,Fire,1
73648695,2,"Michigan City-La Porte, IN",11,3,2,0.6666666666666666,"Personal weapons, includes beating",1
73740784,2,Rural Minnesota,4,3,2,0.6666666666666666,Fire,1
74087891,2,Rural Hawaii,5,3,2,0.6666666666666666,"Firearm, type not stated",1
75250533,1,Rural New Hampshire,4,3,2,0.6666666666666666,Fire,1
78165593,1,"Austin-Round Rock, TX",3,3,2,0.6666666666666666,Explosives,1
78191849,2,"Sarasota-Bradenton-Venice, FL",4,3,2,0.6666666666666666,Fire,1
78377225,1,"Sandusky, OH",14,3,2,0.6666666666666666,Rifle,1
78478710,1,"Gulfport-Biloxi, MS",2,3,2,0.6666666666666666,Drowning,1
78514070,1,Rural Alaska,16,3,2,0.6666666666666666,Strangulation - hanging,1
79462164,1,"Springfield, MA",16,3,2,0.6666666666666666,Strangulation - hanging,1
79594765,2,"Elmira, NY",4,3,2,0.6666666666666666,Fire,1
79809129,1,"Killeen-Temple-Fort Hood, TX",4,3,2,0.6666666666666666,Fire,1
79877692,1,"Omaha-Council Bluffs, NE-IA",2,3,2,0.6666666666666666,Drowning,1
80065156,2,"St. Joseph, MO-KS",15,3,2,0.6666666666666666,Shotgun,1
80488469,1,Rural Alabama,16,3,2,0.6666666666666666,Strangulation - hanging,1
81780656,2,"Valdosta, GA",0,3,2,0.6666666666666666,Asphyxiation - includes death by gas,1
82668985,1,"Lubbock, TX",9,3,2,0.6666666666666666,Other gun,1
83968883,1,"Bremerton-Silverdale, WA",16,3,2,0.6666666666666666,Strangulation - hanging,1
84174956,2,"Kingston, NY",5,3,2,0.6666666666666666,"Firearm, type not stated",1
84329085,1,"New Orleans-Metairie-Kenner, LA",3,3,2,0.6666666666666666,Explosives,1
84459484,2,"Wichita Falls, TX",16,3,2,0.6666666666666666,Strangulation - hanging,1
84768747,1,Rural Texas,12,3,2,0.6666666666666666,Poison - does not include gas,1
84823997,1,"Worcester, MA",9,3,2,0.6666666666666666,Other gun,1
84829885,2,"Fond du Lac, WI",0,3,2,0.6666666666666666,Asphyxiation - includes death by gas,1
86652566,1,"Parkersburg-Marietta-Vienna, WV-OH",4,3,2,0.6666666666666666,Fire,1
87309763,2,"Valdosta, GA",5,3,2,0.6666666666666666,"Firearm, type not stated",1
87526518,1,"Yuma, AZ",2,3,2,0.6666666666666666,Drowning,1
87536144,9,"Oklahoma City, OK",6,3,2,0.6666666666666666,"Handgun - pistol, revolver, etc",1
88187547,2,"Bend, OR",7,3,2,0.6666666666666666,Knife or cutting instrument,1
89171527,2,"Orlando-Kissimmee, FL",2,3,2,0.6666666666666666,Drowning,1
90383018,1,Rural Ohio,9,3,2,0.6666666666666666,Other gun,1
90772841,1,"Idaho Falls, ID",1,3,2,0.6666666666666666,"Blunt object - hammer, club, etc",1
90831755,2,"Jackson, MI",16,3,2,0.6666666666666666,Strangulation - hanging,1
91707273,2,"Lubbock, TX",0,3,2,0.6666666666666666,Asphyxiation - includes death by gas,1
91854631,9,"Orlando-Kissimmee, FL",6,3,2,0.6666666666666666,"Handgun - pistol, revolver, etc",1
93013851,2,Rural Arkansas,9,3,2,0.6666666666666666,Other gun,1
94909345,2,"Rapid City, SD",15,3,2,0.6666666666666666,Shotgun,1
96579876,1,"Lawrence, KS",5,3,2,0.6666666666666666,"Firearm, type not stated",1
97210051,2,"Monroe, MI",5,3,2,0.6666666666666666,"Firearm, type not stated",1
97229221,1,"Las Vegas-Paradise, NV",3,3,2,0.6666666666666666,Explosives,1
97250908,1,"Durham, NC",4,3,2,0.6666666666666666,Fire,1
98397830,1,"La Crosse, WI-MN",8,3,2,0.6666666666666666,"Narcotics or drugs, sleeping pills",1
98630705,1,Rural New Mexico,8,3,2,0.6666666666666666,"Narcotics or drugs, sleeping pills",1
99094197,2,"Elkhart-Goshen, IN",5,3,2,0.6666666666666666,"Firearm, type not stated",1
99252107,1,"Rochester, MN",1,3,2,0.6666666666666666,"Blunt object - hammer, club, etc",1
99697610,1,Rural North Carolina,2,3,2,0.6666666666666666,Drowning,1
293106,1,"Grand Junction, CO",0,2,1,0.5,Asphyxiation - includes death by gas,1
364994,2,Rural Virginia,12,2,1,0.5,Poison - does not include gas,1
467360,2,"Goldsboro, NC",1,2,1,0.5,"Blunt object - hammer, club, etc",1
591569,1,Rural Connecticut,10,2,1,0.5,Other or type unknown,1
1340936,2,"Orlando-Kissimmee, FL",0,2,1,0.5,Asphyxiation - includes death by gas,1
1743975,2,"Merced, CA",2,2,1,0.5,Drowning,1
1788363,1,"Sarasota-Bradenton-Venice, FL",0,2,1,0.5,Asphyxiation - includes death by gas,1
1860434,1,"Pocatello, ID",1,2,1,0.5,"Blunt object - hammer, club, etc",1
1876400,9,"Milwaukee-Waukesha-West Allis, WI",5,2,1,0.5,"Firearm, type not stated",1
2683887,2,"Pine Bluff, AR",4,2,1,0.5,Fire,1
3793914,2,"Rochester, MN",1,2,1,0.5,"Blunt object - hammer, club, etc",1
4141006,9,"Miami-Fort Lauderdale, FL",7,2,1,0.5,Knife or cutting instrument,1
4261194,1,"Grand Junction, CO",4,2,1,0.5,Fire,1
4882280,2,"San Antonio, TX",9,2,1,0.5,Other gun,1
5682664,1,"Winston-Salem, NC",4,2,1,0.5,Fire,1
6044444,2,"Kalamazoo-Portage, MI",0,2,1,0.5,Asphyxiation - includes death by gas,1
6123618,1,"Longview, TX",4,2,1,0.5,Fire,1
6182214,2,"Weirton-Steubenville, WV-OH",1,2,1,0.5,"Blunt object - hammer, club, etc",1
6316276,9,"Salt Lake City, UT",6,2,1,0.5,"Handgun - pistol, revolver, etc",1
6502680,1,"Chico, CA",4,2,1,0.5,Fire,1
6548618,1,"Yuma, AZ",0,2,1,0.5,Asphyxiation - includes death by gas,1
6904181,1,"Columbus, OH",3,2,1,0.5,Explosives,1
6933318,1,"Columbus, IN",10,2,1,0.5,Other or type unknown,1
7077501,1,Rural California,3,2,1,0.5,Explosives,1
7136755,9,"Fayetteville, NC",10,2,1,0.5,Other or type unknown,1
7183282,1,"Fairbanks, AK",4,2,1,0.5,Fire,1
8135847,1,"Jacksonville, NC",5,2,1,0.5,"Firearm, type not stated",1
8360105,2,"Bangor, ME",4,2,1,0.5,Fire,1
8795470,2,"Santa Barbara-Santa Maria, CA",4,2,1,0.5,Fire,1
9694119,9,"Rochester, NY",10,2,1,0.5,Other or type unknown,1
10089677,1,"Jackson, MS",16,2,1,0.5,Strangulation - hanging,1
10658693,1,"Orlando-Kissimmee, FL",16,2,1,0.5,Strangulation - hanging,1
10944349,1,"Evansville, IN-KY",0,2,1,0.5,Asphyxiation - includes death by gas,1
11418895,1,"Lebanon, PA",16,2,1,0.5,Strangulation - hanging,1
11768961,1,"Macon, GA",16,2,1,0.5,Strangulation - hanging,1
11780905,9,"Birmingham-Hoover, AL",14,2,1,0.5,Rifle,1
12436890,2,"Fort Collins-Loveland, CO",16,2,1,0.5,Strangulation - hanging,1
12600421,2,"Bend, OR",16,2,1,0.5,Strangulation - hanging,1
12611696,1,"Elmira, NY",4,2,1,0.5,Fire,1
12816069,1,"Port St. Lucie-Fort Pierce, FL",4,2,1,0.5,Fire,1
13204924,1,"Port St. Lucie-Fort Pierce, FL",16,2,1,0.5,Strangulation - hanging,1
13240812,1,"Atlanta-Sandy Springs-Marietta, GA",3,2,1,0.5,Explosives,1
14410400,2,"Akron, OH",9,2,1,0.5,Other gun,1
14775618,1,"Hagerstown-Martinsburg, MD-WV",16,2,1,0.5,Strangulation - hanging,1
14872232,1,"Chico, CA",8,2,1,0.5,"Narcotics or drugs, sleeping pills",1
15031365,2,"Danville, VA",0,2,1,0.5,Asphyxiation - includes death by gas,1
15114557,1,"Niles-Benton Harbor, MI",4,2,1,0.5,Fire,1
15748799,1,"Baton Rouge, LA",12,2,1,0.5,Poison - does not include gas,1
16370909,1,"Medford, OR",4,2,1,0.5,Fire,1
16390536,9,"New York-New Jersey-Long Island, NY-NJ",4,2,1,0.5,Fire,1
16493441,2,"Milwaukee-Waukesha-West Allis, WI",9,2,1,0.5,Other gun,1
16627558,1,"Fayetteville-Springdale-Rogers, AR-MO",8,2,1,0.5,"Narcotics or drugs, sleeping pills",1
16652847,1,"Lima, OH",14,2,1,0.5,Rifle,1
16903746,1,"Miami-Fort Lauderdale, FL",13,2,1,0.5,Pushed or thrown out window,1
17138641,9,"Seattle-Tacoma-Bellevue, WA",6,2,1,0.5,"Handgun - pistol, revolver, etc",1
17419136,1,"Lake Charles, LA",0,2,1,0.5,Asphyxiation - includes death by gas,1
17460692,1,"Bakersfield, CA",2,2,1,0.5,Drowning,1
18646887,2,"Nashville-Davidson-Murfreesboro, TN",3,2,1,0.5,Explosives,1
19335631,1,"Weirton-Steubenville, WV-OH",8,2,1,0.5,"Narcotics or drugs, sleeping pills",1
19928737,1,Rural Iowa,8,2,1,0.5,"Narcotics or drugs, sleeping pills",1
20549997,1,"Utica-Rome, NY",4,2,1,0.5,Fire,1
21470596,2,"Ithaca, NY",10,2,1,0.5,Other or type unknown,1
21515003,2,"Jacksonville, FL",2,2,1,0.5,Drowning,1
21599757,1,"Corvallis, OR",5,2,1,0.5,"Firearm, type not stated",1
22134801,2,"San Luis Obispo-Paso Robles, CA",5,2,1,0.5,"Firearm, type not stated",1
22221422,1,"El Centro, CA",16,2,1,0.5,Strangulation - hanging,1
22641890,2,"Appleton, WI",1,2,1,0.5,"Blunt object - hammer, club, etc",1
22943375,2,"Ocala, FL",16,2,1,0.5,Strangulation - hanging,1
24191699,2,"Alexandria, LA",8,2,1,0.5,"Narcotics or drugs, sleeping pills",1
24374123,1,"Kingston, NY",5,2,1,0.5,"Firearm, type not stated",1
24816416,1,Rural Florida,2,2,1,0.5,Drowning,1
25375192,1,Rural Illinois,9,2,1,0.5,Other gun,1
25417378,2,"Honolulu, HI",8,2,1,0.5,"Narcotics or drugs, sleeping pills",1
25683970,1,"Santa Fe, NM",9,2,1,0.5,Other gun,1
26697738,2,"Owensboro, KY",5,2,1,0.5,"Firearm, type not stated",1
26979306,1,Rural Kentucky,3,2,1,0.5,Explosives,1
27175478,9,"Montgomery, AL",6,2,1,0.5,"Handgun - pistol, revolver, etc",1
27184362,9,"Boston-Cambridge-Quincy, MA-NH",7,2,1,0.5,Knife or cutting instrument,1
27504848,1,Rural Virginia,12,2,1,0.5,Poison - does not include gas,1
27559306,9,"Dothan, AL",10,2,1,0.5,Other or type unknown,1
28234618,2,"Reading, PA",8,2,1,0.5,"Narcotics or drugs, sleeping pills",1
28502886,2,"Richmond, VA",9,2,1,0.5,Other gun,1
28916222,2,"Medford, OR",4,2,1,0.5,Fire,1
29485016,9,Rural Idaho,10,2,1,0.5,Other or type unknown,1
29685755,1,"Rapid City, SD",15,2,1,0.5,Shotgun,1
30369299,2,"Carson City, NV",1,2,1,0.5,"Blunt object - hammer, club, etc",1
30392988,2,"Springfield, MO",2,2,1,0.5,Drowning,1
30440517,1,"Allentown-Bethlehem-Easton, PA-NJ",12,2,1,0.5,Poison - does not include gas,1
30549516,9,"Gulfport-Biloxi, MS",10,2,1,0.5,Other or type unknown,1
32287534,1,"St. George, UT",5,2,1,0.5,"Firearm, type not stated",1
32583217,9,"Seattle-Tacoma-Bellevue, WA",7,2,1,0.5,Knife or cutting instrument,1
33057886,9,Rural Kentucky,5,2,1,0.5,"Firearm, type not stated",1
33797499,2,"Brunswick, GA",0,2,1,0.5,Asphyxiation - includes death by gas,1
33837550,1,Rural Arkansas,2,2,1,0.5,Drowning,1
34433480,1,Rural Alabama,9,2,1,0.5,Other gun,1
34774039,1,"Boston-Cambridge-Quincy, MA-NH",3,2,1,0.5,Explosives,1
35063841,2,"Mansfield, OH",1,2,1,0.5,"Blunt object - hammer, club, etc",1
35717755,1,"Parkersburg-Marietta-Vienna, WV-OH",16,2,1,0.5,Strangulation - hanging,1
36025603,1,Rural Alaska,8,2,1,0.5,"Narcotics or drugs, sleeping pills",1
36715178,2,"Williamsport, PA",14,2,1,0.5,Rifle,1
36821068,1,Rural Oklahoma,2,2,1,0.5,Drowning,1
37936106,9,"McAllen-Edinburg-Mission, TX",10,2,1,0.5,Other or type unknown,1
39193228,2,"Altoona, PA",7,2,1,0.5,Knife or cutting instrument,1
39250984,2,"Huntington-Ashland, WV-KY-OH",16,2,1,0.5,Strangulation - hanging,1
39704104,2,"Pine Bluff, AR",0,2,1,0.5,Asphyxiation - includes death by gas,1
40372446,1,"Flint, MI",0,2,1,0.5,Asphyxiation - includes death by gas,1
40552923,2,"Danville, IL",16,2,1,0.5,Strangulation - hanging,1
40750881,1,"Fayetteville-Springdale-Rogers, AR-MO",4,2,1,0.5,Fire,1
41880213,2,"Fort Wayne, IN",2,2,1,0.5,Drowning,1
41885120,9,"Reno-Sparks, NV",10,2,1,0.5,Other or type unknown,1
42000559,1,"Atlantic City, NJ",0,2,1,0.5,Asphyxiation - includes death by gas,1
42309606,2,Rural Indiana,8,2,1,0.5,"Narcotics or drugs, sleeping pills",1
44112345,1,"Syracuse, NY",9,2,1,0.5,Other gun,1
44664587,2,"Kingston, NY",0,2,1,0.5,Asphyxiation - includes death by gas,1
44738758,2,"Florence, SC",16,2,1,0.5,Strangulation - hanging,1
45539996,2,"Wichita Falls, TX",5,2,1,0.5,"Firearm, type not stated",1
45687001,9,"Charlotte-Gastonia-Concord, NC-SC",6,2,1,0.5,"Handgun - pistol, revolver, etc",1
45811600,2,"Punta Gorda, FL",4,2,1,0.5,Fire,1
45866238,1,"Texarkana, TX-Texarkana, AR",12,2,1,0.5,Poison - does not include gas,1
46057423,9,"Albany, GA",10,2,1,0.5,Other or type unknown,1
46598037,1,Rural Hawaii,9,2,1,0.5,Other gun,1
47034950,2,"Pittsfield, MA",5,2,1,0.5,"Firearm, type not stated",1
47915381,1,"Cheyenne, WY",16,2,1,0.5,Strangulation - hanging,1
48760554,1,"Columbus, OH",2,2,1,0.5,Drowning,1
49031334,1,"Santa Rosa-Petaluma, CA",16,2,1,0.5,Strangulation - hanging,1
49274576,1,"Farmington, NM",9,2,1,0.5,Other gun,1
49365980,2,"Morgantown, WV",8,2,1,0.5,"Narcotics or drugs, sleeping pills",1
49503681,2,"Longview, WA",0,2,1,0.5,Asphyxiation - includes death by gas,1
50733585,1,Rural California,9,2,1,0.5,Other gun,1
50925850,1,"Richmond, VA",13,2,1,0.5,Pushed or thrown out window,1
52080617,9,"Durham, NC",6,2,1,0.5,"Handgun - pistol, revolver, etc",1
52471942,9,"Columbus, OH",5,2,1,0.5,"Firearm, type not stated",1
52650346,2,"Holland-Grand Haven, MI",5,2,1,0.5,"Firearm, type not stated",1
52918977,9,"Kansas City, MO-KS",14,2,1,0.5,Rifle,1
53032592,9,"Naples-Marco Island, FL",7,2,1,0.5,Knife or cutting instrument,1
53524325,1,"Trenton-Ewing, NJ",0,2,1,0.5,Asphyxiation - includes death by gas,1
54361048,1,"Salisbury, MD",4,2,1,0.5,Fire,1
54524095,1,"Eugene-Springfield, OR",3,2,1,0.5,Explosives,1
54717780,1,"Napa, CA",0,2,1,0.5,Asphyxiation - includes death by gas,1
55046818,1,"Akron, OH",9,2,1,0.5,Other gun,1
56537001,1,"Harrisburg-Carlisle, PA",12,2,1,0.5,Poison - does not include gas,1
57362684,1,"Lafayette, LA",2,2,1,0.5,Drowning,1
57615030,1,"Birmingham-Hoover, AL",16,2,1,0.5,Strangulation - hanging,1
58225366,1,"Lubbock, TX",0,2,1,0.5,Asphyxiation - includes death by gas,1
58580340,9,Rural Oklahoma,4,2,1,0.5,Fire,1
58590554,1,"Sumter, SC",0,2,1,0.5,Asphyxiation - includes death by gas,1
59954757,2,"Washington-Arlington-Alexandria, DC-VA-MD-WV",3,2,1,0.5,Explosives,1
60302800,1,"Yuba City, CA",16,2,1,0.5,Strangulation - hanging,1
61396857,1,"Augusta-Richmond County, GA-SC",2,2,1,0.5,Drowning,1
61410308,1,"Lima, OH",16,2,1,0.5,Strangulation - hanging,1
61906934,2,"Cleveland, TN",0,2,1,0.5,Asphyxiation - includes death by gas,1
62990317,2,"Gainesville, FL",8,2,1,0.5,"Narcotics or drugs, sleeping pills",1
63233673,2,"Lexington-Fayette, KY",9,2,1,0.5,Other gun,1
63518287,1,"Danville, IL",14,2,1,0.5,Rifle,1
63559052,1,"Virginia Beach-Norfolk-Newport News, VA-NC",12,2,1,0.5,Poison - does not include gas,1
63702610,1,"Sioux Falls, SD",0,2,1,0.5,Asphyxiation - includes death by gas,1
63809477,2,"Poughkeepsie-Newburgh-Middletown, NY",17,2,1,0.5,Weapon Not Reported,1
63840911,9,"Jackson, MS",6,2,1,0.5,"Handgun - pistol, revolver, etc",1
64330234,2,"Coeur d Alene, ID",8,2,1,0.5,"Narcotics or drugs, sleeping pills",1
64793679,2,"Sheboygan, WI",7,2,1,0.5,Knife or cutting instrument,1
64837846,1,"St. Joseph, MO-KS",4,2,1,0.5,Fire,1
65263497,1,Rural Michigan,2,2,1,0.5,Drowning,1
65471114,1,"Lexington-Fayette, KY",9,2,1,0.5,Other gun,1
65542821,2,"Yuma, AZ",14,2,1,0.5,Rifle,1
65808927,1,Rural Idaho,0,2,1,0.5,Asphyxiation - includes death by gas,1
65952170,9,"Portland-Vancouver-Beaverton, OR-WA",10,2,1,0.5,Other or type unknown,1
66158319,1,"Jacksonville, FL",3,2,1,0.5,Explosives,1
66353131,9,"Wilmington, NC",10,2,1,0.5,Other or type unknown,1
66426992,1,Rural Nevada,9,2,1,0.5,Other gun,1
67147115,1,"Houma-Bayou Cane-Thibodaux, LA",0,2,1,0.5,Asphyxiation - includes death by gas,1
68032479,1,"Durham, NC",12,2,1,0.5,Poison - does not include gas,1
68743919,2,"South Bend-Mishawaka, IN-MI",9,2,1,0.5,Other gun,1
69881124,2,"Eugene-Springfield, OR",2,2,1,0.5,Drowning,1
69980652,2,"Fargo, ND-MN",1,2,1,0.5,"Blunt object - hammer, club, etc",1
70074406,1,"San Jose-Sunnyvale-Santa Clara, CA",8,2,1,0.5,"Narcotics or drugs, sleeping pills",1
71286546,1,"Birmingham-Hoover, AL",12,2,1,0.5,Poison - does not include gas,1
71803597,2,"Lima, OH",8,2,1,0.5,"Narcotics or drugs, sleeping pills",1
72210901,1,"Gainesville, FL",8,2,1,0.5,"Narcotics or drugs, sleeping pills",1
72292285,2,"Johnstown, PA",4,2,1,0.5,Fire,1
72796643,2,"Bellingham, WA",2,2,1,0.5,Drowning,1
72897475,9,"Kalamazoo-Portage, MI",10,2,1,0.5,Other or type unknown,1
72954977,2,"Raleigh-Cary, NC",5,2,1,0.5,"Firearm, type not stated",1
73236199,9,"Killeen-Temple-Fort Hood, TX",6,2,1,0.5,"Handgun - pistol, revolver, etc",1
73662471,9,"Phoenix-Mesa-Scottsdale, AZ",7,2,1,0.5,Knife or cutting instrument,1
74063043,9,"Tuscaloosa, AL",6,2,1,0.5,"Handgun - pistol, revolver, etc",1
74917226,1,"Flint, MI",3,2,1,0.5,Explosives,1
75198947,2,"Modesto, CA",8,2,1,0.5,"Narcotics or drugs, sleeping pills",1
75356802,1,"Houston-Sugar Land-Baytown, TX",3,2,1,0.5,Explosives,1
76280167,1,Rural Nebraska,16,2,1,0.5,Strangulation - hanging,1
76464486,1,"Weirton-Steubenville, WV-OH",4,2,1,0.5,Fire,1
76472813,2,"Madera, CA",5,2,1,0.5,"Firearm, type not stated",1
76860112,9,"Nashville-Davidson-Murfreesboro, TN",11,2,1,0.5,"Personal weapons, includes beating",1
77034799,1,Rural New Hampshire,9,2,1,0.5,Other gun,1
77582532,2,"Yakima, WA",2,2,1,0.5,Drowning,1
77587756,2,Rural Arizona,0,2,1,0.5,Asphyxiation - includes death by gas,1
78215806,1,"Salisbury, MD",16,2,1,0.5,Strangulation - hanging,1
78357213,1,"El Centro, CA",0,2,1,0.5,Asphyxiation - includes death by gas,1
78813672,1,"Salt Lake City, UT",3,2,1,0.5,Explosives,1
79159067,9,"Chicago-Naperville-Joliet, IL-IN-WI",7,2,1,0.5,Knife or cutting instrument,1
79263586,2,"Greeley, CO",5,2,1,0.5,"Firearm, type not stated",1
79292015,1,"Utica-Rome, NY",12,2,1,0.5,Poison - does not include gas,1
79606233,2,"Battle Creek, MI",4,2,1,0.5,Fire,1
80391877,2,Rural Montana,4,2,1,0.5,Fire,1
80537874,9,Rural Illinois,10,2,1,0.5,Other or type unknown,1
80552645,1,"Olympia, WA",12,2,1,0.5,Poison - does not include gas,1
80568439,1,"Springfield, MO",4,2,1,0.5,Fire,1
80671111,2,"Richmond, VA",2,2,1,0.5,Drowning,1
80676154,1,"South Bend-Mishawaka, IN-MI",16,2,1,0.5,Strangulation - hanging,1
81183280,1,Rural South Carolina,12,2,1,0.5,Poison - does not include gas,1
81435540,1,"Omaha-Council Bluffs, NE-IA",4,2,1,0.5,Fire,1
81603601,1,"Pascagoula, MS",9,2,1,0.5,Other gun,1
81627136,1,"Ocean City, NJ",4,2,1,0.5,Fire,1
81791009,1,"Reading, PA",8,2,1,0.5,"Narcotics or drugs, sleeping pills",1
82111678,9,"Niles-Benton Harbor, MI",10,2,1,0.5,Other or type unknown,1
83230754,1,"McAllen-Edinburg-Mission, TX",4,2,1,0.5,Fire,1
83967703,1,"Grand Rapids-Wyoming, MI",8,2,1,0.5,"Narcotics or drugs, sleeping pills",1
84272849,2,"Napa, CA",12,2,1,0.5,Poison - does not include gas,1
84769815,1,"Morgantown, WV",5,2,1,0.5,"Firearm, type not stated",1
84953598,2,"Montgomery, AL",0,2,1,0.5,Asphyxiation - includes death by gas,1
85047808,2,"Syracuse, NY",8,2,1,0.5,"Narcotics or drugs, sleeping pills",1
85051315,9,"Scranton--Wilkes-Barre, PA",4,2,1,0.5,Fire,1
85798655,2,Rural Alabama,16,2,1,0.5,Strangulation - hanging,1
85821473,9,"Yuma, AZ",10,2,1,0.5,Other or type unknown,1
85844828,2,"Santa Fe, NM",2,2,1,0.5,Drowning,1
87191356,9,"Boston-Cambridge-Quincy, MA-NH",6,2,1,0.5,"Handgun - pistol, revolver, etc",1
87315938,1,"Charlotte-Gastonia-Concord, NC-SC",3,2,1,0.5,Explosives,1
88042075,1,"Iowa City, IA",4,2,1,0.5,Fire,1
88210930,2,"Idaho Falls, ID",1,2,1,0.5,"Blunt object - hammer, club, etc",1
88867803,1,"Medford, OR",9,2,1,0.5,Other gun,1
89247246,9,Rural Arkansas,7,2,1,0.5,Knife or cutting instrument,1
89735891,1,"Cleveland-Elyria-Mentor, OH",13,2,1,0.5,Pushed or thrown out window,1
90630385,1,"Bellingham, WA",16,2,1,0.5,Strangulation - hanging,1
90711215,1,"Tyler, TX",4,2,1,0.5,Fire,1
91323572,9,"Flagstaff, AZ",10,2,1,0.5,Other or type unknown,1
91411916,2,"St. George, UT",1,2,1,0.5,"Blunt object - hammer, club, etc",1
92779463,1,"Texarkana, TX-Texarkana, AR",3,2,1,0.5,Explosives,1
92949062,9,"Cincinnati-Middletown, OH-KY-IN",10,2,1,0.5,Other or type unknown,1
93183960,1,"Yuba City, CA",0,2,1,0.5,Asphyxiation - includes death by gas,1
93334506,2,"Pocatello, ID",10,2,1,0.5,Other or type unknown,1
93374171,2,"Lafayette, LA",4,2,1,0.5,Fire,1
93456644,2,"Boston-Cambridge-Quincy, MA-NH",3,2,1,0.5,Explosives,1
93647530,9,"Birmingham-Hoover, AL",4,2,1,0.5,Fire,1
93864942,1,"Saginaw, MI",16,2,1,0.5,Strangulation - hanging,1
94102826,9,"Montgomery, AL",5,2,1,0.5,"Firearm, type not stated",1
94246178,2,"Muskegon-Norton Shores, MI",4,2,1,0.5,Fire,1
94320396,2,"Texarkana, TX-Texarkana, AR",16,2,1,0.5,Strangulation - hanging,1
95300703,1,Rural Kansas,2,2,1,0.5,Drowning,1
95485996,1,"Parkersburg-Marietta-Vienna, WV-OH",0,2,1,0.5,Asphyxiation - includes death by gas,1
95701129,2,Rural Utah,8,2,1,0.5,"Narcotics or drugs, sleeping pills",1
95757306,9,"New York-New Jersey-Long Island, NY-NJ",5,2,1,0.5,"Firearm, type not stated",1
97593139,2,"Napa, CA",8,2,1,0.5,"Narcotics or drugs, sleeping pills",1
97677846,2,"Yuba City, CA",16,2,1,0.5,Strangulation - hanging,1
98298017,1,"Salem, OR",0,2,1,0.5,Asphyxiation - includes death by gas,1
98800448,1,"Jefferson City, MO",0,2,1,0.5,Asphyxiation - includes death by gas,1
98817605,2,"Odessa, TX",16,2,1,0.5,Strangulation - hanging,1
98895029,1,"Montgomery, AL",16,2,1,0.5,Strangulation - hanging,1
98950600,1,"Greensboro-High Point, NC",16,2,1,0.5,Strangulation - hanging,1
98995493,2,"St. Cloud, MN",14,2,1,0.5,Rifle,1
99140120,2,"Pittsburgh, PA",12,2,1,0.5,Poison - does not include gas,1
99349874,9,"Montgomery, AL",10,2,1,0.5,Other or type unknown,1
99486622,9,"Chicago-Naperville-Joliet, IL-IN-WI",14,2,1,0.5,Rifle,1
99663006,2,"Casper, WY",16,2,1,0.5,Strangulation - hanging,1
29893,1,"Victoria, TX",16,1,0,0.0,Strangulation - hanging,1
121650,1,"Pittsfield, MA",16,1,0,0.0,Strangulation - hanging,1
205238,9,"Nashville-Davidson-Murfreesboro, TN",7,1,0,0.0,Knife or cutting instrument,1
444281,9,"McAllen-Edinburg-Mission, TX",7,1,0,0.0,Knife or cutting instrument,1
544327,2,"Wausau, WI",8,1,0,0.0,"Narcotics or drugs, sleeping pills",1
728892,1,"Merced, CA",8,1,0,0.0,"Narcotics or drugs, sleeping pills",1
750512,9,"Morristown, TN",7,1,0,0.0,Knife or cutting instrument,1
859960,9,"Houston-Sugar Land-Baytown, TX",14,1,0,0.0,Rifle,1
1399412,9,Rural Alabama,14,1,0,0.0,Rifle,1
1458999,1,"Buffalo-Niagara Falls, NY",0,1,0,0.0,Asphyxiation - includes death by gas,1
1702692,1,"Charleston, WV",17,1,0,0.0,Weapon Not Reported,1
2072279,2,"Charleston, WV",17,1,0,0.0,Weapon Not Reported,1
2145524,9,Rural Indiana,10,1,0,0.0,Other or type unknown,1
2220213,2,"Salisbury, MD",5,1,0,0.0,"Firearm, type not stated",1
2225352,2,"Chico, CA",2,1,0,0.0,Drowning,1
2372485,9,"San Francisco-Oakland-Fremont, CA",1,1,0,0.0,"Blunt object - hammer, club, etc",1
2392719,9,"Savannah, GA",5,1,0,0.0,"Firearm, type not stated",1
2527598,2,"Winston-Salem, NC",3,1,0,0.0,Explosives,1
2758009,2,"Lansing-East Lansing, MI",3,1,0,0.0,Explosives,1
3073170,2,"Port St. Lucie-Fort Pierce, FL",2,1,0,0.0,Drowning,1
3170519,9,"Tulsa, OK",5,1,0,0.0,"Firearm, type not stated",1
3382047,1,"Savannah, GA",3,1,0,0.0,Explosives,1
3440722,1,"Salt Lake City, UT",12,1,0,0.0,Poison - does not include gas,1
3597267,9,"Flint, MI",4,1,0,0.0,Fire,1
4609210,1,"Jacksonville, NC",2,1,0,0.0,Drowning,1
4870196,1,Rural Virginia,3,1,0,0.0,Explosives,1
5055175,1,Rural Idaho,17,1,0,0.0,Weapon Not Reported,1
5091634,1,"York-Hanover, PA",9,1,0,0.0,Other gun,1
5159109,1,"Salt Lake City, UT",17,1,0,0.0,Weapon Not Reported,1
5413718,1,"Lynchburg, VA",0,1,0,0.0,Asphyxiation - includes death by gas,1
5607224,1,"Portland-South Portland-Biddeford, ME",16,1,0,0.0,Strangulation - hanging,1
5808405,9,"Pascagoula, MS",10,1,0,0.0,Other or type unknown,1
5999835,1,"Coeur d Alene, ID",16,1,0,0.0,Strangulation - hanging,1
6168688,1,"Vineland-Millville-Bridgeton, NJ",12,1,0,0.0,Poison - does not include gas,1
6408319,1,"Denver-Aurora, CO",3,1,0,0.0,Explosives,1
6724187,1,"Weirton-Steubenville, WV-OH",16,1,0,0.0,Strangulation - hanging,1
6780200,9,"Austin-Round Rock, TX",10,1,0,0.0,Other or type unknown,1
7343773,9,"Denver-Aurora, CO",10,1,0,0.0,Other or type unknown,1
8247886,1,"Abilene, TX",12,1,0,0.0,Poison - does not include gas,1
8557820,9,"Providence-New Bedford-Fall River, RI-MA",15,1,0,0.0,Shotgun,1
8671452,1,"Florence, SC",16,1,0,0.0,Strangulation - hanging,1
8771926,1,Rural Delaware,9,1,0,0.0,Other gun,1
8877023,2,"Huntington-Ashland, WV-KY-OH",17,1,0,0.0,Weapon Not Reported,1
8912300,2,"Jonesboro, AR",4,1,0,0.0,Fire,1
9096943,1,"Prescott, AZ",16,1,0,0.0,Strangulation - hanging,1
9114734,2,"Modesto, CA",3,1,0,0.0,Explosives,1
9371372,9,"Salt Lake City, UT",9,1,0,0.0,Other gun,1
9456796,9,"Phoenix-Mesa-Scottsdale, AZ",16,1,0,0.0,Strangulation - hanging,1
9479154,9,"Vallejo-Fairfield, CA",7,1,0,0.0,Knife or cutting instrument,1
10065355,1,"Laredo, TX",0,1,0,0.0,Asphyxiation - includes death by gas,1
10192612,1,"Modesto, CA",3,1,0,0.0,Explosives,1
10516275,9,"San Antonio, TX",16,1,0,0.0,Strangulation - hanging,1
10523381,2,"Salinas, CA",17,1,0,0.0,Weapon Not Reported,1
11049800,9,Rural Alaska,10,1,0,0.0,Other or type unknown,1
11277051,1,"Mansfield, OH",4,1,0,0.0,Fire,1
11476240,1,"Wheeling, WV-OH",16,1,0,0.0,Strangulation - hanging,1
11716351,2,"Greenville, NC",8,1,0,0.0,"Narcotics or drugs, sleeping pills",1
11830276,9,"Fresno, CA",5,1,0,0.0,"Firearm, type not stated",1
11963174,1,"Cincinnati-Middletown, OH-KY-IN",17,1,0,0.0,Weapon Not Reported,1
12237333,1,"Wenatchee, WA",4,1,0,0.0,Fire,1
12531069,2,"Providence-New Bedford-Fall River, RI-MA",2,1,0,0.0,Drowning,1
12618385,1,"Niles-Benton Harbor, MI",16,1,0,0.0,Strangulation - hanging,1
12828013,1,"Odessa, TX",3,1,0,0.0,Explosives,1
12898691,9,"Santa Fe, NM",7,1,0,0.0,Knife or cutting instrument,1
13728627,1,"Montgomery, AL",17,1,0,0.0,Weapon Not Reported,1
14352303,1,"Logan, UT-ID",5,1,0,0.0,"Firearm, type not stated",1
14388423,9,Rural Missouri,5,1,0,0.0,"Firearm, type not stated",1
14814453,9,"Danville, VA",7,1,0,0.0,Knife or cutting instrument,1
14866521,2,"Salt Lake City, UT",17,1,0,0.0,Weapon Not Reported,1
14983391,9,"Lansing-East Lansing, MI",10,1,0,0.0,Other or type unknown,1
15187339,1,"Pueblo, CO",0,1,0,0.0,Asphyxiation - includes death by gas,1
15630962,9,"Santa Fe, NM",10,1,0,0.0,Other or type unknown,1
15727934,1,"Ocean City, NJ",14,1,0,0.0,Rifle,1
15738654,9,"Riverside-San Bernardino, CA",16,1,0,0.0,Strangulation - hanging,1
15785448,9,"Longview, TX",4,1,0,0.0,Fire,1
15881680,2,"Killeen-Temple-Fort Hood, TX",9,1,0,0.0,Other gun,1
15925558,2,"Fort Smith, AR-OK",17,1,0,0.0,Weapon Not Reported,1
15938356,2,"Lawton, OK",15,1,0,0.0,Shotgun,1
16328169,1,"Battle Creek, MI",16,1,0,0.0,Strangulation - hanging,1
16713970,1,"Lafayette, IN",4,1,0,0.0,Fire,1
16718012,2,"Greenville, NC",5,1,0,0.0,"Firearm, type not stated",1
16857767,2,"Alexandria, LA",2,1,0,0.0,Drowning,1
16940424,2,"Waterloo-Cedar Falls, IA",16,1,0,0.0,Strangulation - hanging,1
17105899,1,"Yuba City, CA",9,1,0,0.0,Other gun,1
17113218,2,"Oshkosh-Neenah, WI",17,1,0,0.0,Weapon Not Reported,1
17135992,2,"Springfield, OH",4,1,0,0.0,Fire,1
17515388,2,"Kingston, NY",8,1,0,0.0,"Narcotics or drugs, sleeping pills",1
17555144,9,"Clarksville, TN-KY",9,1,0,0.0,Other gun,1
17979062,1,"Tyler, TX",17,1,0,0.0,Weapon Not Reported,1
18265449,2,"Fort Wayne, IN",17,1,0,0.0,Weapon Not Reported,1
18727280,2,"Columbia, SC",9,1,0,0.0,Other gun,1
18858590,2,"Hagerstown-Martinsburg, MD-WV",2,1,0,0.0,Drowning,1
19417954,1,"Honolulu, HI",8,1,0,0.0,"Narcotics or drugs, sleeping pills",1
19595418,1,"Santa Barbara-Santa Maria, CA",16,1,0,0.0,Strangulation - hanging,1
19989021,2,"Sioux City, IA-NE-SD",16,1,0,0.0,Strangulation - hanging,1
20156066,1,"Beaumont-Port Arthur, TX",9,1,0,0.0,Other gun,1
20266060,9,"Chicago-Naperville-Joliet, IL-IN-WI",15,1,0,0.0,Shotgun,1
20341034,9,"Vallejo-Fairfield, CA",10,1,0,0.0,Other or type unknown,1
20533984,2,"Abilene, TX",4,1,0,0.0,Fire,1
20633328,1,"Reno-Sparks, NV",13,1,0,0.0,Pushed or thrown out window,1
20939063,1,"Asheville, NC",16,1,0,0.0,Strangulation - hanging,1
21235601,2,"Napa, CA",5,1,0,0.0,"Firearm, type not stated",1
21271819,2,"Salinas, CA",9,1,0,0.0,Other gun,1
21600524,1,"Youngstown-Warren-Boardman, OH-PA",16,1,0,0.0,Strangulation - hanging,1
21689769,9,"Detroit-Warren-Livonia, MI",4,1,0,0.0,Fire,1
21941196,9,"Columbus, OH",7,1,0,0.0,Knife or cutting instrument,1
22038707,9,"Las Cruces, NM",1,1,0,0.0,"Blunt object - hammer, club, etc",1
22461233,2,"Gulfport-Biloxi, MS",17,1,0,0.0,Weapon Not Reported,1
22756749,2,"Lubbock, TX",9,1,0,0.0,Other gun,1
22766438,9,Rural Utah,14,1,0,0.0,Rifle,1
22904155,9,"Santa Rosa-Petaluma, CA",10,1,0,0.0,Other or type unknown,1
23307976,1,"Williamsport, PA",9,1,0,0.0,Other gun,1
23353221,2,"Clarksville, TN-KY",9,1,0,0.0,Other gun,1
23661995,2,"Bremerton-Silverdale, WA",3,1,0,0.0,Explosives,1
24335155,9,"Denver-Aurora, CO",4,1,0,0.0,Fire,1
24474445,9,"Charleston-North Charleston, SC",10,1,0,0.0,Other or type unknown,1
24513542,2,"Phoenix-Mesa-Scottsdale, AZ",3,1,0,0.0,Explosives,1
24560357,1,"Idaho Falls, ID",16,1,0,0.0,Strangulation - hanging,1
24970867,9,"Huntington-Ashland, WV-KY-OH",10,1,0,0.0,Other or type unknown,1
25039201,9,"Minneapolis-St. Paul-Bloomington, MN-WI",4,1,0,0.0,Fire,1
25706885,1,"Janesville, WI",8,1,0,0.0,"Narcotics or drugs, sleeping pills",1
25774663,2,"Victoria, TX",1,1,0,0.0,"Blunt object - hammer, club, etc",1
26016868,1,"Prescott, AZ",4,1,0,0.0,Fire,1
26175765,9,"Chattanooga, TN-GA",7,1,0,0.0,Knife or cutting instrument,1
26335931,2,Rural Alabama,9,1,0,0.0,Other gun,1
26381275,2,"Battle Creek, MI",0,1,0,0.0,Asphyxiation - includes death by gas,1
26570182,9,"Billings, MT",15,1,0,0.0,Shotgun,1
26821228,9,"Las Vegas-Paradise, NV",15,1,0,0.0,Shotgun,1
26878744,2,"Lakeland, FL",2,1,0,0.0,Drowning,1
27081239,1,"Lakeland, FL",16,1,0,0.0,Strangulation - hanging,1
27208479,1,"Danville, VA",17,1,0,0.0,Weapon Not Reported,1
27370907,2,"Tyler, TX",17,1,0,0.0,Weapon Not Reported,1
27440737,2,Rural Mississippi,17,1,0,0.0,Weapon Not Reported,1
27450616,2,"Lafayette, IN",9,1,0,0.0,Other gun,1
28026478,2,"South Bend-Mishawaka, IN-MI",3,1,0,0.0,Explosives,1
28068344,1,"Atlantic City, NJ",13,1,0,0.0,Pushed or thrown out window,1
28139561,9,"Pueblo, CO",10,1,0,0.0,Other or type unknown,1
28576928,1,"Hot Springs, AR",9,1,0,0.0,Other gun,1
28760477,2,"Wenatchee, WA",4,1,0,0.0,Fire,1
28936473,2,"Toledo, OH",2,1,0,0.0,Drowning,1
29270410,9,"Sacramento-Roseville, CA",12,1,0,0.0,Poison - does not include gas,1
29397138,2,"Athens-Clarke County, GA",16,1,0,0.0,Strangulation - hanging,1
29458686,2,"Richmond, VA",3,1,0,0.0,Explosives,1
29565113,2,"Eugene-Springfield, OR",4,1,0,0.0,Fire,1
29573172,9,Rural California,10,1,0,0.0,Other or type unknown,1
29686717,9,"St. Louis, MO-IL",7,1,0,0.0,Knife or cutting instrument,1
29736105,2,"Boston-Cambridge-Quincy, MA-NH",17,1,0,0.0,Weapon Not Reported,1
29749333,9,"Tampa-St. Petersburg-Clearwater, FL",10,1,0,0.0,Other or type unknown,1
30217661,2,"Yuba City, CA",0,1,0,0.0,Asphyxiation - includes death by gas,1
30340688,9,"Bakersfield, CA",10,1,0,0.0,Other or type unknown,1
30471446,2,"Davenport-Moline-Rock Island, IA-IL",2,1,0,0.0,Drowning,1
30637619,2,"Flagstaff, AZ",14,1,0,0.0,Rifle,1
31020464,1,"Mansfield, OH",3,1,0,0.0,Explosives,1
31137993,2,"Montgomery, AL",17,1,0,0.0,Weapon Not Reported,1
31146173,1,"Provo-Orem, UT",17,1,0,0.0,Weapon Not Reported,1
31256056,1,"Shreveport-Bossier City, LA",2,1,0,0.0,Drowning,1
31311421,9,"New Orleans-Metairie-Kenner, LA",1,1,0,0.0,"Blunt object - hammer, club, etc",1
31545446,9,"Atlanta-Sandy Springs-Marietta, GA",1,1,0,0.0,"Blunt object - hammer, club, etc",1
31548816,1,"Cape Coral-Fort Myers, FL",16,1,0,0.0,Strangulation - hanging,1
31937722,2,"Waterloo-Cedar Falls, IA",9,1,0,0.0,Other gun,1
31969623,1,"Grand Junction, CO",3,1,0,0.0,Explosives,1
32124724,9,"Birmingham-Hoover, AL",9,1,0,0.0,Other gun,1
32732336,1,"Brownsville-Harlingen, TX",4,1,0,0.0,Fire,1
32736980,9,Rural New Mexico,10,1,0,0.0,Other or type unknown,1
33135935,9,"Topeka, KS",10,1,0,0.0,Other or type unknown,1
33744378,9,"Roanoke, VA",11,1,0,0.0,"Personal weapons, includes beating",1
34002027,9,"Los Angeles-Long Beach, CA",1,1,0,0.0,"Blunt object - hammer, club, etc",1
34165756,2,"Kokomo, IN",5,1,0,0.0,"Firearm, type not stated",1
34450660,1,"Greenville, NC",8,1,0,0.0,"Narcotics or drugs, sleeping pills",1
34557586,9,"Seattle-Tacoma-Bellevue, WA",16,1,0,0.0,Strangulation - hanging,1
34667184,9,"Charleston-North Charleston, SC",6,1,0,0.0,"Handgun - pistol, revolver, etc",1
34863465,1,Rural Wisconsin,17,1,0,0.0,Weapon Not Reported,1
34979799,2,"Albany, GA",9,1,0,0.0,Other gun,1
35120241,2,"Pascagoula, MS",14,1,0,0.0,Rifle,1
35497877,1,"Anderson, SC",4,1,0,0.0,Fire,1
35569266,1,"Billings, MT",17,1,0,0.0,Weapon Not Reported,1
36189163,9,"Tuscaloosa, AL",11,1,0,0.0,"Personal weapons, includes beating",1
36321350,9,"Las Vegas-Paradise, NV",5,1,0,0.0,"Firearm, type not stated",1
36605204,2,Rural Wisconsin,12,1,0,0.0,Poison - does not include gas,1
36648841,2,"Wichita, KS",9,1,0,0.0,Other gun,1
36708363,2,"Savannah, GA",17,1,0,0.0,Weapon Not Reported,1
36756195,1,"State College, PA",5,1,0,0.0,"Firearm, type not stated",1
36965041,2,Rural Colorado,4,1,0,0.0,Fire,1
37017775,2,"Killeen-Temple-Fort Hood, TX",8,1,0,0.0,"Narcotics or drugs, sleeping pills",1
37563612,2,"Deltona-Daytona Beach-Ormond Beach, FL",3,1,0,0.0,Explosives,1
37833813,2,"Bremerton-Silverdale, WA",2,1,0,0.0,Drowning,1
37836109,9,"Lakeland, FL",1,1,0,0.0,"Blunt object - hammer, club, etc",1
37901584,9,"Rocky Mount, NC",10,1,0,0.0,Other or type unknown,1
37964170,9,"Pine Bluff, AR",6,1,0,0.0,"Handgun - pistol, revolver, etc",1
37985684,1,"Beaumont-Port Arthur, TX",12,1,0,0.0,Poison - does not include gas,1
38297935,1,"Huntington-Ashland, WV-KY-OH",17,1,0,0.0,Weapon Not Reported,1
39025430,1,"Battle Creek, MI",2,1,0,0.0,Drowning,1
39311920,1,Rural Georgia,17,1,0,0.0,Weapon Not Reported,1
39396974,2,"Bay City, MI",2,1,0,0.0,Drowning,1
39536714,2,"Kingston, NY",2,1,0,0.0,Drowning,1
39564627,9,"Albuquerque, NM",5,1,0,0.0,"Firearm, type not stated",1
39743529,9,Rural Pennsylvania,0,1,0,0.0,Asphyxiation - includes death by gas,1
39810019,9,Rural Michigan,5,1,0,0.0,"Firearm, type not stated",1
39915092,1,"Valdosta, GA",0,1,0,0.0,Asphyxiation - includes death by gas,1
40056452,1,"Monroe, MI",12,1,0,0.0,Poison - does not include gas,1
40323688,9,"Phoenix-Mesa-Scottsdale, AZ",4,1,0,0.0,Fire,1
40347809,9,"Laredo, TX",10,1,0,0.0,Other or type unknown,1
40490678,9,Rural South Carolina,4,1,0,0.0,Fire,1
40526648,1,"Muncie, IN",9,1,0,0.0,Other gun,1
40904599,1,"Rochester, NY",3,1,0,0.0,Explosives,1
41345800,2,"Yuma, AZ",2,1,0,0.0,Drowning,1
41398576,9,"Louisville, KY-IN",7,1,0,0.0,Knife or cutting instrument,1
41513727,1,"Medford, OR",17,1,0,0.0,Weapon Not Reported,1
41621782,2,"Billings, MT",17,1,0,0.0,Weapon Not Reported,1
41958626,9,"Chicago-Naperville-Joliet, IL-IN-WI",5,1,0,0.0,"Firearm, type not stated",1
42462954,2,"Akron, OH",17,1,0,0.0,Weapon Not Reported,1
42556412,2,"Asheville, NC",0,1,0,0.0,Asphyxiation - includes death by gas,1
42854336,1,"Ithaca, NY",10,1,0,0.0,Other or type unknown,1
42891383,9,"Morristown, TN",10,1,0,0.0,Other or type unknown,1
43341966,9,"Memphis, TN-MS-AR",4,1,0,0.0,Fire,1
43519319,2,"Rockford, IL",4,1,0,0.0,Fire,1
43565048,9,"Miami-Fort Lauderdale, FL",1,1,0,0.0,"Blunt object - hammer, club, etc",1
43729140,1,"Eugene-Springfield, OR",4,1,0,0.0,Fire,1
43871424,9,"Scranton--Wilkes-Barre, PA",15,1,0,0.0,Shotgun,1
43995408,1,"Lafayette, IN",9,1,0,0.0,Other gun,1
44777249,9,"McAllen-Edinburg-Mission, TX",4,1,0,0.0,Fire,1
44855778,9,"Saginaw, MI",10,1,0,0.0,Other or type unknown,1
44938766,9,"Nashville-Davidson-Murfreesboro, TN",5,1,0,0.0,"Firearm, type not stated",1
45314796,9,"Boise City-Nampa, ID",7,1,0,0.0,Knife or cutting instrument,1
45347610,2,"Lawton, OK",14,1,0,0.0,Rifle,1
45606605,1,"Tulsa, OK",3,1,0,0.0,Explosives,1
45639287,1,"Scranton--Wilkes-Barre, PA",12,1,0,0.0,Poison - does not include gas,1
45885290,9,"Lawton, OK",10,1,0,0.0,Other or type unknown,1
46872111,2,"Grand Junction, CO",3,1,0,0.0,Explosives,1
46916571,2,"Syracuse, NY",3,1,0,0.0,Explosives,1
47358505,2,"Elizabethtown, KY",15,1,0,0.0,Shotgun,1
47427031,2,"Las Cruces, NM",0,1,0,0.0,Asphyxiation - includes death by gas,1
47861068,1,"Laredo, TX",2,1,0,0.0,Drowning,1
48061644,1,"Grand Junction, CO",16,1,0,0.0,Strangulation - hanging,1
48230909,1,"Salem, OR",8,1,0,0.0,"Narcotics or drugs, sleeping pills",1
48273836,9,"Alexandria, LA",5,1,0,0.0,"Firearm, type not stated",1
48303692,2,"Sioux City, IA-NE-SD",4,1,0,0.0,Fire,1
48486798,2,"Yuba City, CA",3,1,0,0.0,Explosives,1
48499638,9,"Barnstable Town, MA",10,1,0,0.0,Other or type unknown,1
48619485,2,"Winchester, VA-WV",0,1,0,0.0,Asphyxiation - includes death by gas,1
48967078,1,"York-Hanover, PA",0,1,0,0.0,Asphyxiation - includes death by gas,1
49487236,9,"Augusta-Richmond County, GA-SC",6,1,0,0.0,"Handgun - pistol, revolver, etc",1
49513717,9,Rural Mississippi,11,1,0,0.0,"Personal weapons, includes beating",1
49663851,1,"Monroe, MI",16,1,0,0.0,Strangulation - hanging,1
49743473,9,"Charleston, WV",10,1,0,0.0,Other or type unknown,1
49831736,9,"Monroe, MI",10,1,0,0.0,Other or type unknown,1
49914206,1,"Longview, WA",16,1,0,0.0,Strangulation - hanging,1
49987969,9,"Nashville-Davidson-Murfreesboro, TN",14,1,0,0.0,Rifle,1
50709435,2,"Greeley, CO",16,1,0,0.0,Strangulation - hanging,1
50821302,1,"Ithaca, NY",16,1,0,0.0,Strangulation - hanging,1
51078063,9,"Merced, CA",10,1,0,0.0,Other or type unknown,1
51232120,1,"Lakeland, FL",0,1,0,0.0,Asphyxiation - includes death by gas,1
51417733,9,Rural Washington,10,1,0,0.0,Other or type unknown,1
51904556,9,"Yuma, AZ",5,1,0,0.0,"Firearm, type not stated",1
52068949,2,"Charleston-North Charleston, SC",2,1,0,0.0,Drowning,1
52198154,2,"Williamsport, PA",1,1,0,0.0,"Blunt object - hammer, club, etc",1
52324995,9,"Gainesville, GA",10,1,0,0.0,Other or type unknown,1
52407123,9,"Grand Junction, CO",7,1,0,0.0,Knife or cutting instrument,1
52414694,9,"Flagstaff, AZ",6,1,0,0.0,"Handgun - pistol, revolver, etc",1
52569427,1,"Gulfport-Biloxi, MS",17,1,0,0.0,Weapon Not Reported,1
52584490,2,"Rochester, MN",16,1,0,0.0,Strangulation - hanging,1
52608416,2,"Vallejo-Fairfield, CA",8,1,0,0.0,"Narcotics or drugs, sleeping pills",1
52827986,9,"Chicago-Naperville-Joliet, IL-IN-WI",0,1,0,0.0,Asphyxiation - includes death by gas,1
52912327,2,"Albany, GA",4,1,0,0.0,Fire,1
53053192,2,"Fresno, CA",17,1,0,0.0,Weapon Not Reported,1
53260556,2,"Wichita, KS",2,1,0,0.0,Drowning,1
53298600,9,"Mobile, AL",11,1,0,0.0,"Personal weapons, includes beating",1
53468490,2,"Provo-Orem, UT",13,1,0,0.0,Pushed or thrown out window,1
53654918,9,"Montgomery, AL",7,1,0,0.0,Knife or cutting instrument,1
53684096,1,"Dothan, AL",0,1,0,0.0,Asphyxiation - includes death by gas,1
53686688,2,Rural Michigan,17,1,0,0.0,Weapon Not Reported,1
53839703,9,"Salt Lake City, UT",11,1,0,0.0,"Personal weapons, includes beating",1
54732649,9,"Phoenix-Mesa-Scottsdale, AZ",11,1,0,0.0,"Personal weapons, includes beating",1
54760081,1,"Davenport-Moline-Rock Island, IA-IL",16,1,0,0.0,Strangulation - hanging,1
55272517,1,"Columbus, GA-AL",3,1,0,0.0,Explosives,1
55363663,1,"Greeley, CO",4,1,0,0.0,Fire,1
55386065,2,"Redding, CA",17,1,0,0.0,Weapon Not Reported,1
55580456,1,"Coeur d Alene, ID",2,1,0,0.0,Drowning,1
55605089,9,"Coeur d Alene, ID",6,1,0,0.0,"Handgun - pistol, revolver, etc",1
55655505,2,"Provo-Orem, UT",16,1,0,0.0,Strangulation - hanging,1
55773885,2,"Tyler, TX",0,1,0,0.0,Asphyxiation - includes death by gas,1
55834992,2,"Burlington, NC",9,1,0,0.0,Other gun,1
55913238,1,"Rocky Mount, NC",12,1,0,0.0,Poison - does not include gas,1
55977375,1,Rural Nebraska,17,1,0,0.0,Weapon Not Reported,1
56025074,9,"New York-New Jersey-Long Island, NY-NJ",0,1,0,0.0,Asphyxiation - includes death by gas,1
56135048,9,"Los Angeles-Long Beach, CA",9,1,0,0.0,Other gun,1
56364248,1,Rural Oklahoma,17,1,0,0.0,Weapon Not Reported,1
56493259,2,"Birmingham-Hoover, AL",3,1,0,0.0,Explosives,1
56644358,9,Rural Kentucky,7,1,0,0.0,Knife or cutting instrument,1
56651437,2,"Columbus, IN",14,1,0,0.0,Rifle,1
56905808,2,"Terre Haute, IN",2,1,0,0.0,Drowning,1
57178762,9,Rural Tennessee,7,1,0,0.0,Knife or cutting instrument,1
57217239,1,"Jackson, MS",8,1,0,0.0,"Narcotics or drugs, sleeping pills",1
57614094,9,"San Antonio, TX",1,1,0,0.0,"Blunt object - hammer, club, etc",1
57632641,1,"Erie, PA",12,1,0,0.0,Poison - does not include gas,1
57633460,9,"Modesto, CA",5,1,0,0.0,"Firearm, type not stated",1
57885813,9,"Corpus Christi, TX",6,1,0,0.0,"Handgun - pistol, revolver, etc",1
58063006,9,"Kansas City, MO-KS",6,1,0,0.0,"Handgun - pistol, revolver, etc",1
58170151,9,"Greenville, NC",10,1,0,0.0,Other or type unknown,1
58271128,2,Rural Oklahoma,17,1,0,0.0,Weapon Not Reported,1
58356012,1,"College Station-Bryan, TX",0,1,0,0.0,Asphyxiation - includes death by gas,1
58444658,2,"Palm Bay-Melbourne-Titusville, FL",16,1,0,0.0,Strangulation - hanging,1
58663539,9,"Reno-Sparks, NV",8,1,0,0.0,"Narcotics or drugs, sleeping pills",1
58670201,2,"Anchorage, AK",3,1,0,0.0,Explosives,1
58979649,2,"Elizabethtown, KY",9,1,0,0.0,Other gun,1
58994051,1,"Yakima, WA",2,1,0,0.0,Drowning,1
59086324,2,"Fayetteville, NC",8,1,0,0.0,"Narcotics or drugs, sleeping pills",1
59135678,2,"Lubbock, TX",17,1,0,0.0,Weapon Not Reported,1
59250137,2,"Johnstown, PA",1,1,0,0.0,"Blunt object - hammer, club, etc",1
59292488,1,"Killeen-Temple-Fort Hood, TX",17,1,0,0.0,Weapon Not Reported,1
59426018,9,"Houston-Sugar Land-Baytown, TX",17,1,0,0.0,Weapon Not Reported,1
59474391,2,"San Antonio, TX",12,1,0,0.0,Poison - does not include gas,1
59615362,9,"Miami-Fort Lauderdale, FL",4,1,0,0.0,Fire,1
59642921,9,"Dallas-Fort Worth-Arlington, TX",4,1,0,0.0,Fire,1
59670999,9,"Waco, TX",6,1,0,0.0,"Handgun - pistol, revolver, etc",1
59798978,2,"Goldsboro, NC",2,1,0,0.0,Drowning,1
59979273,2,"Louisville, KY-IN",12,1,0,0.0,Poison - does not include gas,1
59981232,1,"Anchorage, AK",3,1,0,0.0,Explosives,1
60189674,1,"Niles-Benton Harbor, MI",0,1,0,0.0,Asphyxiation - includes death by gas,1
60461742,2,"Napa, CA",4,1,0,0.0,Fire,1
60694806,1,"Florence, SC",2,1,0,0.0,Drowning,1
60742477,9,"Poughkeepsie-Newburgh-Middletown, NY",6,1,0,0.0,"Handgun - pistol, revolver, etc",1
60777772,9,"Fort Wayne, IN",6,1,0,0.0,"Handgun - pistol, revolver, etc",1
60800361,2,Rural Virginia,17,1,0,0.0,Weapon Not Reported,1
61091939,2,"Monroe, LA",4,1,0,0.0,Fire,1
61235047,1,"Warner Robins, GA",2,1,0,0.0,Drowning,1
61514250,9,"Grand Junction, CO",5,1,0,0.0,"Firearm, type not stated",1
61656317,1,"Oshkosh-Neenah, WI",17,1,0,0.0,Weapon Not Reported,1
61799266,1,"Goldsboro, NC",12,1,0,0.0,Poison - does not include gas,1
62027396,1,"Danville, IL",9,1,0,0.0,Other gun,1
62028189,2,"York-Hanover, PA",12,1,0,0.0,Poison - does not include gas,1
62090253,2,"Birmingham-Hoover, AL",9,1,0,0.0,Other gun,1
62776819,2,"Toledo, OH",13,1,0,0.0,Pushed or thrown out window,1
62908629,2,"Dalton, GA",16,1,0,0.0,Strangulation - hanging,1
62989147,2,"Louisville, KY-IN",17,1,0,0.0,Weapon Not Reported,1
63229593,2,"Anniston-Oxford, AL",4,1,0,0.0,Fire,1
63439070,9,"Phoenix-Mesa-Scottsdale, AZ",6,1,0,0.0,"Handgun - pistol, revolver, etc",1
63587339,9,"Fresno, CA",6,1,0,0.0,"Handgun - pistol, revolver, etc",1
63663232,2,"Cumberland, MD-WV",1,1,0,0.0,"Blunt object - hammer, club, etc",1
63692145,9,"Killeen-Temple-Fort Hood, TX",10,1,0,0.0,Other or type unknown,1
63751548,2,"Honolulu, HI",3,1,0,0.0,Explosives,1
63771555,2,"Lake Charles, LA",17,1,0,0.0,Weapon Not Reported,1
64025794,9,"Tucson, AZ",10,1,0,0.0,Other or type unknown,1
64106435,2,"Dallas-Fort Worth-Arlington, TX",3,1,0,0.0,Explosives,1
64262689,1,"Fort Wayne, IN",3,1,0,0.0,Explosives,1
64392338,1,"South Bend-Mishawaka, IN-MI",13,1,0,0.0,Pushed or thrown out window,1
64679261,9,"San Antonio, TX",7,1,0,0.0,Knife or cutting instrument,1
64757655,1,"Fort Wayne, IN",17,1,0,0.0,Weapon Not Reported,1
64939932,1,"Buffalo-Niagara Falls, NY",9,1,0,0.0,Other gun,1
65527611,1,"Toledo, OH",3,1,0,0.0,Explosives,1
66349728,9,"McAllen-Edinburg-Mission, TX",15,1,0,0.0,Shotgun,1
66646945,1,"Brunswick, GA",4,1,0,0.0,Fire,1
67105917,1,Rural West Virginia,13,1,0,0.0,Pushed or thrown out window,1
67351240,9,"Flagstaff, AZ",5,1,0,0.0,"Firearm, type not stated",1
67423667,1,"Racine, WI",16,1,0,0.0,Strangulation - hanging,1
67534061,9,"Greensboro-High Point, NC",4,1,0,0.0,Fire,1
67849627,2,"Bridgeport-Stamford-Norwalk, CT",9,1,0,0.0,Other gun,1
67853614,9,Rural Texas,14,1,0,0.0,Rifle,1
68082130,2,"Lafayette, LA",9,1,0,0.0,Other gun,1
68218253,9,"Bridgeport-Stamford-Norwalk, CT",10,1,0,0.0,Other or type unknown,1
68557483,9,"Minneapolis-St. Paul-Bloomington, MN-WI",10,1,0,0.0,Other or type unknown,1
68971230,2,"Ann Arbor, MI",2,1,0,0.0,Drowning,1
68994471,2,"Duluth, MN-WI",4,1,0,0.0,Fire,1
69148487,1,"Yuma, AZ",9,1,0,0.0,Other gun,1
69185743,9,Rural Arkansas,4,1,0,0.0,Fire,1
69726056,2,"Tuscaloosa, AL",16,1,0,0.0,Strangulation - hanging,1
69734513,2,"Pueblo, CO",9,1,0,0.0,Other gun,1
70165067,9,"Cleveland-Elyria-Mentor, OH",17,1,0,0.0,Weapon Not Reported,1
70312228,2,"Manchester-Nashua, NH",4,1,0,0.0,Fire,1
70616457,1,Rural Nevada,2,1,0,0.0,Drowning,1
70624501,9,"Los Angeles-Long Beach, CA",5,1,0,0.0,"Firearm, type not stated",1
70718556,9,"Waco, TX",15,1,0,0.0,Shotgun,1
71048729,1,"Salinas, CA",17,1,0,0.0,Weapon Not Reported,1
71176702,2,"Houma-Bayou Cane-Thibodaux, LA",9,1,0,0.0,Other gun,1
71624282,1,"St. Cloud, MN",3,1,0,0.0,Explosives,1
71661217,2,"Burlington, NC",16,1,0,0.0,Strangulation - hanging,1
71937535,9,"McAllen-Edinburg-Mission, TX",11,1,0,0.0,"Personal weapons, includes beating",1
72340081,2,Rural Kansas,17,1,0,0.0,Weapon Not Reported,1
72537931,2,"Anniston-Oxford, AL",16,1,0,0.0,Strangulation - hanging,1
73064234,9,"Muskegon-Norton Shores, MI",5,1,0,0.0,"Firearm, type not stated",1
73233429,1,Rural Kansas,17,1,0,0.0,Weapon Not Reported,1
73886050,1,"Fort Smith, AR-OK",17,1,0,0.0,Weapon Not Reported,1
74345266,2,"Greeley, CO",4,1,0,0.0,Fire,1
74397261,1,"Flint, MI",17,1,0,0.0,Weapon Not Reported,1
74403209,2,"Pascagoula, MS",16,1,0,0.0,Strangulation - hanging,1
74742092,1,"Bay City, MI",12,1,0,0.0,Poison - does not include gas,1
74887687,1,"Fort Smith, AR-OK",12,1,0,0.0,Poison - does not include gas,1
74950367,2,"Ocala, FL",0,1,0,0.0,Asphyxiation - includes death by gas,1
75006430,2,"Altoona, PA",2,1,0,0.0,Drowning,1
75410498,2,Rural Wisconsin,17,1,0,0.0,Weapon Not Reported,1
75541922,9,"Kingston, NY",10,1,0,0.0,Other or type unknown,1
75616501,2,"Iowa City, IA",5,1,0,0.0,"Firearm, type not stated",1
75679328,9,"Flint, MI",5,1,0,0.0,"Firearm, type not stated",1
76115547,2,Rural Maine,2,1,0,0.0,Drowning,1
76714675,2,"Topeka, KS",16,1,0,0.0,Strangulation - hanging,1
76844381,1,"Montgomery, AL",2,1,0,0.0,Drowning,1
77806450,2,"Sacramento-Roseville, CA",17,1,0,0.0,Weapon Not Reported,1
77808232,1,"Madison, WI",17,1,0,0.0,Weapon Not Reported,1
77881699,2,Rural Utah,16,1,0,0.0,Strangulation - hanging,1
78533803,1,Rural Maine,16,1,0,0.0,Strangulation - hanging,1
78701463,2,"Logan, UT-ID",10,1,0,0.0,Other or type unknown,1
79173487,9,"New Orleans-Metairie-Kenner, LA",14,1,0,0.0,Rifle,1
79352972,1,Rural New York,3,1,0,0.0,Explosives,1
79359759,9,"Orlando-Kissimmee, FL",5,1,0,0.0,"Firearm, type not stated",1
79713262,1,"Anderson, SC",9,1,0,0.0,Other gun,1
79821540,1,"Lubbock, TX",17,1,0,0.0,Weapon Not Reported,1
79967336,1,"Milwaukee-Waukesha-West Allis, WI",3,1,0,0.0,Explosives,1
80242969,9,"Clarksville, TN-KY",8,1,0,0.0,"Narcotics or drugs, sleeping pills",1
80320320,2,"Salt Lake City, UT",3,1,0,0.0,Explosives,1
80481856,9,"Baltimore-Towson, MD",1,1,0,0.0,"Blunt object - hammer, club, etc",1
80704000,2,"Danville, VA",17,1,0,0.0,Weapon Not Reported,1
80767810,1,"Salem, OR",12,1,0,0.0,Poison - does not include gas,1
80792382,1,"Hattiesburg, MS",16,1,0,0.0,Strangulation - hanging,1
80997359,1,"Canton-Massillon, OH",8,1,0,0.0,"Narcotics or drugs, sleeping pills",1
81239120,9,Rural Oklahoma,5,1,0,0.0,"Firearm, type not stated",1
81277761,9,"Bowling Green, KY",7,1,0,0.0,Knife or cutting instrument,1
81360022,1,"Cape Coral-Fort Myers, FL",3,1,0,0.0,Explosives,1
81525168,9,"San Antonio, TX",2,1,0,0.0,Drowning,1
81864750,9,"Winchester, VA-WV",10,1,0,0.0,Other or type unknown,1
82151297,9,"Huntington-Ashland, WV-KY-OH",5,1,0,0.0,"Firearm, type not stated",1
82193952,1,"Flint, MI",2,1,0,0.0,Drowning,1
82414628,9,Rural Alabama,11,1,0,0.0,"Personal weapons, includes beating",1
82875931,9,Rural Michigan,7,1,0,0.0,Knife or cutting instrument,1
82984679,9,"Riverside-San Bernardino, CA",4,1,0,0.0,Fire,1
83063127,9,Rural Georgia,7,1,0,0.0,Knife or cutting instrument,1
83139659,9,"Jacksonville, NC",10,1,0,0.0,Other or type unknown,1
83165650,1,"Hickory-Lenoir-Morganton, NC",3,1,0,0.0,Explosives,1
83241774,9,"Jackson, TN",6,1,0,0.0,"Handgun - pistol, revolver, etc",1
83262563,2,"Santa Rosa-Petaluma, CA",2,1,0,0.0,Drowning,1
83741378,2,"Yuma, AZ",17,1,0,0.0,Weapon Not Reported,1
84177504,2,"Albuquerque, NM",9,1,0,0.0,Other gun,1
84785272,2,"Bay City, MI",12,1,0,0.0,Poison - does not include gas,1
85142022,9,"Anniston-Oxford, AL",7,1,0,0.0,Knife or cutting instrument,1
85200188,9,"Saginaw, MI",7,1,0,0.0,Knife or cutting instrument,1
85343978,9,"Pittsburgh, PA",10,1,0,0.0,Other or type unknown,1
85695662,1,"Atlantic City, NJ",8,1,0,0.0,"Narcotics or drugs, sleeping pills",1
86010297,2,Rural Nebraska,17,1,0,0.0,Weapon Not Reported,1
86024559,9,"Albuquerque, NM",1,1,0,0.0,"Blunt object - hammer, club, etc",1
86031793,1,"Tallahassee, FL",0,1,0,0.0,Asphyxiation - includes death by gas,1
86133203,2,"Parkersburg-Marietta-Vienna, WV-OH",1,1,0,0.0,"Blunt object - hammer, club, etc",1
86139452,2,Rural Oklahoma,9,1,0,0.0,Other gun,1
86461860,1,"Rockford, IL",4,1,0,0.0,Fire,1
86576022,2,Rural Kentucky,17,1,0,0.0,Weapon Not Reported,1
86586812,9,"Fargo, ND-MN",10,1,0,0.0,Other or type unknown,1
86653170,1,Rural Wyoming,17,1,0,0.0,Weapon Not Reported,1
86678054,1,"Sherman-Denison, TX",4,1,0,0.0,Fire,1
86778321,9,"Atlanta-Sandy Springs-Marietta, GA",6,1,0,0.0,"Handgun - pistol, revolver, etc",1
86876537,1,Rural New York,9,1,0,0.0,Other gun,1
87056958,2,"Tyler, TX",16,1,0,0.0,Strangulation - hanging,1
87498980,9,"Columbus, OH",1,1,0,0.0,"Blunt object - hammer, club, etc",1
88461798,1,"Florence, SC",9,1,0,0.0,Other gun,1
88538398,2,"Elkhart-Goshen, IN",9,1,0,0.0,Other gun,1
88906370,1,"Monroe, LA",16,1,0,0.0,Strangulation - hanging,1
89074649,9,"Bakersfield, CA",6,1,0,0.0,"Handgun - pistol, revolver, etc",1
89165845,2,"Lima, OH",5,1,0,0.0,"Firearm, type not stated",1
89265609,9,"Holland-Grand Haven, MI",1,1,0,0.0,"Blunt object - hammer, club, etc",1
89290705,9,"Baltimore-Towson, MD",9,1,0,0.0,Other gun,1
89376124,2,Rural Tennessee,3,1,0,0.0,Explosives,1
89432105,2,"Punta Gorda, FL",15,1,0,0.0,Shotgun,1
89644641,9,Rural South Carolina,5,1,0,0.0,"Firearm, type not stated",1
90047908,9,"Oklahoma City, OK",4,1,0,0.0,Fire,1
90228313,2,"Tucson, AZ",12,1,0,0.0,Poison - does not include gas,1
90587708,1,"Olympia, WA",8,1,0,0.0,"Narcotics or drugs, sleeping pills",1
90593947,9,"Miami-Fort Lauderdale, FL",11,1,0,0.0,"Personal weapons, includes beating",1
90798728,1,"Santa Fe, NM",3,1,0,0.0,Explosives,1
90871293,9,Rural North Carolina,4,1,0,0.0,Fire,1
90949357,2,"Kennewick-Richland-Pasco, WA",0,1,0,0.0,Asphyxiation - includes death by gas,1
90950748,2,"Naples-Marco Island, FL",0,1,0,0.0,Asphyxiation - includes death by gas,1
91061298,1,"Lansing-East Lansing, MI",3,1,0,0.0,Explosives,1
91343927,9,"Saginaw, MI",14,1,0,0.0,Rifle,1
91557794,9,"Mobile, AL",4,1,0,0.0,Fire,1
91825514,1,"Alexandria, LA",2,1,0,0.0,Drowning,1
91846961,1,"Oxnard-Thousand Oaks-Ventura, CA",9,1,0,0.0,Other gun,1
91856368,9,"Trenton-Ewing, NJ",6,1,0,0.0,"Handgun - pistol, revolver, etc",1
92034491,9,"Mobile, AL",1,1,0,0.0,"Blunt object - hammer, club, etc",1
92094053,2,"Cincinnati-Middletown, OH-KY-IN",17,1,0,0.0,Weapon Not Reported,1
92214735,9,"Canton-Massillon, OH",11,1,0,0.0,"Personal weapons, includes beating",1
92429087,2,"Rome, GA",16,1,0,0.0,Strangulation - hanging,1
92447085,2,"Madison, WI",17,1,0,0.0,Weapon Not Reported,1
92631057,2,"Medford, OR",3,1,0,0.0,Explosives,1
92715388,9,"Seattle-Tacoma-Bellevue, WA",9,1,0,0.0,Other gun,1
92716603,2,"Kalamazoo-Portage, MI",2,1,0,0.0,Drowning,1
92783020,9,"San Diego-Carlsbad-San Marcos, CA",7,1,0,0.0,Knife or cutting instrument,1
93528446,9,"Charlotte-Gastonia-Concord, NC-SC",10,1,0,0.0,Other or type unknown,1
93577629,1,Rural South Dakota,17,1,0,0.0,Weapon Not Reported,1
93630373,1,"Anderson, SC",16,1,0,0.0,Strangulation - hanging,1
93633915,2,"Dothan, AL",17,1,0,0.0,Weapon Not Reported,1
93668394,1,Rural Colorado,3,1,0,0.0,Explosives,1
94030333,2,"Toledo, OH",17,1,0,0.0,Weapon Not Reported,1
94058250,1,"Akron, OH",17,1,0,0.0,Weapon Not Reported,1
94271163,9,"Pine Bluff, AR",4,1,0,0.0,Fire,1
94612068,9,"Yakima, WA",4,1,0,0.0,Fire,1
94678452,1,"Tucson, AZ",3,1,0,0.0,Explosives,1
94728862,2,"Jonesboro, AR",17,1,0,0.0,Weapon Not Reported,1
94969590,2,"State College, PA",16,1,0,0.0,Strangulation - hanging,1
94980808,1,Rural Kentucky,17,1,0,0.0,Weapon Not Reported,1
95237218,2,Rural New York,2,1,0,0.0,Drowning,1
95458431,1,"Vallejo-Fairfield, CA",8,1,0,0.0,"Narcotics or drugs, sleeping pills",1
95462784,9,"Longview, WA",6,1,0,0.0,"Handgun - pistol, revolver, etc",1
95606573,1,"Las Cruces, NM",4,1,0,0.0,Fire,1
96415813,1,"Dothan, AL",17,1,0,0.0,Weapon Not Reported,1
96547446,2,"Charlottesville, VA",17,1,0,0.0,Weapon Not Reported,1
96910902,1,"Clarksville, TN-KY",3,1,0,0.0,Explosives,1
97064581,1,"Danville, VA",4,1,0,0.0,Fire,1
97214238,9,"Naples-Marco Island, FL",10,1,0,0.0,Other or type unknown,1
97296320,9,Rural Virginia,9,1,0,0.0,Other gun,1
97336590,1,"New Haven-Milford, CT",9,1,0,0.0,Other gun,1
97532685,1,"Gainesville, GA",0,1,0,0.0,Asphyxiation - includes death by gas,1
97672207,1,"Sacramento-Roseville, CA",17,1,0,0.0,Weapon Not Reported,1
98241286,2,"Deltona-Daytona Beach-Ormond Beach, FL",13,1,0,0.0,Pushed or thrown out window,1
98330133,2,"Greenville, NC",17,1,0,0.0,Weapon Not Reported,1
98700947,9,"Jacksonville, FL",7,1,0,0.0,Knife or cutting instrument,1
99115348,9,"Niles-Benton Harbor, MI",6,1,0,0.0,"Handgun - pistol, revolver, etc",1
99466769,1,"Joplin, MO",0,1,0,0.0,Asphyxiation - includes death by gas,1
89570266,2,"Oklahoma City, OK",3,94,94,1.0,Explosives,0
15813466,1,Rural Missouri,11,84,84,1.0,"Personal weapons, includes beating",0
21789186,1,"Columbia, SC",11,82,82,1.0,"Personal weapons, includes beating",0
66503452,2,Rural Maine,6,79,79,1.0,"Handgun - pistol, revolver, etc",0
19293222,1,"Oklahoma City, OK",3,78,78,1.0,Explosives,0
53811352,2,Rural West Virginia,15,71,71,1.0,Shotgun,0
19338757,1,"Charleston, WV",15,56,56,1.0,Shotgun,0
90892736,1,"Colorado Springs, CO",11,56,56,1.0,"Personal weapons, includes beating",0
60603251,1,"Wenatchee, WA",6,53,53,1.0,"Handgun - pistol, revolver, etc",0
43867649,1,Rural Minnesota,11,52,52,1.0,"Personal weapons, includes beating",0
3363961,1,"Asheville, NC",15,50,50,1.0,Shotgun,0
38990179,2,Rural West Virginia,14,50,50,1.0,Rifle,0
80734691,2,Rural Minnesota,11,47,47,1.0,"Personal weapons, includes beating",0
51501711,2,Rural Minnesota,15,46,46,1.0,Shotgun,0
17776209,2,Rural New York,14,43,43,1.0,Rifle,0
52474899,2,Rural California,15,43,43,1.0,Shotgun,0
80052619,2,Rural Maryland,6,43,43,1.0,"Handgun - pistol, revolver, etc",0
23637747,2,"Portland-Vancouver-Beaverton, OR-WA",15,41,41,1.0,Shotgun,0
56544514,1,Rural Nebraska,14,41,41,1.0,Rifle,0
90057440,2,"Cincinnati-Middletown, OH-KY-IN",15,40,40,1.0,Shotgun,0
59900206,1,"Johnson City, TN",7,39,39,1.0,Knife or cutting instrument,0
4780629,2,"Rocky Mount, NC",6,38,38,1.0,"Handgun - pistol, revolver, etc",0
79555621,2,Rural Minnesota,14,38,38,1.0,Rifle,0
40068304,2,"Denver-Aurora, CO",15,37,37,1.0,Shotgun,0
58081742,2,"Rome, GA",6,37,37,1.0,"Handgun - pistol, revolver, etc",0
54408336,1,"Amarillo, TX",15,36,36,1.0,Shotgun,0
35634523,1,"Charlottesville, VA",7,35,35,1.0,Knife or cutting instrument,0
74987449,1,"Alexandria, LA",15,35,35,1.0,Shotgun,0
92911336,1,Rural Nevada,11,35,35,1.0,"Personal weapons, includes beating",0
17608844,1,"Bismarck, ND",10,34,34,1.0,Other or type unknown,0
24739542,2,Rural Washington,14,34,34,1.0,Rifle,0
34312100,1,"Greenville, NC",15,34,34,1.0,Shotgun,0
42516166,1,Rural South Dakota,7,34,34,1.0,Knife or cutting instrument,0
47374552,1,Rural Nebraska,11,34,34,1.0,"Personal weapons, includes beating",0
72430935,1,"Roanoke, VA",11,33,33,1.0,"Personal weapons, includes beating",0
95691292,2,Rural Montana,14,32,32,1.0,Rifle,0
51521487,1,"Idaho Falls, ID",6,31,31,1.0,"Handgun - pistol, revolver, etc",0
66173930,2,Rural North Carolina,8,31,31,1.0,"Narcotics or drugs, sleeping pills",0
31558692,1,"Fort Collins-Loveland, CO",7,30,30,1.0,Knife or cutting instrument,0
65636067,1,Rural Louisiana,4,30,30,1.0,Fire,0
89729775,1,"Wichita Falls, TX",14,30,30,1.0,Rifle,0
30972328,2,"Charleston-North Charleston, SC",15,29,29,1.0,Shotgun,0
32004007,1,"Missoula, MT",6,29,29,1.0,"Handgun - pistol, revolver, etc",0
84311141,1,"Myrtle Beach-Conway, SC",11,29,29,1.0,"Personal weapons, includes beating",0
10879567,1,Rural New Hampshire,11,28,28,1.0,"Personal weapons, includes beating",0
37641395,2,"Austin-Round Rock, TX",15,28,28,1.0,Shotgun,0
41905489,1,"Asheville, NC",14,28,28,1.0,Rifle,0
47206851,2,"San Jose-Sunnyvale-Santa Clara, CA",14,28,28,1.0,Rifle,0
79349797,2,"Minneapolis-St. Paul-Bloomington, MN-WI",14,28,28,1.0,Rifle,0
85741705,2,"Ogden-Clearfield, UT",11,28,28,1.0,"Personal weapons, includes beating",0
75198633,1,"Lafayette, LA",15,27,27,1.0,Shotgun,0
15656431,2,Rural Illinois,15,26,26,1.0,Shotgun,0
22245829,1,"Sarasota-Bradenton-Venice, FL",15,26,26,1.0,Shotgun,0
37973365,2,"Little Rock-North Little Rock, AR",14,26,26,1.0,Rifle,0
45376740,2,Rural Montana,7,26,26,1.0,Knife or cutting instrument,0
58662699,2,Rural Alaska,11,26,26,1.0,"Personal weapons, includes beating",0
73461230,1,Rural Maryland,14,26,26,1.0,Rifle,0
76624463,1,Rural Utah,14,26,26,1.0,Rifle,0
79479019,1,Rural South Dakota,14,26,26,1.0,Rifle,0
92707566,1,"Sioux City, IA-NE-SD",7,26,26,1.0,Knife or cutting instrument,0
47626245,2,"St. Louis, MO-IL",8,25,25,1.0,"Narcotics or drugs, sleeping pills",0
60339282,2,"Minneapolis-St. Paul-Bloomington, MN-WI",8,25,25,1.0,"Narcotics or drugs, sleeping pills",0
60362515,2,"Lincoln, NE",6,25,25,1.0,"Handgun - pistol, revolver, etc",0
60879075,1,"Kalamazoo-Portage, MI",15,25,25,1.0,Shotgun,0
94669069,1,"Barnstable Town, MA",7,25,25,1.0,Knife or cutting instrument,0
31679375,1,"Burlington, NC",5,24,24,1.0,"Firearm, type not stated",0
57462164,2,"Myrtle Beach-Conway, SC",11,24,24,1.0,"Personal weapons, includes beating",0
61989703,1,"Spartanburg, SC",11,24,24,1.0,"Personal weapons, includes beating",0
64213627,1,"Sumter, SC",15,24,24,1.0,Shotgun,0
71342545,2,Rural Ohio,14,24,24,1.0,Rifle,0
88237887,2,Rural Maine,14,24,24,1.0,Rifle,0
97670245,2,Rural South Dakota,6,24,24,1.0,"Handgun - pistol, revolver, etc",0
2310792,2,"Brunswick, GA",6,23,23,1.0,"Handgun - pistol, revolver, etc",0
8854147,1,"Gainesville, FL",14,23,23,1.0,Rifle,0
12746516,1,"Ocean City, NJ",7,23,23,1.0,Knife or cutting instrument,0
14579230,1,"Wheeling, WV-OH",10,23,23,1.0,Other or type unknown,0
15390818,1,"Bowling Green, KY",7,23,23,1.0,Knife or cutting instrument,0
21698179,2,"Austin-Round Rock, TX",14,23,23,1.0,Rifle,0
48288549,1,"Oshkosh-Neenah, WI",6,23,23,1.0,"Handgun - pistol, revolver, etc",0
56957187,1,"Auburn-Opelika, AL",15,23,23,1.0,Shotgun,0
93223409,1,"Panama City-Lynn Haven, FL",11,23,23,1.0,"Personal weapons, includes beating",0
99867714,2,"Manchester-Nashua, NH",6,23,23,1.0,"Handgun - pistol, revolver, etc",0
833045,1,"Mansfield, OH",7,22,22,1.0,Knife or cutting instrument,0
4501350,2,"Syracuse, NY",15,22,22,1.0,Shotgun,0
22262917,1,Rural Idaho,15,22,22,1.0,Shotgun,0
33669959,1,"Lincoln, NE",11,22,22,1.0,"Personal weapons, includes beating",0
35325222,1,"Lewiston-Auburn, ME",14,22,22,1.0,Rifle,0
41278657,2,"Parkersburg-Marietta-Vienna, WV-OH",6,22,22,1.0,"Handgun - pistol, revolver, etc",0
60288955,2,"Huntsville, AL",15,22,22,1.0,Shotgun,0
74005381,1,"Tyler, TX",11,22,22,1.0,"Personal weapons, includes beating",0
86086621,1,"Albany, GA",15,22,22,1.0,Shotgun,0
89046812,2,Rural Idaho,11,22,22,1.0,"Personal weapons, includes beating",0
96879208,1,"Bremerton-Silverdale, WA",7,22,22,1.0,Knife or cutting instrument,0
98088577,1,"Charlottesville, VA",15,22,22,1.0,Shotgun,0
3942880,2,"El Paso, TX",14,21,21,1.0,Rifle,0
10251735,1,"Appleton, WI",6,21,21,1.0,"Handgun - pistol, revolver, etc",0
12846887,1,"St. Cloud, MN",6,21,21,1.0,"Handgun - pistol, revolver, etc",0
44442383,2,"Kalamazoo-Portage, MI",15,21,21,1.0,Shotgun,0
56630466,2,Rural Colorado,14,21,21,1.0,Rifle,0
65518293,1,"Rochester, MN",6,21,21,1.0,"Handgun - pistol, revolver, etc",0
74869209,1,"Pascagoula, MS",15,21,21,1.0,Shotgun,0
82344968,1,"Duluth, MN-WI",11,21,21,1.0,"Personal weapons, includes beating",0
82784459,1,"Abilene, TX",14,21,21,1.0,Rifle,0
85960744,2,Rural Idaho,14,21,21,1.0,Rifle,0
86911650,1,"Lafayette, LA",11,21,21,1.0,"Personal weapons, includes beating",0
13439495,1,"Cincinnati-Middletown, OH-KY-IN",12,20,20,1.0,Poison - does not include gas,0
21930262,2,Rural Maryland,15,20,20,1.0,Shotgun,0
25499005,2,"Springfield, IL",7,20,20,1.0,Knife or cutting instrument,0
49297828,2,"Jackson, MI",6,20,20,1.0,"Handgun - pistol, revolver, etc",0
68238930,2,"Roanoke, VA",15,20,20,1.0,Shotgun,0
77722596,2,"Fayetteville, NC",15,20,20,1.0,Shotgun,0
80140246,2,Rural Hawaii,11,20,20,1.0,"Personal weapons, includes beating",0
80659167,1,"Charleston, WV",1,20,20,1.0,"Blunt object - hammer, club, etc",0
92104100,1,"Victoria, TX",0,20,20,1.0,Asphyxiation - includes death by gas,0
9282347,2,Rural Oregon,15,19,19,1.0,Shotgun,0
16335692,1,"Utica-Rome, NY",11,19,19,1.0,"Personal weapons, includes beating",0
16601097,2,Rural Maryland,14,19,19,1.0,Rifle,0
37881738,1,Rural North Dakota,5,19,19,1.0,"Firearm, type not stated",0
39117527,1,"Midland, TX",14,19,19,1.0,Rifle,0
42493339,2,"Madison, WI",11,19,19,1.0,"Personal weapons, includes beating",0
50330441,2,"Bismarck, ND",10,19,19,1.0,Other or type unknown,0
51521345,2,"Waco, TX",11,19,19,1.0,"Personal weapons, includes beating",0
52799166,2,"Sioux City, IA-NE-SD",6,19,19,1.0,"Handgun - pistol, revolver, etc",0
56638430,2,"Providence-New Bedford-Fall River, RI-MA",14,19,19,1.0,Rifle,0
64160937,1,Rural North Dakota,11,19,19,1.0,"Personal weapons, includes beating",0
64333048,2,"Hinesville-Fort Stewart, GA",6,19,19,1.0,"Handgun - pistol, revolver, etc",0
71618249,2,Rural Tennessee,8,19,19,1.0,"Narcotics or drugs, sleeping pills",0
80496181,2,"Winston-Salem, NC",14,19,19,1.0,Rifle,0
86760291,1,"Huntington-Ashland, WV-KY-OH",11,19,19,1.0,"Personal weapons, includes beating",0
88221205,1,"Kingsport-Bristol-Bristol, TN-VA",11,19,19,1.0,"Personal weapons, includes beating",0
89959311,2,"Asheville, NC",15,19,19,1.0,Shotgun,0
95535319,2,"Casper, WY",6,19,19,1.0,"Handgun - pistol, revolver, etc",0
22346830,2,Rural Maine,1,18,18,1.0,"Blunt object - hammer, club, etc",0
35771219,1,"Des Moines, IA",14,18,18,1.0,Rifle,0
38382509,1,"Yuba City, CA",11,18,18,1.0,"Personal weapons, includes beating",0
45331841,2,"Fayetteville-Springdale-Rogers, AR-MO",5,18,18,1.0,"Firearm, type not stated",0
46581732,1,"Clarksville, TN-KY",14,18,18,1.0,Rifle,0
52297547,1,"Abilene, TX",15,18,18,1.0,Shotgun,0
53559414,2,"McAllen-Edinburg-Mission, TX",15,18,18,1.0,Shotgun,0
61288862,1,"Sheboygan, WI",6,18,18,1.0,"Handgun - pistol, revolver, etc",0
63055868,2,"Cumberland, MD-WV",6,18,18,1.0,"Handgun - pistol, revolver, etc",0
68100367,1,"Lewiston-Auburn, ME",6,18,18,1.0,"Handgun - pistol, revolver, etc",0
72902824,2,"Santa Fe, NM",14,18,18,1.0,Rifle,0
79792173,1,Rural Utah,11,18,18,1.0,"Personal weapons, includes beating",0
86086750,2,"Rapid City, SD",6,18,18,1.0,"Handgun - pistol, revolver, etc",0
90273960,2,Rural Iowa,14,18,18,1.0,Rifle,0
95562480,2,"Provo-Orem, UT",11,18,18,1.0,"Personal weapons, includes beating",0
96508937,2,"Wheeling, WV-OH",6,18,18,1.0,"Handgun - pistol, revolver, etc",0
4946985,2,"Yakima, WA",11,17,17,1.0,"Personal weapons, includes beating",0
12011365,2,"Shreveport-Bossier City, LA",14,17,17,1.0,Rifle,0
21350414,1,"Greeley, CO",14,17,17,1.0,Rifle,0
27988115,2,"Hartford, CT",15,17,17,1.0,Shotgun,0
30889006,1,"Sioux Falls, SD",11,17,17,1.0,"Personal weapons, includes beating",0
32839735,1,"Houma-Bayou Cane-Thibodaux, LA",11,17,17,1.0,"Personal weapons, includes beating",0
33025216,1,"Tuscaloosa, AL",14,17,17,1.0,Rifle,0
36455361,2,"Salt Lake City, UT",14,17,17,1.0,Rifle,0
38498034,2,Rural Utah,7,17,17,1.0,Knife or cutting instrument,0
44211785,2,"Santa Fe, NM",11,17,17,1.0,"Personal weapons, includes beating",0
52033039,1,"Monroe, LA",11,17,17,1.0,"Personal weapons, includes beating",0
76346130,2,Rural Maine,15,17,17,1.0,Shotgun,0
78688026,1,"Lake Charles, LA",14,17,17,1.0,Rifle,0
88384696,2,"Visalia-Porterville, CA",14,17,17,1.0,Rifle,0
92025278,1,"Blacksburg-Christiansburg, VA",7,17,17,1.0,Knife or cutting instrument,0
93570087,1,"Albany, GA",11,17,17,1.0,"Personal weapons, includes beating",0
97787993,1,"Binghamton, NY",1,17,17,1.0,"Blunt object - hammer, club, etc",0
99488731,2,"Pine Bluff, AR",15,17,17,1.0,Shotgun,0
2797753,2,"Lancaster, PA",15,16,16,1.0,Shotgun,0
10141249,1,"Battle Creek, MI",14,16,16,1.0,Rifle,0
12086743,1,"Bloomington, IN",7,16,16,1.0,Knife or cutting instrument,0
14389710,1,Rural Nebraska,5,16,16,1.0,"Firearm, type not stated",0
16617087,2,Rural West Virginia,4,16,16,1.0,Fire,0
37292923,1,"Kingston, NY",14,16,16,1.0,Rifle,0
38883231,2,"Monroe, MI",6,16,16,1.0,"Handgun - pistol, revolver, etc",0
39601687,2,"Brownsville-Harlingen, TX",11,16,16,1.0,"Personal weapons, includes beating",0
41684544,2,Rural Virginia,0,16,16,1.0,Asphyxiation - includes death by gas,0
46116887,2,"Albany-Schenectady-Troy, NY",14,16,16,1.0,Rifle,0
60198963,1,Rural Minnesota,8,16,16,1.0,"Narcotics or drugs, sleeping pills",0
60637108,2,"Richmond, VA",4,16,16,1.0,Fire,0
64445604,2,"Fayetteville-Springdale-Rogers, AR-MO",14,16,16,1.0,Rifle,0
66805015,2,Rural Wyoming,14,16,16,1.0,Rifle,0
67286541,2,"Kingsport-Bristol-Bristol, TN-VA",15,16,16,1.0,Shotgun,0
83858819,1,"Springfield, MA",14,16,16,1.0,Rifle,0
87529233,2,"Weirton-Steubenville, WV-OH",6,16,16,1.0,"Handgun - pistol, revolver, etc",0
95456723,2,"Spartanburg, SC",15,16,16,1.0,Shotgun,0
99616539,1,"Portland-South Portland-Biddeford, ME",15,16,16,1.0,Shotgun,0
99946840,1,Rural Utah,1,16,16,1.0,"Blunt object - hammer, club, etc",0
9756005,2,"Greenville, SC",14,15,15,1.0,Rifle,0
9927844,1,Rural North Dakota,15,15,15,1.0,Shotgun,0
17019206,2,"Charleston, WV",15,15,15,1.0,Shotgun,0
17757974,1,Rural Missouri,0,15,15,1.0,Asphyxiation - includes death by gas,0
19808077,1,Rural South Dakota,15,15,15,1.0,Shotgun,0
19919299,2,"Columbus, GA-AL",1,15,15,1.0,"Blunt object - hammer, club, etc",0
24839961,1,"Alexandria, LA",11,15,15,1.0,"Personal weapons, includes beating",0
27383759,2,"Myrtle Beach-Conway, SC",15,15,15,1.0,Shotgun,0
30224710,1,"Bangor, ME",11,15,15,1.0,"Personal weapons, includes beating",0
31448628,2,"Kingston, NY",6,15,15,1.0,"Handgun - pistol, revolver, etc",0
35633023,1,"Niles-Benton Harbor, MI",11,15,15,1.0,"Personal weapons, includes beating",0
39617021,2,"Binghamton, NY",5,15,15,1.0,"Firearm, type not stated",0
40752487,1,"Rochester, MN",7,15,15,1.0,Knife or cutting instrument,0
48781866,2,"Alexandria, LA",11,15,15,1.0,"Personal weapons, includes beating",0
49409351,1,"Racine, WI",11,15,15,1.0,"Personal weapons, includes beating",0
50043466,1,"Fond du Lac, WI",6,15,15,1.0,"Handgun - pistol, revolver, etc",0
55995724,1,"Barnstable Town, MA",6,15,15,1.0,"Handgun - pistol, revolver, etc",0
58678967,1,"Cincinnati-Middletown, OH-KY-IN",0,15,15,1.0,Asphyxiation - includes death by gas,0
68381383,1,"Hagerstown-Martinsburg, MD-WV",14,15,15,1.0,Rifle,0
73848869,2,"Lawrence, KS",6,15,15,1.0,"Handgun - pistol, revolver, etc",0
74973521,1,"Charlottesville, VA",14,15,15,1.0,Rifle,0
85240066,1,"Syracuse, NY",4,15,15,1.0,Fire,0
85376996,2,Rural Nevada,11,15,15,1.0,"Personal weapons, includes beating",0
86280915,2,Rural Delaware,15,15,15,1.0,Shotgun,0
87571474,2,"Owensboro, KY",6,15,15,1.0,"Handgun - pistol, revolver, etc",0
99103995,2,"Harrisonburg, VA",6,15,15,1.0,"Handgun - pistol, revolver, etc",0
1125923,2,Rural Alaska,0,14,14,1.0,Asphyxiation - includes death by gas,0
11198325,1,Rural South Dakota,12,14,14,1.0,Poison - does not include gas,0
14350296,2,"Kingsport-Bristol-Bristol, TN-VA",7,14,14,1.0,Knife or cutting instrument,0
18318357,2,"Ocala, FL",15,14,14,1.0,Shotgun,0
18513010,1,"Cheyenne, WY",7,14,14,1.0,Knife or cutting instrument,0
19193964,2,"Boulder, CO",7,14,14,1.0,Knife or cutting instrument,0
21416608,1,"Kokomo, IN",11,14,14,1.0,"Personal weapons, includes beating",0
22059007,1,"Lafayette, IN",15,14,14,1.0,Shotgun,0
23362681,2,"Kingsport-Bristol-Bristol, TN-VA",11,14,14,1.0,"Personal weapons, includes beating",0
25962771,2,"Pensacola-Ferry Pass-Brent, FL",15,14,14,1.0,Shotgun,0
26255944,1,"Johnson City, TN",14,14,14,1.0,Rifle,0
27661114,2,Rural Ohio,0,14,14,1.0,Asphyxiation - includes death by gas,0
30453945,1,"Salt Lake City, UT",0,14,14,1.0,Asphyxiation - includes death by gas,0
32611857,2,"Longview, WA",6,14,14,1.0,"Handgun - pistol, revolver, etc",0
37796181,2,Rural South Dakota,11,14,14,1.0,"Personal weapons, includes beating",0
41085595,1,"Bend, OR",14,14,14,1.0,Rifle,0
42539636,2,Rural Nebraska,14,14,14,1.0,Rifle,0
50954168,1,"Tucson, AZ",8,14,14,1.0,"Narcotics or drugs, sleeping pills",0
54837877,1,"Bremerton-Silverdale, WA",11,14,14,1.0,"Personal weapons, includes beating",0
56813183,2,"Spokane, WA",14,14,14,1.0,Rifle,0
59058721,1,"Blacksburg-Christiansburg, VA",15,14,14,1.0,Shotgun,0
60436179,2,"Lake Charles, LA",15,14,14,1.0,Shotgun,0
65132305,2,"Binghamton, NY",15,14,14,1.0,Shotgun,0
65976914,2,Rural West Virginia,8,14,14,1.0,"Narcotics or drugs, sleeping pills",0
66605488,2,"Knoxville, TN",14,14,14,1.0,Rifle,0
69917923,2,"Anderson, SC",15,14,14,1.0,Shotgun,0
74153964,2,"Boise City-Nampa, ID",14,14,14,1.0,Rifle,0
74410539,1,"Winchester, VA-WV",15,14,14,1.0,Shotgun,0
76803511,1,"San Luis Obispo-Paso Robles, CA",15,14,14,1.0,Shotgun,0
77053219,2,"Killeen-Temple-Fort Hood, TX",14,14,14,1.0,Rifle,0
82197647,2,Rural Maine,5,14,14,1.0,"Firearm, type not stated",0
87958233,1,"Norwich-New London, CT",11,14,14,1.0,"Personal weapons, includes beating",0
93001218,1,"Burlington, NC",11,14,14,1.0,"Personal weapons, includes beating",0
95654587,2,"Macon, GA",15,14,14,1.0,Shotgun,0
95936708,2,"Wausau, WI",6,14,14,1.0,"Handgun - pistol, revolver, etc",0
96914125,1,"Hanford-Corcoran, CA",1,14,14,1.0,"Blunt object - hammer, club, etc",0
97492053,2,"Binghamton, NY",11,14,14,1.0,"Personal weapons, includes beating",0
2003071,1,"Muskegon-Norton Shores, MI",11,13,13,1.0,"Personal weapons, includes beating",0
4206382,1,"Richmond, VA",8,13,13,1.0,"Narcotics or drugs, sleeping pills",0
5004733,1,"Fargo, ND-MN",5,13,13,1.0,"Firearm, type not stated",0
8229561,2,"Greeley, CO",11,13,13,1.0,"Personal weapons, includes beating",0
9995960,1,"Jackson, TN",14,13,13,1.0,Rifle,0
15874055,1,"Peoria, IL",11,13,13,1.0,"Personal weapons, includes beating",0
19468281,1,"Lancaster, PA",15,13,13,1.0,Shotgun,0
22862765,2,Rural North Dakota,15,13,13,1.0,Shotgun,0
23243911,1,"Jonesboro, AR",15,13,13,1.0,Shotgun,0
27719832,2,"Jonesboro, AR",14,13,13,1.0,Rifle,0
29714409,2,"Bellingham, WA",7,13,13,1.0,Knife or cutting instrument,0
31700246,1,"Farmington, NM",14,13,13,1.0,Rifle,0
32259416,1,Rural Wisconsin,0,13,13,1.0,Asphyxiation - includes death by gas,0
32442996,2,"Trenton-Ewing, NJ",15,13,13,1.0,Shotgun,0
33906851,1,"Anderson, IN",7,13,13,1.0,Knife or cutting instrument,0
34188922,1,"Green Bay, WI",14,13,13,1.0,Rifle,0
38822134,1,"Spokane, WA",16,13,13,1.0,Strangulation - hanging,0
39611626,2,"Hanford-Corcoran, CA",6,13,13,1.0,"Handgun - pistol, revolver, etc",0
40184903,2,"Eugene-Springfield, OR",11,13,13,1.0,"Personal weapons, includes beating",0
50189068,2,"Springfield, MA",4,13,13,1.0,Fire,0
50209147,2,"Modesto, CA",15,13,13,1.0,Shotgun,0
58675801,2,"Chico, CA",15,13,13,1.0,Shotgun,0
60960367,2,"Utica-Rome, NY",15,13,13,1.0,Shotgun,0
63186926,2,"Boise City-Nampa, ID",15,13,13,1.0,Shotgun,0
63805364,1,"Cumberland, MD-WV",11,13,13,1.0,"Personal weapons, includes beating",0
63837000,2,"New Haven-Milford, CT",15,13,13,1.0,Shotgun,0
64008857,1,"Ann Arbor, MI",11,13,13,1.0,"Personal weapons, includes beating",0
65451798,1,"Detroit-Warren-Livonia, MI",2,13,13,1.0,Drowning,0
67859137,2,"Omaha-Council Bluffs, NE-IA",15,13,13,1.0,Shotgun,0
70899484,1,"Bellingham, WA",14,13,13,1.0,Rifle,0
76837879,2,"Cheyenne, WY",11,13,13,1.0,"Personal weapons, includes beating",0
85658218,2,"Scranton--Wilkes-Barre, PA",15,13,13,1.0,Shotgun,0
94391126,1,"Appleton, WI",7,13,13,1.0,Knife or cutting instrument,0
96294531,1,"Ogden-Clearfield, UT",14,13,13,1.0,Rifle,0
524389,2,Rural North Dakota,11,12,12,1.0,"Personal weapons, includes beating",0
567146,1,"Idaho Falls, ID",14,12,12,1.0,Rifle,0
1019195,2,"Sandusky, OH",6,12,12,1.0,"Handgun - pistol, revolver, etc",0
2703058,2,"Bend, OR",6,12,12,1.0,"Handgun - pistol, revolver, etc",0
2894596,2,"Lynchburg, VA",15,12,12,1.0,Shotgun,0
5985940,1,"Wausau, WI",7,12,12,1.0,Knife or cutting instrument,0
7298092,2,"Gainesville, GA",11,12,12,1.0,"Personal weapons, includes beating",0
7965834,2,Rural Kansas,0,12,12,1.0,Asphyxiation - includes death by gas,0
8387442,1,"Wausau, WI",6,12,12,1.0,"Handgun - pistol, revolver, etc",0
11153810,1,"Jacksonville, FL",8,12,12,1.0,"Narcotics or drugs, sleeping pills",0
13045786,1,"Michigan City-La Porte, IN",11,12,12,1.0,"Personal weapons, includes beating",0
19466313,2,"Lewiston, ID-WA",6,12,12,1.0,"Handgun - pistol, revolver, etc",0
21001941,1,"Salt Lake City, UT",9,12,12,1.0,Other gun,0
23627979,1,"Sioux Falls, SD",1,12,12,1.0,"Blunt object - hammer, club, etc",0
24136830,1,"Pascagoula, MS",14,12,12,1.0,Rifle,0
26918974,1,"Wichita Falls, TX",11,12,12,1.0,"Personal weapons, includes beating",0
26979963,2,"Poughkeepsie-Newburgh-Middletown, NY",16,12,12,1.0,Strangulation - hanging,0
27808149,2,Rural Vermont,15,12,12,1.0,Shotgun,0
28712962,2,"Lakeland, FL",14,12,12,1.0,Rifle,0
33422956,2,"Lafayette, IN",6,12,12,1.0,"Handgun - pistol, revolver, etc",0
33798201,1,"Pittsfield, MA",6,12,12,1.0,"Handgun - pistol, revolver, etc",0
34972799,2,"Charlottesville, VA",15,12,12,1.0,Shotgun,0
40138742,1,"Fort Collins-Loveland, CO",14,12,12,1.0,Rifle,0
41093220,1,"Seattle-Tacoma-Bellevue, WA",2,12,12,1.0,Drowning,0
45238510,1,"Johnson City, TN",1,12,12,1.0,"Blunt object - hammer, club, etc",0
46044720,1,"Burlington, NC",15,12,12,1.0,Shotgun,0
47446620,1,"Erie, PA",14,12,12,1.0,Rifle,0
47753670,1,"New Haven-Milford, CT",8,12,12,1.0,"Narcotics or drugs, sleeping pills",0
49669978,2,"Pocatello, ID",6,12,12,1.0,"Handgun - pistol, revolver, etc",0
51848333,2,"Virginia Beach-Norfolk-Newport News, VA-NC",8,12,12,1.0,"Narcotics or drugs, sleeping pills",0
53383971,2,"Bay City, MI",7,12,12,1.0,Knife or cutting instrument,0
55724077,2,"Jackson, MI",5,12,12,1.0,"Firearm, type not stated",0
58828436,1,"Medford, OR",11,12,12,1.0,"Personal weapons, includes beating",0
58954998,1,"Springfield, IL",11,12,12,1.0,"Personal weapons, includes beating",0
61104128,1,"Panama City-Lynn Haven, FL",14,12,12,1.0,Rifle,0
66487600,2,"Waco, TX",15,12,12,1.0,Shotgun,0
69441635,1,Rural Wisconsin,4,12,12,1.0,Fire,0
70603533,2,Rural Hawaii,14,12,12,1.0,Rifle,0
71236581,2,"Laredo, TX",11,12,12,1.0,"Personal weapons, includes beating",0
72154519,2,"Johnson City, TN",11,12,12,1.0,"Personal weapons, includes beating",0
76362817,1,"Toledo, OH",8,12,12,1.0,"Narcotics or drugs, sleeping pills",0
83114989,2,Rural Kansas,1,12,12,1.0,"Blunt object - hammer, club, etc",0
84851766,2,"Lynchburg, VA",14,12,12,1.0,Rifle,0
89965897,2,"Decatur, IL",7,12,12,1.0,Knife or cutting instrument,0
91667833,2,"Prescott, AZ",7,12,12,1.0,Knife or cutting instrument,0
95758428,1,"Blacksburg-Christiansburg, VA",14,12,12,1.0,Rifle,0
96500767,2,"Hagerstown-Martinsburg, MD-WV",15,12,12,1.0,Shotgun,0
96581558,2,Rural South Dakota,15,12,12,1.0,Shotgun,0
198492,2,"Winston-Salem, NC",5,11,11,1.0,"Firearm, type not stated",0
3326641,2,"Hagerstown-Martinsburg, MD-WV",14,11,11,1.0,Rifle,0
5354706,2,"Cape Coral-Fort Myers, FL",15,11,11,1.0,Shotgun,0
6033529,2,"Binghamton, NY",7,11,11,1.0,Knife or cutting instrument,0
8710403,2,"Merced, CA",14,11,11,1.0,Rifle,0
9934924,2,"Binghamton, NY",1,11,11,1.0,"Blunt object - hammer, club, etc",0
10477168,2,"Casper, WY",11,11,11,1.0,"Personal weapons, includes beating",0
13107971,2,"Duluth, MN-WI",6,11,11,1.0,"Handgun - pistol, revolver, etc",0
15656798,1,"Midland, TX",11,11,11,1.0,"Personal weapons, includes beating",0
16832234,2,"Lewiston-Auburn, ME",6,11,11,1.0,"Handgun - pistol, revolver, etc",0
17354125,2,"Kingston, NY",1,11,11,1.0,"Blunt object - hammer, club, etc",0
17611861,2,"Burlington-South Burlington, VT",6,11,11,1.0,"Handgun - pistol, revolver, etc",0
20993526,2,"Miami-Fort Lauderdale, FL",8,11,11,1.0,"Narcotics or drugs, sleeping pills",0
22815157,1,"Jonesboro, AR",14,11,11,1.0,Rifle,0
23806787,2,"York-Hanover, PA",15,11,11,1.0,Shotgun,0
26292083,1,"Grand Forks, ND-MN",7,11,11,1.0,Knife or cutting instrument,0
27723515,2,"Kingston, NY",7,11,11,1.0,Knife or cutting instrument,0
32887849,2,"Roanoke, VA",14,11,11,1.0,Rifle,0
39003437,1,"Owensboro, KY",11,11,11,1.0,"Personal weapons, includes beating",0
39893863,2,"Reading, PA",15,11,11,1.0,Shotgun,0
41330304,1,"Fort Collins-Loveland, CO",11,11,11,1.0,"Personal weapons, includes beating",0
45423077,2,"Danville, VA",14,11,11,1.0,Rifle,0
46467140,1,"Lincoln, NE",15,11,11,1.0,Shotgun,0
47108367,2,"Decatur, IL",11,11,11,1.0,"Personal weapons, includes beating",0
50700153,1,"Duluth, MN-WI",14,11,11,1.0,Rifle,0
52094471,2,"Johnson City, TN",7,11,11,1.0,Knife or cutting instrument,0
52612456,1,"Coeur d Alene, ID",7,11,11,1.0,Knife or cutting instrument,0
53088266,1,"Green Bay, WI",8,11,11,1.0,"Narcotics or drugs, sleeping pills",0
53865984,1,"Blacksburg-Christiansburg, VA",10,11,11,1.0,Other or type unknown,0
57411391,1,"Midland, TX",15,11,11,1.0,Shotgun,0
65414820,2,"Corpus Christi, TX",15,11,11,1.0,Shotgun,0
66124778,2,"Merced, CA",11,11,11,1.0,"Personal weapons, includes beating",0
68628345,2,"Cheyenne, WY",6,11,11,1.0,"Handgun - pistol, revolver, etc",0
69328581,1,"Joplin, MO",14,11,11,1.0,Rifle,0
70177491,1,"Brunswick, GA",1,11,11,1.0,"Blunt object - hammer, club, etc",0
70973907,2,"Longview, TX",11,11,11,1.0,"Personal weapons, includes beating",0
75080277,2,"Burlington, NC",11,11,11,1.0,"Personal weapons, includes beating",0
76807053,1,"Dalton, GA",14,11,11,1.0,Rifle,0
77371285,1,"Kokomo, IN",1,11,11,1.0,"Blunt object - hammer, club, etc",0
78226953,2,"Canton-Massillon, OH",15,11,11,1.0,Shotgun,0
80015695,1,"Cumberland, MD-WV",15,11,11,1.0,Shotgun,0
81541947,1,"Grand Junction, CO",14,11,11,1.0,Rifle,0
81601106,1,"Winchester, VA-WV",14,11,11,1.0,Rifle,0
84940356,2,Rural Illinois,14,11,11,1.0,Rifle,0
85962083,2,"El Paso, TX",0,11,11,1.0,Asphyxiation - includes death by gas,0
86966730,2,"Sioux City, IA-NE-SD",11,11,11,1.0,"Personal weapons, includes beating",0
89860227,1,Rural Georgia,9,11,11,1.0,Other gun,0
89922859,2,"Green Bay, WI",11,11,11,1.0,"Personal weapons, includes beating",0
90180081,1,"Dover, DE",11,11,11,1.0,"Personal weapons, includes beating",0
90984289,1,"Sandusky, OH",7,11,11,1.0,Knife or cutting instrument,0
92692039,2,"Cedar Rapids, IA",11,11,11,1.0,"Personal weapons, includes beating",0
93986047,1,Rural Virginia,0,11,11,1.0,Asphyxiation - includes death by gas,0
96225138,1,"Atlanta-Sandy Springs-Marietta, GA",2,11,11,1.0,Drowning,0
98442223,2,Rural Arkansas,0,11,11,1.0,Asphyxiation - includes death by gas,0
850633,1,"Great Falls, MT",11,10,10,1.0,"Personal weapons, includes beating",0
941106,2,"Evansville, IN-KY",15,10,10,1.0,Shotgun,0
960373,1,"Decatur, IL",11,10,10,1.0,"Personal weapons, includes beating",0
2816664,2,Rural South Dakota,5,10,10,1.0,"Firearm, type not stated",0
3720290,1,"Missoula, MT",11,10,10,1.0,"Personal weapons, includes beating",0
3777840,1,"Colorado Springs, CO",0,10,10,1.0,Asphyxiation - includes death by gas,0
4225977,1,"Waterloo-Cedar Falls, IA",11,10,10,1.0,"Personal weapons, includes beating",0
4512862,1,"Yuma, AZ",14,10,10,1.0,Rifle,0
4613169,2,"Bangor, ME",11,10,10,1.0,"Personal weapons, includes beating",0
6245472,1,"Lancaster, PA",14,10,10,1.0,Rifle,0
7965011,1,"Bellingham, WA",11,10,10,1.0,"Personal weapons, includes beating",0
9298700,1,"Ocean City, NJ",11,10,10,1.0,"Personal weapons, includes beating",0
10810635,2,"Bloomington-Normal, IL",6,10,10,1.0,"Handgun - pistol, revolver, etc",0
11257613,2,"Salem, OR",11,10,10,1.0,"Personal weapons, includes beating",0
12940434,2,"Dover, DE",11,10,10,1.0,"Personal weapons, includes beating",0
13461761,2,Rural Delaware,7,10,10,1.0,Knife or cutting instrument,0
17512133,1,Rural California,8,10,10,1.0,"Narcotics or drugs, sleeping pills",0
20592447,2,"Orlando-Kissimmee, FL",8,10,10,1.0,"Narcotics or drugs, sleeping pills",0
20947369,1,Rural Louisiana,8,10,10,1.0,"Narcotics or drugs, sleeping pills",0
21409103,1,"College Station-Bryan, TX",1,10,10,1.0,"Blunt object - hammer, club, etc",0
22051747,2,"Johnstown, PA",11,10,10,1.0,"Personal weapons, includes beating",0
25277328,2,"Monroe, LA",14,10,10,1.0,Rifle,0
25467933,2,"Ogden-Clearfield, UT",5,10,10,1.0,"Firearm, type not stated",0
26995266,2,"Rome, GA",7,10,10,1.0,Knife or cutting instrument,0
27870846,1,"Casper, WY",11,10,10,1.0,"Personal weapons, includes beating",0
29306492,1,"Kingston, NY",11,10,10,1.0,"Personal weapons, includes beating",0
29639040,2,"Tampa-St. Petersburg-Clearwater, FL",9,10,10,1.0,Other gun,0
30403744,1,"Cedar Rapids, IA",15,10,10,1.0,Shotgun,0
33561946,2,"Madison, WI",0,10,10,1.0,Asphyxiation - includes death by gas,0
33621045,1,"Johnson City, TN",11,10,10,1.0,"Personal weapons, includes beating",0
38048918,2,"Salinas, CA",0,10,10,1.0,Asphyxiation - includes death by gas,0
41550524,2,"Savannah, GA",15,10,10,1.0,Shotgun,0
43278781,2,"Santa Cruz-Watsonville, CA",15,10,10,1.0,Shotgun,0
46209321,1,"Madison, WI",8,10,10,1.0,"Narcotics or drugs, sleeping pills",0
46987544,2,"Gulfport-Biloxi, MS",15,10,10,1.0,Shotgun,0
52430093,2,"Las Cruces, NM",11,10,10,1.0,"Personal weapons, includes beating",0
53695703,2,"Elmira, NY",11,10,10,1.0,"Personal weapons, includes beating",0
55673778,1,"Pocatello, ID",7,10,10,1.0,Knife or cutting instrument,0
56478417,1,"Panama City-Lynn Haven, FL",15,10,10,1.0,Shotgun,0
62379268,1,"Napa, CA",11,10,10,1.0,"Personal weapons, includes beating",0
62476992,1,"Bangor, ME",14,10,10,1.0,Rifle,0
63024866,1,"Monroe, MI",11,10,10,1.0,"Personal weapons, includes beating",0
63856348,1,"Pine Bluff, AR",11,10,10,1.0,"Personal weapons, includes beating",0
68833843,1,"Provo-Orem, UT",14,10,10,1.0,Rifle,0
69760760,1,"Oshkosh-Neenah, WI",7,10,10,1.0,Knife or cutting instrument,0
71714324,1,"Oshkosh-Neenah, WI",10,10,10,1.0,Other or type unknown,0
72223669,2,"Allentown-Bethlehem-Easton, PA-NJ",14,10,10,1.0,Rifle,0
72836976,2,"Flagstaff, AZ",1,10,10,1.0,"Blunt object - hammer, club, etc",0
78881114,1,Rural Missouri,16,10,10,1.0,Strangulation - hanging,0
79845848,2,"Monroe, MI",15,10,10,1.0,Shotgun,0
79996158,2,"Tallahassee, FL",14,10,10,1.0,Rifle,0
82832781,2,"Florence, SC",15,10,10,1.0,Shotgun,0
86085849,1,"Huntington-Ashland, WV-KY-OH",14,10,10,1.0,Rifle,0
86338780,1,"Pocatello, ID",11,10,10,1.0,"Personal weapons, includes beating",0
86507427,2,"Bangor, ME",6,10,10,1.0,"Handgun - pistol, revolver, etc",0
87773971,1,"Champaign-Urbana, IL",11,10,10,1.0,"Personal weapons, includes beating",0
90513858,1,"St. Joseph, MO-KS",11,10,10,1.0,"Personal weapons, includes beating",0
93712226,2,"Lawton, OK",1,10,10,1.0,"Blunt object - hammer, club, etc",0
93931896,2,Rural Montana,15,10,10,1.0,Shotgun,0
94004469,1,"Bangor, ME",7,10,10,1.0,Knife or cutting instrument,0
94466427,1,Rural Pennsylvania,2,10,10,1.0,Drowning,0
97184070,1,"Bellingham, WA",1,10,10,1.0,"Blunt object - hammer, club, etc",0
97331804,1,"Bay City, MI",7,10,10,1.0,Knife or cutting instrument,0
98578144,1,"Warner Robins, GA",14,10,10,1.0,Rifle,0
98630977,1,"Davenport-Moline-Rock Island, IA-IL",15,10,10,1.0,Shotgun,0
99375051,2,Rural North Dakota,5,10,10,1.0,"Firearm, type not stated",0
158476,2,"Burlington-South Burlington, VT",5,9,9,1.0,"Firearm, type not stated",0
2993710,2,"Mansfield, OH",15,9,9,1.0,Shotgun,0
6096959,2,"Worcester, MA",15,9,9,1.0,Shotgun,0
6200581,2,"Texarkana, TX-Texarkana, AR",15,9,9,1.0,Shotgun,0
7705734,2,"Saginaw, MI",15,9,9,1.0,Shotgun,0
8035874,1,"Warner Robins, GA",11,9,9,1.0,"Personal weapons, includes beating",0
10855166,2,"Provo-Orem, UT",7,9,9,1.0,Knife or cutting instrument,0
12485504,1,"Hartford, CT",8,9,9,1.0,"Narcotics or drugs, sleeping pills",0
14019124,1,"Lynchburg, VA",1,9,9,1.0,"Blunt object - hammer, club, etc",0
14897809,2,"Burlington, NC",10,9,9,1.0,Other or type unknown,0
19595325,2,"Modesto, CA",14,9,9,1.0,Rifle,0
21394164,2,"Beaumont-Port Arthur, TX",14,9,9,1.0,Rifle,0
22168389,1,"Rapid City, SD",14,9,9,1.0,Rifle,0
22449820,1,"Duluth, MN-WI",15,9,9,1.0,Shotgun,0
24413309,1,Rural Georgia,0,9,9,1.0,Asphyxiation - includes death by gas,0
25122993,2,"Eugene-Springfield, OR",14,9,9,1.0,Rifle,0
27459375,1,"San Luis Obispo-Paso Robles, CA",11,9,9,1.0,"Personal weapons, includes beating",0
27877777,2,Rural Utah,15,9,9,1.0,Shotgun,0
28425947,1,"Rome, GA",11,9,9,1.0,"Personal weapons, includes beating",0
28441398,1,"New Orleans-Metairie-Kenner, LA",8,9,9,1.0,"Narcotics or drugs, sleeping pills",0
28600519,2,"Redding, CA",14,9,9,1.0,Rifle,0
28813045,1,"Salisbury, MD",11,9,9,1.0,"Personal weapons, includes beating",0
29398314,1,"Columbia, MO",11,9,9,1.0,"Personal weapons, includes beating",0
29938471,2,"Texarkana, TX-Texarkana, AR",11,9,9,1.0,"Personal weapons, includes beating",0
33327884,2,"Lancaster, PA",11,9,9,1.0,"Personal weapons, includes beating",0
33821505,1,"Sherman-Denison, TX",14,9,9,1.0,Rifle,0
34082800,2,"Florence, SC",14,9,9,1.0,Rifle,0
34463506,1,"Rochester, MN",11,9,9,1.0,"Personal weapons, includes beating",0
34823473,1,"Worcester, MA",4,9,9,1.0,Fire,0
35160777,1,"Altoona, PA",15,9,9,1.0,Shotgun,0
36620817,2,"Lexington-Fayette, KY",15,9,9,1.0,Shotgun,0
39185811,2,"Lancaster, PA",0,9,9,1.0,Asphyxiation - includes death by gas,0
40557221,1,"Visalia-Porterville, CA",16,9,9,1.0,Strangulation - hanging,0
40804992,2,"Erie, PA",15,9,9,1.0,Shotgun,0
42248441,2,"Eau Claire, WI",6,9,9,1.0,"Handgun - pistol, revolver, etc",0
43336766,2,"El Paso, TX",15,9,9,1.0,Shotgun,0
46464997,2,"Huntsville, AL",14,9,9,1.0,Rifle,0
47327046,1,"Harrisonburg, VA",15,9,9,1.0,Shotgun,0
47600910,2,"Spartanburg, SC",14,9,9,1.0,Rifle,0
48036336,2,"Columbia, MO",15,9,9,1.0,Shotgun,0
51386208,2,Rural New York,0,9,9,1.0,Asphyxiation - includes death by gas,0
52939634,1,"Denver-Aurora, CO",2,9,9,1.0,Drowning,0
54592275,2,"Bridgeport-Stamford-Norwalk, CT",15,9,9,1.0,Shotgun,0
54731647,2,"Elkhart-Goshen, IN",11,9,9,1.0,"Personal weapons, includes beating",0
54962500,2,"Sumter, SC",15,9,9,1.0,Shotgun,0
56254900,1,"Rome, GA",14,9,9,1.0,Rifle,0
56437567,1,Rural Tennessee,0,9,9,1.0,Asphyxiation - includes death by gas,0
58714058,1,"Elkhart-Goshen, IN",11,9,9,1.0,"Personal weapons, includes beating",0
60448308,2,"San Jose-Sunnyvale-Santa Clara, CA",2,9,9,1.0,Drowning,0
62778054,1,"Dover, DE",14,9,9,1.0,Rifle,0
65218465,2,Rural Connecticut,6,9,9,1.0,"Handgun - pistol, revolver, etc",0
65366424,2,"Dayton, OH",14,9,9,1.0,Rifle,0
67551919,2,"Springfield, IL",11,9,9,1.0,"Personal weapons, includes beating",0
67748384,2,"Fargo, ND-MN",11,9,9,1.0,"Personal weapons, includes beating",0
68171870,2,"Bend, OR",10,9,9,1.0,Other or type unknown,0
68215174,2,"Appleton, WI",6,9,9,1.0,"Handgun - pistol, revolver, etc",0
72090702,1,"St. Joseph, MO-KS",15,9,9,1.0,Shotgun,0
73771055,1,"Brunswick, GA",11,9,9,1.0,"Personal weapons, includes beating",0
74601713,2,"Utica-Rome, NY",14,9,9,1.0,Rifle,0
74679862,1,"Fort Collins-Loveland, CO",10,9,9,1.0,Other or type unknown,0
76206221,2,"Ithaca, NY",7,9,9,1.0,Knife or cutting instrument,0
76264451,1,"Fairbanks, AK",11,9,9,1.0,"Personal weapons, includes beating",0
77064240,2,"Davenport-Moline-Rock Island, IA-IL",15,9,9,1.0,Shotgun,0
77737556,2,Rural Delaware,14,9,9,1.0,Rifle,0
80082375,2,"Tallahassee, FL",15,9,9,1.0,Shotgun,0
82742113,1,"Corvallis, OR",6,9,9,1.0,"Handgun - pistol, revolver, etc",0
83429174,1,"Springfield, IL",15,9,9,1.0,Shotgun,0
84336199,1,"Winchester, VA-WV",7,9,9,1.0,Knife or cutting instrument,0
84531392,2,"Texarkana, TX-Texarkana, AR",14,9,9,1.0,Rifle,0
85729060,1,"Olympia, WA",11,9,9,1.0,"Personal weapons, includes beating",0
86592357,2,"Davenport-Moline-Rock Island, IA-IL",5,9,9,1.0,"Firearm, type not stated",0
88407708,2,"Redding, CA",15,9,9,1.0,Shotgun,0
89575504,1,"Fort Walton Beach-Destin, FL",11,9,9,1.0,"Personal weapons, includes beating",0
89664218,2,"Joplin, MO",14,9,9,1.0,Rifle,0
90612771,2,"Cumberland, MD-WV",11,9,9,1.0,"Personal weapons, includes beating",0
90974297,1,"Columbia, SC",9,9,9,1.0,Other gun,0
92937992,2,"Glens Falls, NY",7,9,9,1.0,Knife or cutting instrument,0
93174153,2,"Brunswick, GA",15,9,9,1.0,Shotgun,0
94022443,2,"Madison, WI",14,9,9,1.0,Rifle,0
94444113,2,"Vallejo-Fairfield, CA",4,9,9,1.0,Fire,0
95280715,2,"Coeur d Alene, ID",11,9,9,1.0,"Personal weapons, includes beating",0
97038292,2,"Johnson City, TN",15,9,9,1.0,Shotgun,0
351225,2,"Charlottesville, VA",14,8,8,1.0,Rifle,0
1964979,1,"Corvallis, OR",14,8,8,1.0,Rifle,0
2323935,1,"Johnstown, PA",15,8,8,1.0,Shotgun,0
2596704,2,"Blacksburg-Christiansburg, VA",14,8,8,1.0,Rifle,0
3745306,1,"Bend, OR",1,8,8,1.0,"Blunt object - hammer, club, etc",0
4809132,2,"Jacksonville, NC",15,8,8,1.0,Shotgun,0
6038530,2,"Dalton, GA",11,8,8,1.0,"Personal weapons, includes beating",0
8401941,2,"Punta Gorda, FL",6,8,8,1.0,"Handgun - pistol, revolver, etc",0
10255886,2,"Lafayette, LA",11,8,8,1.0,"Personal weapons, includes beating",0
14825736,2,"Jonesboro, AR",15,8,8,1.0,Shotgun,0
15815646,1,"Lewiston, ID-WA",11,8,8,1.0,"Personal weapons, includes beating",0
17428300,2,"Monroe, MI",11,8,8,1.0,"Personal weapons, includes beating",0
19242062,2,"Salisbury, MD",14,8,8,1.0,Rifle,0
19433639,2,"Lafayette, LA",14,8,8,1.0,Rifle,0
22192500,2,"Great Falls, MT",6,8,8,1.0,"Handgun - pistol, revolver, etc",0
22968690,2,"Bend, OR",14,8,8,1.0,Rifle,0
23148776,1,"Auburn-Opelika, AL",11,8,8,1.0,"Personal weapons, includes beating",0
23837623,2,"Salem, OR",0,8,8,1.0,Asphyxiation - includes death by gas,0
23915301,1,"Gadsden, AL",14,8,8,1.0,Rifle,0
28611750,1,"Dayton, OH",8,8,8,1.0,"Narcotics or drugs, sleeping pills",0
31075203,1,"York-Hanover, PA",8,8,8,1.0,"Narcotics or drugs, sleeping pills",0
32841839,2,"Vero Beach, FL",11,8,8,1.0,"Personal weapons, includes beating",0
33161203,1,"Virginia Beach-Norfolk-Newport News, VA-NC",8,8,8,1.0,"Narcotics or drugs, sleeping pills",0
33667815,1,"Greensboro-High Point, NC",4,8,8,1.0,Fire,0
34706225,2,Rural Wisconsin,4,8,8,1.0,Fire,0
34941013,1,"Lewiston-Auburn, ME",11,8,8,1.0,"Personal weapons, includes beating",0
35026516,2,"Toledo, OH",8,8,8,1.0,"Narcotics or drugs, sleeping pills",0
35553320,2,"Janesville, WI",11,8,8,1.0,"Personal weapons, includes beating",0
36494233,2,Rural Connecticut,11,8,8,1.0,"Personal weapons, includes beating",0
36530376,2,"Wenatchee, WA",7,8,8,1.0,Knife or cutting instrument,0
37681664,2,"Parkersburg-Marietta-Vienna, WV-OH",15,8,8,1.0,Shotgun,0
37914184,2,Rural Oregon,4,8,8,1.0,Fire,0
38448769,2,"Brownsville-Harlingen, TX",1,8,8,1.0,"Blunt object - hammer, club, etc",0
39651089,2,"Colorado Springs, CO",0,8,8,1.0,Asphyxiation - includes death by gas,0
40301701,2,"Blacksburg-Christiansburg, VA",11,8,8,1.0,"Personal weapons, includes beating",0
40722443,2,"San Luis Obispo-Paso Robles, CA",11,8,8,1.0,"Personal weapons, includes beating",0
41396622,2,"Olympia, WA",10,8,8,1.0,Other or type unknown,0
42932483,2,"San Antonio, TX",2,8,8,1.0,Drowning,0
45697809,1,Rural California,0,8,8,1.0,Asphyxiation - includes death by gas,0
47104678,1,"Austin-Round Rock, TX",16,8,8,1.0,Strangulation - hanging,0
52154712,1,"Binghamton, NY",14,8,8,1.0,Rifle,0
52640548,1,"Gadsden, AL",1,8,8,1.0,"Blunt object - hammer, club, etc",0
53513008,2,"Muskegon-Norton Shores, MI",11,8,8,1.0,"Personal weapons, includes beating",0
54879411,1,"Lawrence, KS",11,8,8,1.0,"Personal weapons, includes beating",0
55092530,2,Rural Hawaii,15,8,8,1.0,Shotgun,0
58580683,2,"Providence-New Bedford-Fall River, RI-MA",8,8,8,1.0,"Narcotics or drugs, sleeping pills",0
58752745,2,"Midland, TX",11,8,8,1.0,"Personal weapons, includes beating",0
58848213,2,"Provo-Orem, UT",15,8,8,1.0,Shotgun,0
59389452,1,"Kankakee-Bradley, IL",11,8,8,1.0,"Personal weapons, includes beating",0
61788724,2,Rural Nevada,5,8,8,1.0,"Firearm, type not stated",0
61798472,2,"Fargo, ND-MN",7,8,8,1.0,Knife or cutting instrument,0
62664409,2,"Santa Rosa-Petaluma, CA",4,8,8,1.0,Fire,0
63312948,1,"Morgantown, WV",14,8,8,1.0,Rifle,0
64397317,2,"Springfield, IL",15,8,8,1.0,Shotgun,0
64850701,1,"Terre Haute, IN",11,8,8,1.0,"Personal weapons, includes beating",0
66166203,2,"Madison, WI",15,8,8,1.0,Shotgun,0
66837815,2,"Olympia, WA",5,8,8,1.0,"Firearm, type not stated",0
68029526,1,"Michigan City-La Porte, IN",14,8,8,1.0,Rifle,0
70130126,1,"Lawrence, KS",10,8,8,1.0,Other or type unknown,0
70371190,2,"Springfield, MO",16,8,8,1.0,Strangulation - hanging,0
70491688,1,"Racine, WI",1,8,8,1.0,"Blunt object - hammer, club, etc",0
70980402,1,"Des Moines, IA",4,8,8,1.0,Fire,0
71866441,1,"Manchester-Nashua, NH",15,8,8,1.0,Shotgun,0
75933305,2,"St. Cloud, MN",6,8,8,1.0,"Handgun - pistol, revolver, etc",0
76700254,2,"Lafayette, IN",11,8,8,1.0,"Personal weapons, includes beating",0
81895778,1,Rural Kansas,8,8,8,1.0,"Narcotics or drugs, sleeping pills",0
82140099,2,"Medford, OR",11,8,8,1.0,"Personal weapons, includes beating",0
82528052,1,"Pocatello, ID",14,8,8,1.0,Rifle,0
83184118,2,"Springfield, MA",14,8,8,1.0,Rifle,0
83293466,2,Rural South Dakota,14,8,8,1.0,Rifle,0
87167860,2,Rural Kentucky,0,8,8,1.0,Asphyxiation - includes death by gas,0
87412476,1,Rural Colorado,0,8,8,1.0,Asphyxiation - includes death by gas,0
87976988,1,"Riverside-San Bernardino, CA",3,8,8,1.0,Explosives,0
88135250,2,"Springfield, MO",14,8,8,1.0,Rifle,0
88962497,2,"Baton Rouge, LA",8,8,8,1.0,"Narcotics or drugs, sleeping pills",0
91506659,2,"Kennewick-Richland-Pasco, WA",5,8,8,1.0,"Firearm, type not stated",0
91592695,1,"Longview, WA",15,8,8,1.0,Shotgun,0
92206801,1,"Vero Beach, FL",14,8,8,1.0,Rifle,0
93006471,2,"Santa Barbara-Santa Maria, CA",15,8,8,1.0,Shotgun,0
93386685,2,"Fargo, ND-MN",6,8,8,1.0,"Handgun - pistol, revolver, etc",0
93483788,1,"Missoula, MT",14,8,8,1.0,Rifle,0
94153139,2,"San Luis Obispo-Paso Robles, CA",15,8,8,1.0,Shotgun,0
94501575,2,"Fort Collins-Loveland, CO",10,8,8,1.0,Other or type unknown,0
95673464,2,Rural Nebraska,0,8,8,1.0,Asphyxiation - includes death by gas,0
95915269,2,"Glens Falls, NY",11,8,8,1.0,"Personal weapons, includes beating",0
97020891,2,Rural Oregon,8,8,8,1.0,"Narcotics or drugs, sleeping pills",0
97330983,2,"Ocean City, NJ",11,8,8,1.0,"Personal weapons, includes beating",0
98774537,1,"Blacksburg-Christiansburg, VA",11,8,8,1.0,"Personal weapons, includes beating",0
99353651,2,"San Jose-Sunnyvale-Santa Clara, CA",8,8,8,1.0,"Narcotics or drugs, sleeping pills",0
99385843,2,"New Orleans-Metairie-Kenner, LA",8,8,8,1.0,"Narcotics or drugs, sleeping pills",0
99699823,2,"Pascagoula, MS",5,8,8,1.0,"Firearm, type not stated",0
365960,2,"Ogden-Clearfield, UT",0,7,7,1.0,Asphyxiation - includes death by gas,0
811237,2,"Glens Falls, NY",4,7,7,1.0,Fire,0
3658593,1,"Ames, IA",7,7,7,1.0,Knife or cutting instrument,0
5816560,2,"Albany, GA",15,7,7,1.0,Shotgun,0
6790212,9,Rural Oklahoma,6,7,7,1.0,"Handgun - pistol, revolver, etc",0
6819454,2,Rural Michigan,12,7,7,1.0,Poison - does not include gas,0
7245716,2,"Idaho Falls, ID",7,7,7,1.0,Knife or cutting instrument,0
9290097,2,"Salem, OR",15,7,7,1.0,Shotgun,0
10156940,2,"Honolulu, HI",15,7,7,1.0,Shotgun,0
11050883,1,"Bismarck, ND",14,7,7,1.0,Rifle,0
11969262,2,"Fort Collins-Loveland, CO",14,7,7,1.0,Rifle,0
16286014,2,"Logan, UT-ID",6,7,7,1.0,"Handgun - pistol, revolver, etc",0
16731864,2,"Fort Walton Beach-Destin, FL",15,7,7,1.0,Shotgun,0
18179325,1,"Iowa City, IA",11,7,7,1.0,"Personal weapons, includes beating",0
18678780,2,"Cumberland, MD-WV",15,7,7,1.0,Shotgun,0
18720960,1,"Lafayette, IN",11,7,7,1.0,"Personal weapons, includes beating",0
18952478,1,"Longview, WA",11,7,7,1.0,"Personal weapons, includes beating",0
18970724,1,"Parkersburg-Marietta-Vienna, WV-OH",14,7,7,1.0,Rifle,0
19048104,2,"Hickory-Lenoir-Morganton, NC",1,7,7,1.0,"Blunt object - hammer, club, etc",0
19487564,2,"Lubbock, TX",14,7,7,1.0,Rifle,0
20005280,2,"Naples-Marco Island, FL",14,7,7,1.0,Rifle,0
20174853,2,"Kennewick-Richland-Pasco, WA",14,7,7,1.0,Rifle,0
21651598,1,"Dalton, GA",11,7,7,1.0,"Personal weapons, includes beating",0
21919928,1,"Oshkosh-Neenah, WI",15,7,7,1.0,Shotgun,0
22053825,2,"Jackson, TN",15,7,7,1.0,Shotgun,0
22893547,1,Rural Idaho,4,7,7,1.0,Fire,0
23093875,2,"Greeley, CO",15,7,7,1.0,Shotgun,0
23134598,1,"Manchester-Nashua, NH",14,7,7,1.0,Rifle,0
23284157,2,"Lake Charles, LA",5,7,7,1.0,"Firearm, type not stated",0
23735397,2,Rural New York,8,7,7,1.0,"Narcotics or drugs, sleeping pills",0
24195393,1,"Bremerton-Silverdale, WA",14,7,7,1.0,Rifle,0
25220452,2,"Jonesboro, AR",11,7,7,1.0,"Personal weapons, includes beating",0
25484389,2,"Santa Fe, NM",15,7,7,1.0,Shotgun,0
25505014,2,"Michigan City-La Porte, IN",15,7,7,1.0,Shotgun,0
26545979,2,"Anderson, IN",11,7,7,1.0,"Personal weapons, includes beating",0
26691586,1,"Wenatchee, WA",14,7,7,1.0,Rifle,0
30195411,2,"Appleton, WI",14,7,7,1.0,Rifle,0
31446975,2,"Clarksville, TN-KY",14,7,7,1.0,Rifle,0
32555821,2,"Wausau, WI",7,7,7,1.0,Knife or cutting instrument,0
33350265,2,"Cincinnati-Middletown, OH-KY-IN",12,7,7,1.0,Poison - does not include gas,0
33600796,1,"Lima, OH",1,7,7,1.0,"Blunt object - hammer, club, etc",0
35113087,2,"Peoria, IL",10,7,7,1.0,Other or type unknown,0
35358412,1,Rural Vermont,8,7,7,1.0,"Narcotics or drugs, sleeping pills",0
36062374,2,"Appleton, WI",10,7,7,1.0,Other or type unknown,0
36683888,2,"Manchester-Nashua, NH",14,7,7,1.0,Rifle,0
36797233,2,"Las Vegas-Paradise, NV",2,7,7,1.0,Drowning,0
37877752,2,"Elizabethtown, KY",10,7,7,1.0,Other or type unknown,0
39376589,2,"Burlington, NC",15,7,7,1.0,Shotgun,0
39651736,1,"Burlington-South Burlington, VT",10,7,7,1.0,Other or type unknown,0
42011937,1,"Harrisonburg, VA",14,7,7,1.0,Rifle,0
42722279,2,"Jonesboro, AR",10,7,7,1.0,Other or type unknown,0
42848959,2,"Fort Smith, AR-OK",11,7,7,1.0,"Personal weapons, includes beating",0
43161480,2,"Jonesboro, AR",5,7,7,1.0,"Firearm, type not stated",0
43415190,2,"Texarkana, TX-Texarkana, AR",10,7,7,1.0,Other or type unknown,0
44634371,2,"Iowa City, IA",11,7,7,1.0,"Personal weapons, includes beating",0
44762102,2,Rural North Dakota,14,7,7,1.0,Rifle,0
44770650,2,"Morristown, TN",15,7,7,1.0,Shotgun,0
46615074,2,"Anchorage, AK",14,7,7,1.0,Rifle,0
47389598,1,"Sumter, SC",11,7,7,1.0,"Personal weapons, includes beating",0
47611380,1,"Sioux City, IA-NE-SD",11,7,7,1.0,"Personal weapons, includes beating",0
47786088,1,"Vineland-Millville-Bridgeton, NJ",15,7,7,1.0,Shotgun,0
48121235,2,"Yuba City, CA",14,7,7,1.0,Rifle,0
49160612,2,"Monroe, LA",15,7,7,1.0,Shotgun,0
49207425,2,"Warner Robins, GA",5,7,7,1.0,"Firearm, type not stated",0
50664521,1,"Barnstable Town, MA",11,7,7,1.0,"Personal weapons, includes beating",0
51195060,1,"Sioux City, IA-NE-SD",15,7,7,1.0,Shotgun,0
51250022,2,"Lincoln, NE",1,7,7,1.0,"Blunt object - hammer, club, etc",0
52810043,2,Rural South Dakota,0,7,7,1.0,Asphyxiation - includes death by gas,0
53394052,2,"Vallejo-Fairfield, CA",15,7,7,1.0,Shotgun,0
53415935,1,"Owensboro, KY",1,7,7,1.0,"Blunt object - hammer, club, etc",0
53761356,1,"Lawrence, KS",14,7,7,1.0,Rifle,0
53810811,2,"Salem, OR",1,7,7,1.0,"Blunt object - hammer, club, etc",0
54884691,1,"Owensboro, KY",7,7,7,1.0,Knife or cutting instrument,0
55413776,2,"Canton-Massillon, OH",4,7,7,1.0,Fire,0
55895241,1,"Johnstown, PA",11,7,7,1.0,"Personal weapons, includes beating",0
55989036,2,"Ann Arbor, MI",15,7,7,1.0,Shotgun,0
56162404,2,"Bloomington, IN",15,7,7,1.0,Shotgun,0
56404015,2,"Lancaster, PA",14,7,7,1.0,Rifle,0
56643345,2,"Bismarck, ND",6,7,7,1.0,"Handgun - pistol, revolver, etc",0
57841077,1,"Elizabethtown, KY",1,7,7,1.0,"Blunt object - hammer, club, etc",0
59251517,2,"Rome, GA",5,7,7,1.0,"Firearm, type not stated",0
60762188,2,"Bay City, MI",11,7,7,1.0,"Personal weapons, includes beating",0
61187736,2,Rural Minnesota,0,7,7,1.0,Asphyxiation - includes death by gas,0
62505642,2,"Lakeland, FL",15,7,7,1.0,Shotgun,0
62818908,2,"Wenatchee, WA",1,7,7,1.0,"Blunt object - hammer, club, etc",0
63125060,1,"Bloomington, IN",14,7,7,1.0,Rifle,0
64359703,2,"Deltona-Daytona Beach-Ormond Beach, FL",15,7,7,1.0,Shotgun,0
65783623,1,"Hot Springs, AR",11,7,7,1.0,"Personal weapons, includes beating",0
65912333,1,Rural North Dakota,1,7,7,1.0,"Blunt object - hammer, club, etc",0
66620830,2,"Ocala, FL",14,7,7,1.0,Rifle,0
67883331,2,"Provo-Orem, UT",0,7,7,1.0,Asphyxiation - includes death by gas,0
68373291,2,"Syracuse, NY",17,7,7,1.0,Weapon Not Reported,0
68735928,2,"Erie, PA",11,7,7,1.0,"Personal weapons, includes beating",0
70352051,1,"Columbia, MO",15,7,7,1.0,Shotgun,0
70810709,1,Rural Maryland,8,7,7,1.0,"Narcotics or drugs, sleeping pills",0
71470365,2,"Portland-South Portland-Biddeford, ME",15,7,7,1.0,Shotgun,0
72004299,2,"Bismarck, ND",11,7,7,1.0,"Personal weapons, includes beating",0
72007823,2,"Fond du Lac, WI",6,7,7,1.0,"Handgun - pistol, revolver, etc",0
73004623,1,"Springfield, MO",8,7,7,1.0,"Narcotics or drugs, sleeping pills",0
73214094,2,"Johnson City, TN",14,7,7,1.0,Rifle,0
76757875,1,"Springfield, MA",8,7,7,1.0,"Narcotics or drugs, sleeping pills",0
77126598,1,Rural West Virginia,16,7,7,1.0,Strangulation - hanging,0
78043519,2,"Holland-Grand Haven, MI",10,7,7,1.0,Other or type unknown,0
78244614,1,"Idaho Falls, ID",10,7,7,1.0,Other or type unknown,0
78666891,2,Rural Minnesota,8,7,7,1.0,"Narcotics or drugs, sleeping pills",0
78725045,2,"Canton-Massillon, OH",1,7,7,1.0,"Blunt object - hammer, club, etc",0
81982533,2,"Ocean City, NJ",6,7,7,1.0,"Handgun - pistol, revolver, etc",0
82081390,2,"Jackson, MI",15,7,7,1.0,Shotgun,0
82363024,1,"Bend, OR",7,7,7,1.0,Knife or cutting instrument,0
82541172,1,"Lewiston, ID-WA",7,7,7,1.0,Knife or cutting instrument,0
82568789,2,"Danville, VA",15,7,7,1.0,Shotgun,0
83325246,2,"Flagstaff, AZ",11,7,7,1.0,"Personal weapons, includes beating",0
83849412,1,"Weirton-Steubenville, WV-OH",1,7,7,1.0,"Blunt object - hammer, club, etc",0
84427027,1,"Bloomington, IN",11,7,7,1.0,"Personal weapons, includes beating",0
85283189,1,"Glens Falls, NY",11,7,7,1.0,"Personal weapons, includes beating",0
85472333,1,"Cape Coral-Fort Myers, FL",4,7,7,1.0,Fire,0
86549031,2,"Odessa, TX",15,7,7,1.0,Shotgun,0
87433261,1,"La Crosse, WI-MN",15,7,7,1.0,Shotgun,0
87444740,1,"St. Cloud, MN",11,7,7,1.0,"Personal weapons, includes beating",0
89359964,1,"Spokane, WA",8,7,7,1.0,"Narcotics or drugs, sleeping pills",0
90512921,2,"Elkhart-Goshen, IN",1,7,7,1.0,"Blunt object - hammer, club, etc",0
90853805,2,"Springfield, MO",15,7,7,1.0,Shotgun,0
91389300,1,"Coeur d Alene, ID",14,7,7,1.0,Rifle,0
91409143,1,"Grand Junction, CO",1,7,7,1.0,"Blunt object - hammer, club, etc",0
91811369,2,"Sheboygan, WI",6,7,7,1.0,"Handgun - pistol, revolver, etc",0
92309721,1,"Logan, UT-ID",11,7,7,1.0,"Personal weapons, includes beating",0
94949395,1,"Cheyenne, WY",14,7,7,1.0,Rifle,0
95409041,1,"Grand Forks, ND-MN",11,7,7,1.0,"Personal weapons, includes beating",0
95701085,2,"Tucson, AZ",2,7,7,1.0,Drowning,0
95776656,2,Rural Wyoming,15,7,7,1.0,Shotgun,0
96214221,2,"Florence-Muscle Shoals, AL",15,7,7,1.0,Shotgun,0
96485951,2,"Merced, CA",16,7,7,1.0,Strangulation - hanging,0
96553012,2,"Peoria, IL",1,7,7,1.0,"Blunt object - hammer, club, etc",0
96729328,2,"Poughkeepsie-Newburgh-Middletown, NY",14,7,7,1.0,Rifle,0
97485878,2,"Charleston-North Charleston, SC",4,7,7,1.0,Fire,0
97786504,1,"Muncie, IN",1,7,7,1.0,"Blunt object - hammer, club, etc",0
98388413,2,"Grand Forks, ND-MN",6,7,7,1.0,"Handgun - pistol, revolver, etc",0
99569299,2,"State College, PA",6,7,7,1.0,"Handgun - pistol, revolver, etc",0
99660326,1,"Austin-Round Rock, TX",8,7,7,1.0,"Narcotics or drugs, sleeping pills",0
99825592,1,Rural Minnesota,16,7,7,1.0,Strangulation - hanging,0
1965692,2,"Fond du Lac, WI",11,6,6,1.0,"Personal weapons, includes beating",0
2285507,2,"Greenville, SC",0,6,6,1.0,Asphyxiation - includes death by gas,0
3765499,2,"Longview, WA",11,6,6,1.0,"Personal weapons, includes beating",0
4839117,1,"Springfield, MA",0,6,6,1.0,Asphyxiation - includes death by gas,0
5524739,1,"Appleton, WI",11,6,6,1.0,"Personal weapons, includes beating",0
5696745,2,"Salt Lake City, UT",9,6,6,1.0,Other gun,0
6026836,1,"Oshkosh-Neenah, WI",11,6,6,1.0,"Personal weapons, includes beating",0
6447974,1,"Madera, CA",11,6,6,1.0,"Personal weapons, includes beating",0
6515375,1,"Williamsport, PA",7,6,6,1.0,Knife or cutting instrument,0
6596692,2,"Portland-South Portland-Biddeford, ME",14,6,6,1.0,Rifle,0
6617228,2,"Winchester, VA-WV",11,6,6,1.0,"Personal weapons, includes beating",0
7739238,1,"Auburn-Opelika, AL",1,6,6,1.0,"Blunt object - hammer, club, etc",0
9402509,2,"Lewiston-Auburn, ME",16,6,6,1.0,Strangulation - hanging,0
10906889,1,Rural Florida,8,6,6,1.0,"Narcotics or drugs, sleeping pills",0
12253143,2,"Sarasota-Bradenton-Venice, FL",8,6,6,1.0,"Narcotics or drugs, sleeping pills",0
12267513,2,"Philadelphia-Camden-Wilmington, PA-NJ-DE",12,6,6,1.0,Poison - does not include gas,0
12630520,2,"Merced, CA",15,6,6,1.0,Shotgun,0
13147057,2,"Lincoln, NE",11,6,6,1.0,"Personal weapons, includes beating",0
14080314,1,"Vineland-Millville-Bridgeton, NJ",14,6,6,1.0,Rifle,0
14468482,1,"Des Moines, IA",8,6,6,1.0,"Narcotics or drugs, sleeping pills",0
15144409,2,"Gainesville, GA",15,6,6,1.0,Shotgun,0
17900319,2,"Gainesville, FL",1,6,6,1.0,"Blunt object - hammer, club, etc",0
19741207,2,"Fort Collins-Loveland, CO",15,6,6,1.0,Shotgun,0
22202213,2,"Oshkosh-Neenah, WI",7,6,6,1.0,Knife or cutting instrument,0
23266044,2,"Lincoln, NE",15,6,6,1.0,Shotgun,0
23623150,2,"Dover, DE",14,6,6,1.0,Rifle,0
23738535,2,"Midland, TX",5,6,6,1.0,"Firearm, type not stated",0
26438392,1,"Janesville, WI",11,6,6,1.0,"Personal weapons, includes beating",0
26494190,2,"Johnson City, TN",5,6,6,1.0,"Firearm, type not stated",0
27438340,1,"Morristown, TN",11,6,6,1.0,"Personal weapons, includes beating",0
27909320,1,"Rockford, IL",8,6,6,1.0,"Narcotics or drugs, sleeping pills",0
29252412,1,"Anderson, IN",15,6,6,1.0,Shotgun,0
30744232,2,"Erie, PA",14,6,6,1.0,Rifle,0
31105440,2,"Ocean City, NJ",1,6,6,1.0,"Blunt object - hammer, club, etc",0
31133388,2,"St. Cloud, MN",10,6,6,1.0,Other or type unknown,0
33065065,2,"Albany, GA",14,6,6,1.0,Rifle,0
34475542,1,"Davenport-Moline-Rock Island, IA-IL",14,6,6,1.0,Rifle,0
36430880,1,"Flagstaff, AZ",15,6,6,1.0,Shotgun,0
37209466,1,"Hagerstown-Martinsburg, MD-WV",1,6,6,1.0,"Blunt object - hammer, club, etc",0
37237101,1,"Elmira, NY",11,6,6,1.0,"Personal weapons, includes beating",0
38708253,1,"Wausau, WI",11,6,6,1.0,"Personal weapons, includes beating",0
39568669,2,"Springfield, IL",1,6,6,1.0,"Blunt object - hammer, club, etc",0
39663106,1,"Bay City, MI",15,6,6,1.0,Shotgun,0
39734497,1,Rural Idaho,9,6,6,1.0,Other gun,0
42063289,2,"Toledo, OH",14,6,6,1.0,Rifle,0
42258177,2,"Duluth, MN-WI",15,6,6,1.0,Shotgun,0
43245771,2,"Pittsfield, MA",11,6,6,1.0,"Personal weapons, includes beating",0
47706996,1,"Janesville, WI",15,6,6,1.0,Shotgun,0
48358989,1,"Champaign-Urbana, IL",1,6,6,1.0,"Blunt object - hammer, club, etc",0
48484658,2,"Anchorage, AK",15,6,6,1.0,Shotgun,0
48908969,2,"Jacksonville, NC",1,6,6,1.0,"Blunt object - hammer, club, etc",0
49071042,1,"Parkersburg-Marietta-Vienna, WV-OH",8,6,6,1.0,"Narcotics or drugs, sleeping pills",0
49264810,1,"Altoona, PA",14,6,6,1.0,Rifle,0
49925865,2,"Medford, OR",10,6,6,1.0,Other or type unknown,0
50079841,1,"St. George, UT",11,6,6,1.0,"Personal weapons, includes beating",0
50394753,1,"Provo-Orem, UT",1,6,6,1.0,"Blunt object - hammer, club, etc",0
50888728,1,"Fort Walton Beach-Destin, FL",14,6,6,1.0,Rifle,0
51665642,2,"Laredo, TX",14,6,6,1.0,Rifle,0
51779715,1,"Lawton, OK",14,6,6,1.0,Rifle,0
52408575,1,"Glens Falls, NY",7,6,6,1.0,Knife or cutting instrument,0
53223839,2,"Eugene-Springfield, OR",15,6,6,1.0,Shotgun,0
54568388,1,"Bangor, ME",15,6,6,1.0,Shotgun,0
55115340,2,"Prescott, AZ",11,6,6,1.0,"Personal weapons, includes beating",0
55452472,2,"Lima, OH",1,6,6,1.0,"Blunt object - hammer, club, etc",0
55582224,2,"Huntington-Ashland, WV-KY-OH",14,6,6,1.0,Rifle,0
56154022,1,"Fayetteville-Springdale-Rogers, AR-MO",0,6,6,1.0,Asphyxiation - includes death by gas,0
56832594,1,Rural Washington,16,6,6,1.0,Strangulation - hanging,0
57137360,1,"Wausau, WI",10,6,6,1.0,Other or type unknown,0
58133597,1,"Anderson, IN",11,6,6,1.0,"Personal weapons, includes beating",0
62138164,1,"Cleveland-Elyria-Mentor, OH",2,6,6,1.0,Drowning,0
63106935,2,"Binghamton, NY",0,6,6,1.0,Asphyxiation - includes death by gas,0
63655547,1,"Columbia, SC",8,6,6,1.0,"Narcotics or drugs, sleeping pills",0
65286727,2,"Eau Claire, WI",11,6,6,1.0,"Personal weapons, includes beating",0
65684725,2,"Muncie, IN",15,6,6,1.0,Shotgun,0
66533042,2,"San Diego-Carlsbad-San Marcos, CA",2,6,6,1.0,Drowning,0
67112801,1,Rural Washington,4,6,6,1.0,Fire,0
67169731,1,"Waterloo-Cedar Falls, IA",10,6,6,1.0,Other or type unknown,0
67634694,1,"Lynchburg, VA",4,6,6,1.0,Fire,0
67838763,2,"Abilene, TX",15,6,6,1.0,Shotgun,0
67860340,1,"Boulder, CO",14,6,6,1.0,Rifle,0
67940690,1,"Salem, OR",4,6,6,1.0,Fire,0
69023027,2,Rural Utah,14,6,6,1.0,Rifle,0
69468948,1,"Modesto, CA",8,6,6,1.0,"Narcotics or drugs, sleeping pills",0
69749156,2,Rural New Mexico,16,6,6,1.0,Strangulation - hanging,0
69761609,2,"Jackson, MI",1,6,6,1.0,"Blunt object - hammer, club, etc",0
69930083,2,"Idaho Falls, ID",11,6,6,1.0,"Personal weapons, includes beating",0
71080957,2,"Harrisonburg, VA",11,6,6,1.0,"Personal weapons, includes beating",0
71597648,2,"El Centro, CA",11,6,6,1.0,"Personal weapons, includes beating",0
71903016,2,"Dubuque, IA",7,6,6,1.0,Knife or cutting instrument,0
72156189,1,"Mount Vernon-Anacortes, WA",1,6,6,1.0,"Blunt object - hammer, club, etc",0
72551666,2,"Auburn-Opelika, AL",15,6,6,1.0,Shotgun,0
73176306,2,"Columbia, MO",0,6,6,1.0,Asphyxiation - includes death by gas,0
75578425,1,"Provo-Orem, UT",5,6,6,1.0,"Firearm, type not stated",0
77831149,2,"Bend, OR",11,6,6,1.0,"Personal weapons, includes beating",0
77851500,2,"Cedar Rapids, IA",5,6,6,1.0,"Firearm, type not stated",0
78105545,1,"Lawrence, KS",7,6,6,1.0,Knife or cutting instrument,0
79513819,1,"Bowling Green, KY",11,6,6,1.0,"Personal weapons, includes beating",0
80147359,2,"Barnstable Town, MA",11,6,6,1.0,"Personal weapons, includes beating",0
81641024,1,"Great Falls, MT",5,6,6,1.0,"Firearm, type not stated",0
81995484,1,"Glens Falls, NY",4,6,6,1.0,Fire,0
82534445,2,"Decatur, IL",10,6,6,1.0,Other or type unknown,0
82742153,1,"Jackson, TN",10,6,6,1.0,Other or type unknown,0
83437275,2,Rural Arkansas,8,6,6,1.0,"Narcotics or drugs, sleeping pills",0
83588958,2,"Kingsport-Bristol-Bristol, TN-VA",0,6,6,1.0,Asphyxiation - includes death by gas,0
84553806,1,"Salt Lake City, UT",4,6,6,1.0,Fire,0
85621576,2,"Brunswick, GA",16,6,6,1.0,Strangulation - hanging,0
86295977,2,"Portland-Vancouver-Beaverton, OR-WA",8,6,6,1.0,"Narcotics or drugs, sleeping pills",0
86557923,2,Rural Illinois,0,6,6,1.0,Asphyxiation - includes death by gas,0
86689474,1,"Grand Forks, ND-MN",14,6,6,1.0,Rifle,0
87816495,2,"Weirton-Steubenville, WV-OH",15,6,6,1.0,Shotgun,0
88170059,2,"Harrisonburg, VA",10,6,6,1.0,Other or type unknown,0
89514870,1,"Logan, UT-ID",7,6,6,1.0,Knife or cutting instrument,0
90119782,1,"Bangor, ME",1,6,6,1.0,"Blunt object - hammer, club, etc",0
90404905,1,"Pascagoula, MS",11,6,6,1.0,"Personal weapons, includes beating",0
90999417,2,"Mount Vernon-Anacortes, WA",14,6,6,1.0,Rifle,0
91919048,2,"San Francisco-Oakland-Fremont, CA",12,6,6,1.0,Poison - does not include gas,0
92028445,2,"Gulfport-Biloxi, MS",14,6,6,1.0,Rifle,0
92133665,1,"Sheboygan, WI",7,6,6,1.0,Knife or cutting instrument,0
92310133,1,"Springfield, MO",16,6,6,1.0,Strangulation - hanging,0
93618051,2,"Odessa, TX",14,6,6,1.0,Rifle,0
95281659,2,"Topeka, KS",0,6,6,1.0,Asphyxiation - includes death by gas,0
95423845,1,"Boise City-Nampa, ID",8,6,6,1.0,"Narcotics or drugs, sleeping pills",0
96087844,2,"Oxnard-Thousand Oaks-Ventura, CA",15,6,6,1.0,Shotgun,0
96766040,2,"Ames, IA",7,6,6,1.0,Knife or cutting instrument,0
97975337,1,"Bend, OR",11,6,6,1.0,"Personal weapons, includes beating",0
98133114,1,"Jonesboro, AR",11,6,6,1.0,"Personal weapons, includes beating",0
98516559,2,"Chico, CA",14,6,6,1.0,Rifle,0
99871171,1,"Mount Vernon-Anacortes, WA",15,6,6,1.0,Shotgun,0
169956,2,"Tuscaloosa, AL",14,5,5,1.0,Rifle,0
331162,2,"Olympia, WA",15,5,5,1.0,Shotgun,0
876812,1,"St. George, UT",10,5,5,1.0,Other or type unknown,0
2027979,2,"Cheyenne, WY",15,5,5,1.0,Shotgun,0
3016614,1,Rural Mississippi,8,5,5,1.0,"Narcotics or drugs, sleeping pills",0
4053135,1,"Sarasota-Bradenton-Venice, FL",8,5,5,1.0,"Narcotics or drugs, sleeping pills",0
4975167,1,"San Antonio, TX",13,5,5,1.0,Pushed or thrown out window,0
5067538,2,"Wilmington, NC",4,5,5,1.0,Fire,0
5787047,1,"Lansing-East Lansing, MI",8,5,5,1.0,"Narcotics or drugs, sleeping pills",0
6719030,1,"Hagerstown-Martinsburg, MD-WV",8,5,5,1.0,"Narcotics or drugs, sleeping pills",0
7761666,2,"Baltimore-Towson, MD",3,5,5,1.0,Explosives,0
7921075,2,"Worcester, MA",14,5,5,1.0,Rifle,0
8081290,2,"Raleigh-Cary, NC",0,5,5,1.0,Asphyxiation - includes death by gas,0
8913007,2,"Elmira, NY",15,5,5,1.0,Shotgun,0
9657174,1,"Grand Forks, ND-MN",5,5,5,1.0,"Firearm, type not stated",0
10279536,1,"Tampa-St. Petersburg-Clearwater, FL",2,5,5,1.0,Drowning,0
10690677,1,"Lewiston, ID-WA",10,5,5,1.0,Other or type unknown,0
11505734,2,"Hot Springs, AR",15,5,5,1.0,Shotgun,0
12046728,1,"Little Rock-North Little Rock, AR",8,5,5,1.0,"Narcotics or drugs, sleeping pills",0
12265507,1,"Hagerstown-Martinsburg, MD-WV",4,5,5,1.0,Fire,0
13766833,1,"Idaho Falls, ID",11,5,5,1.0,"Personal weapons, includes beating",0
14238204,1,"Elizabethtown, KY",10,5,5,1.0,Other or type unknown,0
14509637,2,Rural Minnesota,2,5,5,1.0,Drowning,0
15232874,1,"Carson City, NV",7,5,5,1.0,Knife or cutting instrument,0
15494109,1,"Little Rock-North Little Rock, AR",0,5,5,1.0,Asphyxiation - includes death by gas,0
15975636,2,"Iowa City, IA",7,5,5,1.0,Knife or cutting instrument,0
18614268,2,"Denver-Aurora, CO",2,5,5,1.0,Drowning,0
19290418,2,"Bridgeport-Stamford-Norwalk, CT",8,5,5,1.0,"Narcotics or drugs, sleeping pills",0
19326510,2,"Elizabethtown, KY",11,5,5,1.0,"Personal weapons, includes beating",0
19626863,1,"Louisville, KY-IN",2,5,5,1.0,Drowning,0
19945073,2,Rural Colorado,8,5,5,1.0,"Narcotics or drugs, sleeping pills",0
20350627,1,"Milwaukee-Waukesha-West Allis, WI",2,5,5,1.0,Drowning,0
20380470,2,"Kingston, NY",15,5,5,1.0,Shotgun,0
20920399,2,"Ames, IA",6,5,5,1.0,"Handgun - pistol, revolver, etc",0
21206869,2,"Grand Junction, CO",7,5,5,1.0,Knife or cutting instrument,0
21239696,1,"Yuba City, CA",2,5,5,1.0,Drowning,0
21515332,1,"Barnstable Town, MA",10,5,5,1.0,Other or type unknown,0
21894432,2,"Lake Charles, LA",14,5,5,1.0,Rifle,0
22554304,1,"Jefferson City, MO",15,5,5,1.0,Shotgun,0
22912329,2,"Medford, OR",0,5,5,1.0,Asphyxiation - includes death by gas,0
23028137,1,"Great Falls, MT",1,5,5,1.0,"Blunt object - hammer, club, etc",0
23553858,2,"Ann Arbor, MI",0,5,5,1.0,Asphyxiation - includes death by gas,0
24131018,1,"Cleveland, TN",11,5,5,1.0,"Personal weapons, includes beating",0
24825616,1,"Owensboro, KY",15,5,5,1.0,Shotgun,0
24843109,2,"Knoxville, TN",8,5,5,1.0,"Narcotics or drugs, sleeping pills",0
24881698,2,Rural Arkansas,2,5,5,1.0,Drowning,0
24959235,2,"Midland, TX",14,5,5,1.0,Rifle,0
25370238,2,"Columbia, MO",1,5,5,1.0,"Blunt object - hammer, club, etc",0
26353596,2,"Lewiston-Auburn, ME",7,5,5,1.0,Knife or cutting instrument,0
26515955,2,"Napa, CA",14,5,5,1.0,Rifle,0
26523279,2,"Pascagoula, MS",15,5,5,1.0,Shotgun,0
27420223,2,"Coeur d Alene, ID",7,5,5,1.0,Knife or cutting instrument,0
28601845,1,"Bismarck, ND",11,5,5,1.0,"Personal weapons, includes beating",0
29119381,1,Rural Nebraska,4,5,5,1.0,Fire,0
29854712,2,"Florence, SC",4,5,5,1.0,Fire,0
30011139,2,Rural Iowa,4,5,5,1.0,Fire,0
30550559,2,"Akron, OH",0,5,5,1.0,Asphyxiation - includes death by gas,0
30655241,2,"Augusta-Richmond County, GA-SC",4,5,5,1.0,Fire,0
30805727,2,"Oshkosh-Neenah, WI",15,5,5,1.0,Shotgun,0
30855343,2,"Lewiston, ID-WA",14,5,5,1.0,Rifle,0
30987815,1,"Cleveland, TN",14,5,5,1.0,Rifle,0
31323496,1,"Springfield, OH",14,5,5,1.0,Rifle,0
31438548,2,"Danville, IL",11,5,5,1.0,"Personal weapons, includes beating",0
31734393,2,"La Crosse, WI-MN",15,5,5,1.0,Shotgun,0
32032333,1,"Michigan City-La Porte, IN",16,5,5,1.0,Strangulation - hanging,0
32481149,2,"Champaign-Urbana, IL",15,5,5,1.0,Shotgun,0
32833509,2,"Dover, DE",15,5,5,1.0,Shotgun,0
33076131,2,"Burlington-South Burlington, VT",14,5,5,1.0,Rifle,0
33534594,1,"El Paso, TX",2,5,5,1.0,Drowning,0
33606463,1,"Racine, WI",14,5,5,1.0,Rifle,0
34689866,2,"Anderson, SC",0,5,5,1.0,Asphyxiation - includes death by gas,0
35012069,1,"Prescott, AZ",8,5,5,1.0,"Narcotics or drugs, sleeping pills",0
35023342,2,"Houston-Sugar Land-Baytown, TX",9,5,5,1.0,Other gun,0
35469625,1,"Sioux City, IA-NE-SD",14,5,5,1.0,Rifle,0
36767010,2,"Palm Bay-Melbourne-Titusville, FL",8,5,5,1.0,"Narcotics or drugs, sleeping pills",0
38322102,2,"Yuma, AZ",15,5,5,1.0,Shotgun,0
38819111,1,Rural Alaska,9,5,5,1.0,Other gun,0
39746833,1,"La Crosse, WI-MN",10,5,5,1.0,Other or type unknown,0
39829191,1,Rural Arkansas,0,5,5,1.0,Asphyxiation - includes death by gas,0
40676959,1,"Battle Creek, MI",8,5,5,1.0,"Narcotics or drugs, sleeping pills",0
41487720,1,"Boise City-Nampa, ID",0,5,5,1.0,Asphyxiation - includes death by gas,0
42141771,1,"Jacksonville, NC",0,5,5,1.0,Asphyxiation - includes death by gas,0
42461167,2,"York-Hanover, PA",0,5,5,1.0,Asphyxiation - includes death by gas,0
43071465,1,Rural Arkansas,8,5,5,1.0,"Narcotics or drugs, sleeping pills",0
43225769,2,"Rockford, IL",8,5,5,1.0,"Narcotics or drugs, sleeping pills",0
43470727,1,"Wheeling, WV-OH",11,5,5,1.0,"Personal weapons, includes beating",0
43613039,2,Rural Connecticut,15,5,5,1.0,Shotgun,0
43773895,2,"Evansville, IN-KY",8,5,5,1.0,"Narcotics or drugs, sleeping pills",0
43993551,2,"Iowa City, IA",10,5,5,1.0,Other or type unknown,0
44774381,2,Rural New Hampshire,0,5,5,1.0,Asphyxiation - includes death by gas,0
44825068,2,"York-Hanover, PA",14,5,5,1.0,Rifle,0
45888997,2,"Oshkosh-Neenah, WI",11,5,5,1.0,"Personal weapons, includes beating",0
45960462,1,"Charleston-North Charleston, SC",8,5,5,1.0,"Narcotics or drugs, sleeping pills",0
46030273,2,"Abilene, TX",5,5,5,1.0,"Firearm, type not stated",0
47282822,2,"Springfield, OH",11,5,5,1.0,"Personal weapons, includes beating",0
47399499,1,"Provo-Orem, UT",15,5,5,1.0,Shotgun,0
47502918,1,"Iowa City, IA",7,5,5,1.0,Knife or cutting instrument,0
47743747,1,"San Jose-Sunnyvale-Santa Clara, CA",2,5,5,1.0,Drowning,0
48113502,2,"Ann Arbor, MI",14,5,5,1.0,Rifle,0
48212417,2,Rural Florida,4,5,5,1.0,Fire,0
49790544,2,"Washington-Arlington-Alexandria, DC-VA-MD-WV",12,5,5,1.0,Poison - does not include gas,0
49932243,2,"Muskegon-Norton Shores, MI",15,5,5,1.0,Shotgun,0
50434401,1,"Burlington-South Burlington, VT",5,5,5,1.0,"Firearm, type not stated",0
51751857,2,"College Station-Bryan, TX",14,5,5,1.0,Rifle,0
52625404,2,"Greenville, SC",8,5,5,1.0,"Narcotics or drugs, sleeping pills",0
53032519,1,"Providence-New Bedford-Fall River, RI-MA",3,5,5,1.0,Explosives,0
53142560,1,"Carson City, NV",1,5,5,1.0,"Blunt object - hammer, club, etc",0
53238888,2,"Ogden-Clearfield, UT",15,5,5,1.0,Shotgun,0
53507753,1,"New Haven-Milford, CT",16,5,5,1.0,Strangulation - hanging,0
54424601,2,"Rome, GA",1,5,5,1.0,"Blunt object - hammer, club, etc",0
58135464,2,"Albany, GA",1,5,5,1.0,"Blunt object - hammer, club, etc",0
58714239,2,"Goldsboro, NC",15,5,5,1.0,Shotgun,0
59770857,2,"Panama City-Lynn Haven, FL",14,5,5,1.0,Rifle,0
60045754,1,"Trenton-Ewing, NJ",16,5,5,1.0,Strangulation - hanging,0
60319293,1,"Bend, OR",15,5,5,1.0,Shotgun,0
61624141,1,"Santa Barbara-Santa Maria, CA",4,5,5,1.0,Fire,0
61870955,2,"Columbia, MO",14,5,5,1.0,Rifle,0
62174928,2,"Joplin, MO",15,5,5,1.0,Shotgun,0
63234187,2,Rural Vermont,0,5,5,1.0,Asphyxiation - includes death by gas,0
64125037,1,"Boston-Cambridge-Quincy, MA-NH",12,5,5,1.0,Poison - does not include gas,0
64413762,1,Rural Minnesota,2,5,5,1.0,Drowning,0
65008899,2,"Burlington-South Burlington, VT",11,5,5,1.0,"Personal weapons, includes beating",0
65286843,2,"Bloomington-Normal, IL",1,5,5,1.0,"Blunt object - hammer, club, etc",0
65982205,1,"Minneapolis-St. Paul-Bloomington, MN-WI",2,5,5,1.0,Drowning,0
66659640,2,"Port St. Lucie-Fort Pierce, FL",15,5,5,1.0,Shotgun,0
66872142,1,"Elkhart-Goshen, IN",9,5,5,1.0,Other gun,0
67046831,1,"Coeur d Alene, ID",1,5,5,1.0,"Blunt object - hammer, club, etc",0
67567723,2,"Evansville, IN-KY",5,5,5,1.0,"Firearm, type not stated",0
67926284,2,"La Crosse, WI-MN",11,5,5,1.0,"Personal weapons, includes beating",0
67982115,2,"Reno-Sparks, NV",8,5,5,1.0,"Narcotics or drugs, sleeping pills",0
68079091,2,"Salinas, CA",15,5,5,1.0,Shotgun,0
68155600,2,"San Jose-Sunnyvale-Santa Clara, CA",12,5,5,1.0,Poison - does not include gas,0
68339041,1,"Parkersburg-Marietta-Vienna, WV-OH",1,5,5,1.0,"Blunt object - hammer, club, etc",0
68591161,1,"Washington-Arlington-Alexandria, DC-VA-MD-WV",12,5,5,1.0,Poison - does not include gas,0
68761516,1,"San Diego-Carlsbad-San Marcos, CA",2,5,5,1.0,Drowning,0
69245425,2,"Punta Gorda, FL",5,5,5,1.0,"Firearm, type not stated",0
69247735,1,"La Crosse, WI-MN",7,5,5,1.0,Knife or cutting instrument,0
69615814,2,"Naples-Marco Island, FL",15,5,5,1.0,Shotgun,0
70476849,1,"Wenatchee, WA",11,5,5,1.0,"Personal weapons, includes beating",0
70485471,2,"Lebanon, PA",11,5,5,1.0,"Personal weapons, includes beating",0
71451922,2,"Sumter, SC",14,5,5,1.0,Rifle,0
71754504,1,"Ocala, FL",8,5,5,1.0,"Narcotics or drugs, sleeping pills",0
72600388,1,"Elizabethtown, KY",11,5,5,1.0,"Personal weapons, includes beating",0
73362870,2,"Champaign-Urbana, IL",1,5,5,1.0,"Blunt object - hammer, club, etc",0
73588081,1,"Sarasota-Bradenton-Venice, FL",4,5,5,1.0,Fire,0
73714453,1,"Blacksburg-Christiansburg, VA",8,5,5,1.0,"Narcotics or drugs, sleeping pills",0
74814576,1,"Lewiston-Auburn, ME",5,5,5,1.0,"Firearm, type not stated",0
75797700,2,"Johnson City, TN",1,5,5,1.0,"Blunt object - hammer, club, etc",0
76233487,1,"Fond du Lac, WI",5,5,5,1.0,"Firearm, type not stated",0
77043598,1,Rural Washington,2,5,5,1.0,Drowning,0
77139862,2,"Palm Bay-Melbourne-Titusville, FL",15,5,5,1.0,Shotgun,0
77223276,2,"Deltona-Daytona Beach-Ormond Beach, FL",14,5,5,1.0,Rifle,0
77466217,1,"Lafayette, IN",14,5,5,1.0,Rifle,0
78200189,1,"Canton-Massillon, OH",9,5,5,1.0,Other gun,0
78994235,1,"Lewiston, ID-WA",14,5,5,1.0,Rifle,0
80594897,2,"Gadsden, AL",11,5,5,1.0,"Personal weapons, includes beating",0
80999888,1,"Atlantic City, NJ",14,5,5,1.0,Rifle,0
82479902,2,"Oklahoma City, OK",2,5,5,1.0,Drowning,0
82494326,2,"Baton Rouge, LA",9,5,5,1.0,Other gun,0
83231884,1,Rural Connecticut,11,5,5,1.0,"Personal weapons, includes beating",0
83366703,1,"Bay City, MI",14,5,5,1.0,Rifle,0
83388236,2,"Shreveport-Bossier City, LA",4,5,5,1.0,Fire,0
83543307,1,"Green Bay, WI",11,5,5,1.0,"Personal weapons, includes beating",0
83867313,1,"Warner Robins, GA",1,5,5,1.0,"Blunt object - hammer, club, etc",0
84373902,2,"Mount Vernon-Anacortes, WA",1,5,5,1.0,"Blunt object - hammer, club, etc",0
85091807,1,"McAllen-Edinburg-Mission, TX",9,5,5,1.0,Other gun,0
85670367,2,"Morgantown, WV",14,5,5,1.0,Rifle,0
86136173,1,"Williamsport, PA",14,5,5,1.0,Rifle,0
86158017,2,"Greenville, NC",14,5,5,1.0,Rifle,0
86833639,2,"Dubuque, IA",10,5,5,1.0,Other or type unknown,0
87581543,2,"Corvallis, OR",6,5,5,1.0,"Handgun - pistol, revolver, etc",0
88614559,1,"Norwich-New London, CT",15,5,5,1.0,Shotgun,0
89940102,2,Rural Utah,5,5,5,1.0,"Firearm, type not stated",0
90464786,1,"Logan, UT-ID",14,5,5,1.0,Rifle,0
90984346,1,"Lebanon, PA",14,5,5,1.0,Rifle,0
91266127,2,"Rapid City, SD",1,5,5,1.0,"Blunt object - hammer, club, etc",0
92261165,2,"Niles-Benton Harbor, MI",1,5,5,1.0,"Blunt object - hammer, club, etc",0
93442156,1,"Grand Forks, ND-MN",1,5,5,1.0,"Blunt object - hammer, club, etc",0
94814328,2,"Prescott, AZ",14,5,5,1.0,Rifle,0
95126408,1,"Shreveport-Bossier City, LA",0,5,5,1.0,Asphyxiation - includes death by gas,0
95278550,2,"Battle Creek, MI",8,5,5,1.0,"Narcotics or drugs, sleeping pills",0
95672863,2,"Alexandria, LA",14,5,5,1.0,Rifle,0
97291092,2,"Medford, OR",14,5,5,1.0,Rifle,0
97581733,2,"Weirton-Steubenville, WV-OH",11,5,5,1.0,"Personal weapons, includes beating",0
97716307,2,"Medford, OR",5,5,5,1.0,"Firearm, type not stated",0
98596209,2,"Jackson, MS",4,5,5,1.0,Fire,0
99437272,2,"Midland, TX",1,5,5,1.0,"Blunt object - hammer, club, etc",0
5930,1,"Green Bay, WI",0,4,4,1.0,Asphyxiation - includes death by gas,0
348809,2,"Racine, WI",15,4,4,1.0,Shotgun,0
587698,2,"Norwich-New London, CT",0,4,4,1.0,Asphyxiation - includes death by gas,0
1164856,1,"Grand Forks, ND-MN",15,4,4,1.0,Shotgun,0
1652864,2,"Parkersburg-Marietta-Vienna, WV-OH",8,4,4,1.0,"Narcotics or drugs, sleeping pills",0
1967581,2,"Ocala, FL",8,4,4,1.0,"Narcotics or drugs, sleeping pills",0
2089469,2,"Kennewick-Richland-Pasco, WA",8,4,4,1.0,"Narcotics or drugs, sleeping pills",0
2213967,2,"Olympia, WA",0,4,4,1.0,Asphyxiation - includes death by gas,0
2249892,2,"Boise City-Nampa, ID",0,4,4,1.0,Asphyxiation - includes death by gas,0
2700313,1,"Savannah, GA",4,4,4,1.0,Fire,0
3826528,2,"Salinas, CA",2,4,4,1.0,Drowning,0
4069372,2,"Roanoke, VA",0,4,4,1.0,Asphyxiation - includes death by gas,0
4336911,2,"Bloomington, IN",1,4,4,1.0,"Blunt object - hammer, club, etc",0
4838017,2,"Florence-Muscle Shoals, AL",14,4,4,1.0,Rifle,0
5605578,2,"Springfield, MO",4,4,4,1.0,Fire,0
5755992,2,"Pensacola-Ferry Pass-Brent, FL",8,4,4,1.0,"Narcotics or drugs, sleeping pills",0
6192082,2,"Bismarck, ND",7,4,4,1.0,Knife or cutting instrument,0
6292363,2,"Lewiston, ID-WA",10,4,4,1.0,Other or type unknown,0
6384054,2,Rural Washington,4,4,4,1.0,Fire,0
7342822,2,"Fort Walton Beach-Destin, FL",14,4,4,1.0,Rifle,0
8516880,2,"Flint, MI",8,4,4,1.0,"Narcotics or drugs, sleeping pills",0
9519422,2,"Decatur, AL",14,4,4,1.0,Rifle,0
9804783,1,Rural Arizona,0,4,4,1.0,Asphyxiation - includes death by gas,0
10279517,2,"Indianapolis, IN",12,4,4,1.0,Poison - does not include gas,0
10935101,1,"Lebanon, PA",4,4,4,1.0,Fire,0
10983422,2,"Corpus Christi, TX",8,4,4,1.0,"Narcotics or drugs, sleeping pills",0
11041523,2,"Cape Coral-Fort Myers, FL",9,4,4,1.0,Other gun,0
11502332,1,"Peoria, IL",14,4,4,1.0,Rifle,0
11775772,2,"Corpus Christi, TX",4,4,4,1.0,Fire,0
11906849,2,"Hanford-Corcoran, CA",14,4,4,1.0,Rifle,0
12483979,2,"Palm Bay-Melbourne-Titusville, FL",14,4,4,1.0,Rifle,0
12551929,2,"Dalton, GA",14,4,4,1.0,Rifle,0
13746889,2,"Bremerton-Silverdale, WA",8,4,4,1.0,"Narcotics or drugs, sleeping pills",0
13833690,2,"Grand Forks, ND-MN",15,4,4,1.0,Shotgun,0
14266619,2,"Appleton, WI",0,4,4,1.0,Asphyxiation - includes death by gas,0
14415511,2,"Pocatello, ID",14,4,4,1.0,Rifle,0
15543089,1,"Lancaster, PA",0,4,4,1.0,Asphyxiation - includes death by gas,0
16221718,1,"Cincinnati-Middletown, OH-KY-IN",2,4,4,1.0,Drowning,0
16494142,2,Rural New Hampshire,9,4,4,1.0,Other gun,0
16536162,2,"Farmington, NM",15,4,4,1.0,Shotgun,0
16673617,2,"Waterloo-Cedar Falls, IA",1,4,4,1.0,"Blunt object - hammer, club, etc",0
17222999,2,"Green Bay, WI",14,4,4,1.0,Rifle,0
18361710,1,Rural Virginia,2,4,4,1.0,Drowning,0
18441822,1,"Anderson, SC",0,4,4,1.0,Asphyxiation - includes death by gas,0
19043475,2,Rural Colorado,16,4,4,1.0,Strangulation - hanging,0
19608552,1,Rural New Hampshire,8,4,4,1.0,"Narcotics or drugs, sleeping pills",0
19621464,1,Rural Connecticut,15,4,4,1.0,Shotgun,0
19982702,2,"La Crosse, WI-MN",14,4,4,1.0,Rifle,0
20851519,2,"Terre Haute, IN",14,4,4,1.0,Rifle,0
21121501,1,"Danville, VA",8,4,4,1.0,"Narcotics or drugs, sleeping pills",0
22345957,1,"Vero Beach, FL",11,4,4,1.0,"Personal weapons, includes beating",0
22390821,2,"Muncie, IN",5,4,4,1.0,"Firearm, type not stated",0
22706631,2,"Provo-Orem, UT",4,4,4,1.0,Fire,0
23116045,2,"Valdosta, GA",14,4,4,1.0,Rifle,0
24175627,2,"Salem, OR",4,4,4,1.0,Fire,0
24475107,2,"Cedar Rapids, IA",15,4,4,1.0,Shotgun,0
24880240,1,"Indianapolis, IN",13,4,4,1.0,Pushed or thrown out window,0
24940136,1,"Altoona, PA",5,4,4,1.0,"Firearm, type not stated",0
25101332,1,Rural Kansas,0,4,4,1.0,Asphyxiation - includes death by gas,0
25971326,2,"Sioux Falls, SD",4,4,4,1.0,Fire,0
26289784,2,"Bend, OR",1,4,4,1.0,"Blunt object - hammer, club, etc",0
26515559,2,"Morristown, TN",14,4,4,1.0,Rifle,0
27032605,1,"Kalamazoo-Portage, MI",0,4,4,1.0,Asphyxiation - includes death by gas,0
27573387,1,"Fargo, ND-MN",14,4,4,1.0,Rifle,0
27590779,2,"Wausau, WI",15,4,4,1.0,Shotgun,0
29310774,1,"Charleston-North Charleston, SC",9,4,4,1.0,Other gun,0
29930910,1,"Omaha-Council Bluffs, NE-IA",0,4,4,1.0,Asphyxiation - includes death by gas,0
30499983,1,"Knoxville, TN",8,4,4,1.0,"Narcotics or drugs, sleeping pills",0
30837510,1,"Madison, WI",15,4,4,1.0,Shotgun,0
31667329,2,"Burlington-South Burlington, VT",1,4,4,1.0,"Blunt object - hammer, club, etc",0
31899824,2,"Bloomington-Normal, IL",11,4,4,1.0,"Personal weapons, includes beating",0
32009863,2,"Gainesville, FL",14,4,4,1.0,Rifle,0
32112558,2,"Utica-Rome, NY",5,4,4,1.0,"Firearm, type not stated",0
33646197,1,"Harrisonburg, VA",11,4,4,1.0,"Personal weapons, includes beating",0
33889641,2,"Waco, TX",8,4,4,1.0,"Narcotics or drugs, sleeping pills",0
34058311,2,"St. George, UT",7,4,4,1.0,Knife or cutting instrument,0
34370401,2,"Wenatchee, WA",11,4,4,1.0,"Personal weapons, includes beating",0
34513212,2,"Ogden-Clearfield, UT",8,4,4,1.0,"Narcotics or drugs, sleeping pills",0
35878034,2,"Kennewick-Richland-Pasco, WA",15,4,4,1.0,Shotgun,0
36761177,2,"Fargo, ND-MN",14,4,4,1.0,Rifle,0
37656526,2,Rural North Carolina,2,4,4,1.0,Drowning,0
38362984,2,"Redding, CA",0,4,4,1.0,Asphyxiation - includes death by gas,0
38393874,1,"Janesville, WI",14,4,4,1.0,Rifle,0
39312166,2,"Lafayette, IN",5,4,4,1.0,"Firearm, type not stated",0
39374690,2,"College Station-Bryan, TX",15,4,4,1.0,Shotgun,0
39394386,2,"Sioux Falls, SD",5,4,4,1.0,"Firearm, type not stated",0
39800551,1,"Billings, MT",1,4,4,1.0,"Blunt object - hammer, club, etc",0
39921678,1,"St. Joseph, MO-KS",14,4,4,1.0,Rifle,0
39962366,1,"Hanford-Corcoran, CA",16,4,4,1.0,Strangulation - hanging,0
40836300,2,Rural California,8,4,4,1.0,"Narcotics or drugs, sleeping pills",0
41539692,1,Rural Minnesota,0,4,4,1.0,Asphyxiation - includes death by gas,0
41756584,1,"Spokane, WA",0,4,4,1.0,Asphyxiation - includes death by gas,0
42525355,1,"Billings, MT",9,4,4,1.0,Other gun,0
42855689,2,"Altoona, PA",15,4,4,1.0,Shotgun,0
42860209,2,"Lima, OH",4,4,4,1.0,Fire,0
42915494,1,"Reno-Sparks, NV",16,4,4,1.0,Strangulation - hanging,0
43153201,1,"St. Cloud, MN",8,4,4,1.0,"Narcotics or drugs, sleeping pills",0
43868925,2,"Kansas City, MO-KS",3,4,4,1.0,Explosives,0
43890331,1,"Fort Wayne, IN",0,4,4,1.0,Asphyxiation - includes death by gas,0
44368080,1,"Missoula, MT",10,4,4,1.0,Other or type unknown,0
45360185,1,"Rocky Mount, NC",4,4,4,1.0,Fire,0
46709105,1,"Indianapolis, IN",2,4,4,1.0,Drowning,0
47463529,1,"Lakeland, FL",8,4,4,1.0,"Narcotics or drugs, sleeping pills",0
47466906,2,"Manchester-Nashua, NH",15,4,4,1.0,Shotgun,0
48388816,2,"Hot Springs, AR",11,4,4,1.0,"Personal weapons, includes beating",0
48406263,2,"Bend, OR",0,4,4,1.0,Asphyxiation - includes death by gas,0
48663316,1,"Weirton-Steubenville, WV-OH",11,4,4,1.0,"Personal weapons, includes beating",0
48710871,1,"Kokomo, IN",14,4,4,1.0,Rifle,0
48732318,2,"Kingsport-Bristol-Bristol, TN-VA",8,4,4,1.0,"Narcotics or drugs, sleeping pills",0
48888353,1,"Boise City-Nampa, ID",4,4,4,1.0,Fire,0
49218922,2,"Jonesboro, AR",0,4,4,1.0,Asphyxiation - includes death by gas,0
49703244,2,"Lafayette, LA",8,4,4,1.0,"Narcotics or drugs, sleeping pills",0
50141637,2,"Lewiston-Auburn, ME",14,4,4,1.0,Rifle,0
51466737,2,"Peoria, IL",15,4,4,1.0,Shotgun,0
51517613,2,"Ogden-Clearfield, UT",14,4,4,1.0,Rifle,0
52666317,1,"State College, PA",15,4,4,1.0,Shotgun,0
52706591,1,"Vallejo-Fairfield, CA",4,4,4,1.0,Fire,0
52894185,1,"Portland-Vancouver-Beaverton, OR-WA",12,4,4,1.0,Poison - does not include gas,0
53639907,1,Rural Mississippi,2,4,4,1.0,Drowning,0
54150148,2,"San Angelo, TX",5,4,4,1.0,"Firearm, type not stated",0
54711824,2,"Janesville, WI",1,4,4,1.0,"Blunt object - hammer, club, etc",0
54932876,1,"Bellingham, WA",15,4,4,1.0,Shotgun,0
54960966,1,"Fresno, CA",8,4,4,1.0,"Narcotics or drugs, sleeping pills",0
55652038,2,"Columbus, GA-AL",0,4,4,1.0,Asphyxiation - includes death by gas,0
55678456,1,"Lima, OH",4,4,4,1.0,Fire,0
55741266,2,"Dothan, AL",1,4,4,1.0,"Blunt object - hammer, club, etc",0
56265434,2,"Farmington, NM",14,4,4,1.0,Rifle,0
57337299,1,"Hattiesburg, MS",11,4,4,1.0,"Personal weapons, includes beating",0
59297361,2,"Huntington-Ashland, WV-KY-OH",8,4,4,1.0,"Narcotics or drugs, sleeping pills",0
59350433,2,"Johnstown, PA",7,4,4,1.0,Knife or cutting instrument,0
59498066,2,"Altoona, PA",14,4,4,1.0,Rifle,0
59981671,1,"Longview, WA",5,4,4,1.0,"Firearm, type not stated",0
60111617,2,Rural Maine,0,4,4,1.0,Asphyxiation - includes death by gas,0
60824738,1,"Fond du Lac, WI",11,4,4,1.0,"Personal weapons, includes beating",0
61031178,2,"Goldsboro, NC",14,4,4,1.0,Rifle,0
61120334,2,"Des Moines, IA",14,4,4,1.0,Rifle,0
61467296,2,"Farmington, NM",5,4,4,1.0,"Firearm, type not stated",0
61742796,2,"Duluth, MN-WI",0,4,4,1.0,Asphyxiation - includes death by gas,0
62514059,1,"Decatur, IL",14,4,4,1.0,Rifle,0
64047174,2,"Dalton, GA",7,4,4,1.0,Knife or cutting instrument,0
64092671,1,Rural Mississippi,0,4,4,1.0,Asphyxiation - includes death by gas,0
64854602,1,"Wichita, KS",9,4,4,1.0,Other gun,0
64997130,9,"Baton Rouge, LA",10,4,4,1.0,Other or type unknown,0
65352594,2,"Atlanta-Sandy Springs-Marietta, GA",12,4,4,1.0,Poison - does not include gas,0
65440833,2,"Williamsport, PA",15,4,4,1.0,Shotgun,0
65449536,2,"Jacksonville, NC",14,4,4,1.0,Rifle,0
65815322,2,"St. Joseph, MO-KS",7,4,4,1.0,Knife or cutting instrument,0
65987565,1,"Vineland-Millville-Bridgeton, NJ",16,4,4,1.0,Strangulation - hanging,0
66608881,1,"Sheboygan, WI",11,4,4,1.0,"Personal weapons, includes beating",0
67649374,1,"Lincoln, NE",4,4,4,1.0,Fire,0
67950507,2,"Cumberland, MD-WV",14,4,4,1.0,Rifle,0
68317232,2,"Vineland-Millville-Bridgeton, NJ",5,4,4,1.0,"Firearm, type not stated",0
68455484,2,"Bakersfield, CA",4,4,4,1.0,Fire,0
68820096,1,"Pittsfield, MA",14,4,4,1.0,Rifle,0
69050723,1,"Missoula, MT",15,4,4,1.0,Shotgun,0
69760489,1,"Oshkosh-Neenah, WI",8,4,4,1.0,"Narcotics or drugs, sleeping pills",0
69787910,2,"Lincoln, NE",14,4,4,1.0,Rifle,0
71229601,1,"Cleveland, TN",1,4,4,1.0,"Blunt object - hammer, club, etc",0
71849247,2,"Burlington, NC",1,4,4,1.0,"Blunt object - hammer, club, etc",0
71976382,2,"Glens Falls, NY",14,4,4,1.0,Rifle,0
72237374,2,"Rocky Mount, NC",5,4,4,1.0,"Firearm, type not stated",0
72407265,2,"Bellingham, WA",8,4,4,1.0,"Narcotics or drugs, sleeping pills",0
72428152,1,Rural Connecticut,1,4,4,1.0,"Blunt object - hammer, club, etc",0
73293646,2,"Peoria, IL",0,4,4,1.0,Asphyxiation - includes death by gas,0
73335153,1,"Jefferson City, MO",1,4,4,1.0,"Blunt object - hammer, club, etc",0
73499093,1,"Fort Smith, AR-OK",4,4,4,1.0,Fire,0
73982714,2,"Dover, DE",5,4,4,1.0,"Firearm, type not stated",0
74338322,2,"Bay City, MI",1,4,4,1.0,"Blunt object - hammer, club, etc",0
74369419,2,"Fort Collins-Loveland, CO",5,4,4,1.0,"Firearm, type not stated",0
74537349,2,"Santa Fe, NM",4,4,4,1.0,Fire,0
74618664,1,"Fond du Lac, WI",14,4,4,1.0,Rifle,0
75084045,2,"Bellingham, WA",1,4,4,1.0,"Blunt object - hammer, club, etc",0
75105665,9,Rural New York,10,4,4,1.0,Other or type unknown,0
75835823,1,"Dallas-Fort Worth-Arlington, TX",3,4,4,1.0,Explosives,0
75981898,2,"Harrisonburg, VA",5,4,4,1.0,"Firearm, type not stated",0
76212537,1,"Raleigh-Cary, NC",8,4,4,1.0,"Narcotics or drugs, sleeping pills",0
76777375,1,"Rochester, MN",8,4,4,1.0,"Narcotics or drugs, sleeping pills",0
77131711,2,"State College, PA",1,4,4,1.0,"Blunt object - hammer, club, etc",0
77831397,1,Rural Iowa,0,4,4,1.0,Asphyxiation - includes death by gas,0
78578917,2,"Saginaw, MI",9,4,4,1.0,Other gun,0
78983021,2,"Carson City, NV",6,4,4,1.0,"Handgun - pistol, revolver, etc",0
79176812,2,"Florence, SC",0,4,4,1.0,Asphyxiation - includes death by gas,0
80790103,2,"St. Louis, MO-IL",2,4,4,1.0,Drowning,0
81474096,2,"Coeur d Alene, ID",14,4,4,1.0,Rifle,0
81762489,1,"Pueblo, CO",9,4,4,1.0,Other gun,0
81987281,1,"Kankakee-Bradley, IL",4,4,4,1.0,Fire,0
82426618,2,"Columbus, IN",6,4,4,1.0,"Handgun - pistol, revolver, etc",0
82434237,1,"Iowa City, IA",1,4,4,1.0,"Blunt object - hammer, club, etc",0
83461976,2,"Boise City-Nampa, ID",4,4,4,1.0,Fire,0
84063951,1,"Pittsfield, MA",11,4,4,1.0,"Personal weapons, includes beating",0
85417939,2,"Amarillo, TX",14,4,4,1.0,Rifle,0
85485762,1,"Hinesville-Fort Stewart, GA",15,4,4,1.0,Shotgun,0
85830525,2,"Rochester, MN",0,4,4,1.0,Asphyxiation - includes death by gas,0
85956112,1,"Salinas, CA",0,4,4,1.0,Asphyxiation - includes death by gas,0
85959869,1,"Montgomery, AL",4,4,4,1.0,Fire,0
85984161,2,"Hattiesburg, MS",0,4,4,1.0,Asphyxiation - includes death by gas,0
85995179,1,"Wausau, WI",0,4,4,1.0,Asphyxiation - includes death by gas,0
87103981,1,"Sacramento-Roseville, CA",12,4,4,1.0,Poison - does not include gas,0
88318580,1,"Mount Vernon-Anacortes, WA",10,4,4,1.0,Other or type unknown,0
88951458,1,"Cumberland, MD-WV",0,4,4,1.0,Asphyxiation - includes death by gas,0
89459706,2,"Muskegon-Norton Shores, MI",1,4,4,1.0,"Blunt object - hammer, club, etc",0
89907690,2,"Wichita Falls, TX",0,4,4,1.0,Asphyxiation - includes death by gas,0
90718598,1,"Cheyenne, WY",10,4,4,1.0,Other or type unknown,0
90899068,2,Rural Maryland,16,4,4,1.0,Strangulation - hanging,0
93282570,1,"Akron, OH",16,4,4,1.0,Strangulation - hanging,0
93842437,1,"Binghamton, NY",4,4,4,1.0,Fire,0
94415300,2,"Morgantown, WV",15,4,4,1.0,Shotgun,0
94491952,2,"Greeley, CO",14,4,4,1.0,Rifle,0
95365105,1,"Eau Claire, WI",0,4,4,1.0,Asphyxiation - includes death by gas,0
95652609,2,Rural Alabama,0,4,4,1.0,Asphyxiation - includes death by gas,0
96015768,2,"Columbus, IN",11,4,4,1.0,"Personal weapons, includes beating",0
96211388,2,Rural Mississippi,2,4,4,1.0,Drowning,0
96334379,9,Rural West Virginia,6,4,4,1.0,"Handgun - pistol, revolver, etc",0
96383555,1,"Olympia, WA",14,4,4,1.0,Rifle,0
96707988,1,"Chattanooga, TN-GA",8,4,4,1.0,"Narcotics or drugs, sleeping pills",0
97586512,1,"Amarillo, TX",0,4,4,1.0,Asphyxiation - includes death by gas,0
97621768,2,Rural Wyoming,5,4,4,1.0,"Firearm, type not stated",0
97669953,2,Rural North Dakota,1,4,4,1.0,"Blunt object - hammer, club, etc",0
98004729,2,"Corvallis, OR",11,4,4,1.0,"Personal weapons, includes beating",0
98042623,1,"Muncie, IN",11,4,4,1.0,"Personal weapons, includes beating",0
98439264,2,"Ithaca, NY",14,4,4,1.0,Rifle,0
98800632,2,"Orlando-Kissimmee, FL",9,4,4,1.0,Other gun,0
99445056,2,"Grand Rapids-Wyoming, MI",8,4,4,1.0,"Narcotics or drugs, sleeping pills",0
540669,2,Rural Idaho,4,3,3,1.0,Fire,0
576439,1,"Reno-Sparks, NV",0,3,3,1.0,Asphyxiation - includes death by gas,0
1116693,1,"Ocean City, NJ",5,3,3,1.0,"Firearm, type not stated",0
1123089,2,Rural Alaska,2,3,3,1.0,Drowning,0
1199181,2,"College Station-Bryan, TX",0,3,3,1.0,Asphyxiation - includes death by gas,0
1526352,1,"Billings, MT",14,3,3,1.0,Rifle,0
2131003,1,"Allentown-Bethlehem-Easton, PA-NJ",0,3,3,1.0,Asphyxiation - includes death by gas,0
2427789,9,Rural Ohio,6,3,3,1.0,"Handgun - pistol, revolver, etc",0
3082584,2,"Beaumont-Port Arthur, TX",0,3,3,1.0,Asphyxiation - includes death by gas,0
3188500,2,"Bay City, MI",14,3,3,1.0,Rifle,0
3200779,1,"Anderson, IN",14,3,3,1.0,Rifle,0
3242965,2,"Sioux Falls, SD",1,3,3,1.0,"Blunt object - hammer, club, etc",0
3309426,2,"Spokane, WA",4,3,3,1.0,Fire,0
3380147,2,"El Centro, CA",15,3,3,1.0,Shotgun,0
3466144,2,"Santa Rosa-Petaluma, CA",5,3,3,1.0,"Firearm, type not stated",0
3702853,2,"Billings, MT",1,3,3,1.0,"Blunt object - hammer, club, etc",0
3810416,1,"Sheboygan, WI",10,3,3,1.0,Other or type unknown,0
4098510,1,"Huntington-Ashland, WV-KY-OH",8,3,3,1.0,"Narcotics or drugs, sleeping pills",0
4970028,1,"Akron, OH",0,3,3,1.0,Asphyxiation - includes death by gas,0
5127896,2,"Dalton, GA",5,3,3,1.0,"Firearm, type not stated",0
5487702,2,"Muncie, IN",1,3,3,1.0,"Blunt object - hammer, club, etc",0
5680664,2,"Great Falls, MT",10,3,3,1.0,Other or type unknown,0
6313882,2,"New Haven-Milford, CT",2,3,3,1.0,Drowning,0
6382629,1,"Decatur, AL",8,3,3,1.0,"Narcotics or drugs, sleeping pills",0
6610646,1,"Waterloo-Cedar Falls, IA",4,3,3,1.0,Fire,0
6641092,1,"Erie, PA",0,3,3,1.0,Asphyxiation - includes death by gas,0
6642964,2,"Oxnard-Thousand Oaks-Ventura, CA",0,3,3,1.0,Asphyxiation - includes death by gas,0
6910386,1,"Anniston-Oxford, AL",1,3,3,1.0,"Blunt object - hammer, club, etc",0
7212517,1,"Decatur, IL",15,3,3,1.0,Shotgun,0
7645711,2,Rural Wyoming,1,3,3,1.0,"Blunt object - hammer, club, etc",0
7673464,1,"Hartford, CT",13,3,3,1.0,Pushed or thrown out window,0
7820999,1,"Virginia Beach-Norfolk-Newport News, VA-NC",2,3,3,1.0,Drowning,0
7871133,2,"Bloomington-Normal, IL",5,3,3,1.0,"Firearm, type not stated",0
8551055,2,"Pascagoula, MS",0,3,3,1.0,Asphyxiation - includes death by gas,0
8654411,2,"Winchester, VA-WV",1,3,3,1.0,"Blunt object - hammer, club, etc",0
8909895,2,"Columbus, IN",15,3,3,1.0,Shotgun,0
9058119,2,"Boise City-Nampa, ID",8,3,3,1.0,"Narcotics or drugs, sleeping pills",0
9378848,1,"Lakeland, FL",9,3,3,1.0,Other gun,0
9803822,1,"Olympia, WA",15,3,3,1.0,Shotgun,0
9922275,1,"Terre Haute, IN",4,3,3,1.0,Fire,0
10968759,2,Rural Illinois,2,3,3,1.0,Drowning,0
11406083,2,"Durham, NC",8,3,3,1.0,"Narcotics or drugs, sleeping pills",0
11498102,2,"Goldsboro, NC",16,3,3,1.0,Strangulation - hanging,0
11612760,2,"Rochester, NY",3,3,3,1.0,Explosives,0
12208606,2,"Rochester, MN",6,3,3,1.0,"Handgun - pistol, revolver, etc",0
12448071,1,"Durham, NC",8,3,3,1.0,"Narcotics or drugs, sleeping pills",0
13446683,2,"Bangor, ME",15,3,3,1.0,Shotgun,0
13735919,1,"Columbus, IN",7,3,3,1.0,Knife or cutting instrument,0
14265022,1,"Sarasota-Bradenton-Venice, FL",2,3,3,1.0,Drowning,0
14344545,2,"Dayton, OH",8,3,3,1.0,"Narcotics or drugs, sleeping pills",0
14504184,1,"Corvallis, OR",11,3,3,1.0,"Personal weapons, includes beating",0
14777112,1,"Provo-Orem, UT",8,3,3,1.0,"Narcotics or drugs, sleeping pills",0
14798709,2,"Sumter, SC",0,3,3,1.0,Asphyxiation - includes death by gas,0
15485099,1,Rural Delaware,10,3,3,1.0,Other or type unknown,0
15535198,2,"Green Bay, WI",5,3,3,1.0,"Firearm, type not stated",0
15760510,9,"Knoxville, TN",10,3,3,1.0,Other or type unknown,0
16065798,2,"Fayetteville-Springdale-Rogers, AR-MO",0,3,3,1.0,Asphyxiation - includes death by gas,0
16330893,1,"Bismarck, ND",15,3,3,1.0,Shotgun,0
17076710,2,"Salisbury, MD",2,3,3,1.0,Drowning,0
17407023,2,"Monroe, MI",4,3,3,1.0,Fire,0
17418570,2,Rural Oregon,12,3,3,1.0,Poison - does not include gas,0
17510361,1,"Fond du Lac, WI",7,3,3,1.0,Knife or cutting instrument,0
18358069,1,Rural Tennessee,16,3,3,1.0,Strangulation - hanging,0
18507602,2,"Harrisonburg, VA",15,3,3,1.0,Shotgun,0
18746312,1,"Duluth, MN-WI",8,3,3,1.0,"Narcotics or drugs, sleeping pills",0
18967002,1,"Rocky Mount, NC",16,3,3,1.0,Strangulation - hanging,0
19542596,1,Rural Georgia,12,3,3,1.0,Poison - does not include gas,0
20476181,1,"Monroe, LA",8,3,3,1.0,"Narcotics or drugs, sleeping pills",0
20735326,2,"Chattanooga, TN-GA",8,3,3,1.0,"Narcotics or drugs, sleeping pills",0
21084832,1,"Allentown-Bethlehem-Easton, PA-NJ",2,3,3,1.0,Drowning,0
21436486,2,"Cleveland-Elyria-Mentor, OH",2,3,3,1.0,Drowning,0
22573933,1,"Sandusky, OH",1,3,3,1.0,"Blunt object - hammer, club, etc",0
22591907,2,"Spokane, WA",8,3,3,1.0,"Narcotics or drugs, sleeping pills",0
22874718,1,"Grand Rapids-Wyoming, MI",9,3,3,1.0,Other gun,0
22915902,2,"Bloomington, IN",14,3,3,1.0,Rifle,0
23314775,2,"Bellingham, WA",5,3,3,1.0,"Firearm, type not stated",0
23762663,2,"Holland-Grand Haven, MI",15,3,3,1.0,Shotgun,0
24288937,2,"Lafayette, IN",15,3,3,1.0,Shotgun,0
24306593,1,"La Crosse, WI-MN",14,3,3,1.0,Rifle,0
24341361,1,"Lincoln, NE",14,3,3,1.0,Rifle,0
24502068,1,Rural Connecticut,14,3,3,1.0,Rifle,0
25177631,2,"Gulfport-Biloxi, MS",0,3,3,1.0,Asphyxiation - includes death by gas,0
25661564,2,"Santa Cruz-Watsonville, CA",0,3,3,1.0,Asphyxiation - includes death by gas,0
25837918,2,"Monroe, MI",14,3,3,1.0,Rifle,0
26125241,2,"Wheeling, WV-OH",1,3,3,1.0,"Blunt object - hammer, club, etc",0
26335168,1,"State College, PA",11,3,3,1.0,"Personal weapons, includes beating",0
26680230,2,"Raleigh-Cary, NC",8,3,3,1.0,"Narcotics or drugs, sleeping pills",0
27624884,1,"Poughkeepsie-Newburgh-Middletown, NY",8,3,3,1.0,"Narcotics or drugs, sleeping pills",0
27751894,2,"Columbus, IN",1,3,3,1.0,"Blunt object - hammer, club, etc",0
28149079,2,"Scranton--Wilkes-Barre, PA",3,3,3,1.0,Explosives,0
28684167,2,"New Orleans-Metairie-Kenner, LA",12,3,3,1.0,Poison - does not include gas,0
28969234,1,"Ocean City, NJ",15,3,3,1.0,Shotgun,0
29328315,1,"Canton-Massillon, OH",16,3,3,1.0,Strangulation - hanging,0
29953963,2,"Mansfield, OH",0,3,3,1.0,Asphyxiation - includes death by gas,0
30308668,2,Rural Vermont,8,3,3,1.0,"Narcotics or drugs, sleeping pills",0
30363268,1,"Greenville, NC",4,3,3,1.0,Fire,0
30438506,1,"Houma-Bayou Cane-Thibodaux, LA",2,3,3,1.0,Drowning,0
30741288,2,"Palm Bay-Melbourne-Titusville, FL",9,3,3,1.0,Other gun,0
30746156,2,"Lafayette, IN",16,3,3,1.0,Strangulation - hanging,0
31516532,1,"Syracuse, NY",2,3,3,1.0,Drowning,0
31862964,1,"Springfield, IL",14,3,3,1.0,Rifle,0
32171113,2,"Hagerstown-Martinsburg, MD-WV",0,3,3,1.0,Asphyxiation - includes death by gas,0
32263582,2,"Midland, TX",15,3,3,1.0,Shotgun,0
32541419,1,"Blacksburg-Christiansburg, VA",2,3,3,1.0,Drowning,0
33344471,9,"Richmond, VA",6,3,3,1.0,"Handgun - pistol, revolver, etc",0
33364012,1,"Scranton--Wilkes-Barre, PA",16,3,3,1.0,Strangulation - hanging,0
33916807,1,"St. George, UT",15,3,3,1.0,Shotgun,0
34498406,2,"Hattiesburg, MS",14,3,3,1.0,Rifle,0
34613388,1,"Tulsa, OK",12,3,3,1.0,Poison - does not include gas,0
34670100,2,"Salt Lake City, UT",4,3,3,1.0,Fire,0
34676621,1,"Lewiston, ID-WA",1,3,3,1.0,"Blunt object - hammer, club, etc",0
34681810,2,"Wichita Falls, TX",15,3,3,1.0,Shotgun,0
34970591,1,Rural New Mexico,4,3,3,1.0,Fire,0
35016881,2,"Elmira, NY",14,3,3,1.0,Rifle,0
35148473,1,"Sandusky, OH",15,3,3,1.0,Shotgun,0
35461310,9,Rural Mississippi,10,3,3,1.0,Other or type unknown,0
35587445,1,"Prescott, AZ",0,3,3,1.0,Asphyxiation - includes death by gas,0
36321658,1,"Appleton, WI",1,3,3,1.0,"Blunt object - hammer, club, etc",0
36382326,2,"Morgantown, WV",10,3,3,1.0,Other or type unknown,0
36420707,2,"Florence-Muscle Shoals, AL",5,3,3,1.0,"Firearm, type not stated",0
36526801,2,Rural North Carolina,12,3,3,1.0,Poison - does not include gas,0
37208203,2,Rural Ohio,9,3,3,1.0,Other gun,0
37869830,1,"Muskegon-Norton Shores, MI",4,3,3,1.0,Fire,0
38560571,9,"Florence-Muscle Shoals, AL",5,3,3,1.0,"Firearm, type not stated",0
38999918,2,"Pensacola-Ferry Pass-Brent, FL",14,3,3,1.0,Rifle,0
40118361,1,"Missoula, MT",5,3,3,1.0,"Firearm, type not stated",0
40636909,2,"Lubbock, TX",15,3,3,1.0,Shotgun,0
41002425,1,"Visalia-Porterville, CA",8,3,3,1.0,"Narcotics or drugs, sleeping pills",0
41126150,2,"Kankakee-Bradley, IL",4,3,3,1.0,Fire,0
41139278,2,"Brunswick, GA",5,3,3,1.0,"Firearm, type not stated",0
41202289,1,"Medford, OR",15,3,3,1.0,Shotgun,0
41316199,1,"Casper, WY",15,3,3,1.0,Shotgun,0
41382196,1,"Minneapolis-St. Paul-Bloomington, MN-WI",13,3,3,1.0,Pushed or thrown out window,0
41521380,2,Rural Delaware,0,3,3,1.0,Asphyxiation - includes death by gas,0
41638571,2,"Lafayette, LA",5,3,3,1.0,"Firearm, type not stated",0
41645715,1,"Provo-Orem, UT",4,3,3,1.0,Fire,0
41764958,2,"Coeur d Alene, ID",1,3,3,1.0,"Blunt object - hammer, club, etc",0
42342881,1,"El Centro, CA",8,3,3,1.0,"Narcotics or drugs, sleeping pills",0
42824341,2,"State College, PA",10,3,3,1.0,Other or type unknown,0
43318663,2,"Cedar Rapids, IA",0,3,3,1.0,Asphyxiation - includes death by gas,0
43321292,2,"Reading, PA",0,3,3,1.0,Asphyxiation - includes death by gas,0
43420555,1,"Farmington, NM",15,3,3,1.0,Shotgun,0
44342600,1,Rural Missouri,2,3,3,1.0,Drowning,0
44531323,1,"Elmira, NY",15,3,3,1.0,Shotgun,0
44759085,2,"Phoenix-Mesa-Scottsdale, AZ",12,3,3,1.0,Poison - does not include gas,0
44775864,2,"Lafayette, IN",14,3,3,1.0,Rifle,0
44980987,1,"Youngstown-Warren-Boardman, OH-PA",8,3,3,1.0,"Narcotics or drugs, sleeping pills",0
44993604,2,"Hattiesburg, MS",15,3,3,1.0,Shotgun,0
45013310,2,"Grand Forks, ND-MN",11,3,3,1.0,"Personal weapons, includes beating",0
45392961,2,"Minneapolis-St. Paul-Bloomington, MN-WI",3,3,3,1.0,Explosives,0
45665682,2,"Killeen-Temple-Fort Hood, TX",0,3,3,1.0,Asphyxiation - includes death by gas,0
45689132,2,"Gadsden, AL",15,3,3,1.0,Shotgun,0
45975099,2,"Cedar Rapids, IA",14,3,3,1.0,Rifle,0
46018650,2,"Joplin, MO",0,3,3,1.0,Asphyxiation - includes death by gas,0
46118368,1,Rural North Dakota,0,3,3,1.0,Asphyxiation - includes death by gas,0
46521205,2,"Ocean City, NJ",0,3,3,1.0,Asphyxiation - includes death by gas,0
46708198,1,"St. Joseph, MO-KS",0,3,3,1.0,Asphyxiation - includes death by gas,0
47044456,2,"Wichita, KS",8,3,3,1.0,"Narcotics or drugs, sleeping pills",0
47082303,2,"Buffalo-Niagara Falls, NY",8,3,3,1.0,"Narcotics or drugs, sleeping pills",0
47252078,2,"Bangor, ME",14,3,3,1.0,Rifle,0
47319375,1,"Lincoln, NE",9,3,3,1.0,Other gun,0
47478424,1,"Ocean City, NJ",1,3,3,1.0,"Blunt object - hammer, club, etc",0
47532312,1,"Sioux Falls, SD",15,3,3,1.0,Shotgun,0
47572056,2,Rural Idaho,8,3,3,1.0,"Narcotics or drugs, sleeping pills",0
47614699,2,"Grand Junction, CO",15,3,3,1.0,Shotgun,0
47871652,2,"Pueblo, CO",4,3,3,1.0,Fire,0
48308672,2,"McAllen-Edinburg-Mission, TX",2,3,3,1.0,Drowning,0
48576271,2,"Lynchburg, VA",4,3,3,1.0,Fire,0
49321143,1,"Fargo, ND-MN",15,3,3,1.0,Shotgun,0
50122600,1,"Williamsport, PA",1,3,3,1.0,"Blunt object - hammer, club, etc",0
50264385,2,"Dubuque, IA",11,3,3,1.0,"Personal weapons, includes beating",0
50638464,2,"Waterloo-Cedar Falls, IA",4,3,3,1.0,Fire,0
51007663,1,"Minneapolis-St. Paul-Bloomington, MN-WI",12,3,3,1.0,Poison - does not include gas,0
51167166,2,"Prescott, AZ",5,3,3,1.0,"Firearm, type not stated",0
51216318,2,"Vero Beach, FL",14,3,3,1.0,Rifle,0
51389213,2,"Riverside-San Bernardino, CA",12,3,3,1.0,Poison - does not include gas,0
51997339,2,"Rochester, NY",2,3,3,1.0,Drowning,0
52442385,1,"Ithaca, NY",15,3,3,1.0,Shotgun,0
52837721,1,"Rome, GA",4,3,3,1.0,Fire,0
53169497,9,"Albuquerque, NM",6,3,3,1.0,"Handgun - pistol, revolver, etc",0
53341656,2,"St. Louis, MO-IL",12,3,3,1.0,Poison - does not include gas,0
53345043,1,"Great Falls, MT",10,3,3,1.0,Other or type unknown,0
54063626,1,"Eau Claire, WI",5,3,3,1.0,"Firearm, type not stated",0
54152994,2,"Pittsfield, MA",6,3,3,1.0,"Handgun - pistol, revolver, etc",0
54367668,2,"Logan, UT-ID",11,3,3,1.0,"Personal weapons, includes beating",0
54398929,2,"Panama City-Lynn Haven, FL",4,3,3,1.0,Fire,0
54688716,1,"Lake Charles, LA",16,3,3,1.0,Strangulation - hanging,0
54846178,2,"Glens Falls, NY",15,3,3,1.0,Shotgun,0
55004892,1,"La Crosse, WI-MN",11,3,3,1.0,"Personal weapons, includes beating",0
55084234,2,"Vallejo-Fairfield, CA",2,3,3,1.0,Drowning,0
55143210,2,"Tallahassee, FL",16,3,3,1.0,Strangulation - hanging,0
55167838,2,Rural Oklahoma,12,3,3,1.0,Poison - does not include gas,0
55237984,1,"Cleveland, TN",8,3,3,1.0,"Narcotics or drugs, sleeping pills",0
55442941,1,Rural Indiana,9,3,3,1.0,Other gun,0
56062336,2,"Laredo, TX",1,3,3,1.0,"Blunt object - hammer, club, etc",0
56909777,1,"Salt Lake City, UT",16,3,3,1.0,Strangulation - hanging,0
57344097,1,"Vallejo-Fairfield, CA",2,3,3,1.0,Drowning,0
58100810,2,"Green Bay, WI",8,3,3,1.0,"Narcotics or drugs, sleeping pills",0
58145776,2,"Harrisonburg, VA",14,3,3,1.0,Rifle,0
58789470,1,"Boise City-Nampa, ID",9,3,3,1.0,Other gun,0
58910378,2,"Morristown, TN",10,3,3,1.0,Other or type unknown,0
59004116,2,"Weirton-Steubenville, WV-OH",10,3,3,1.0,Other or type unknown,0
59069946,1,"Bloomington, IN",15,3,3,1.0,Shotgun,0
59400994,1,"Corvallis, OR",7,3,3,1.0,Knife or cutting instrument,0
59578896,2,Rural New Hampshire,8,3,3,1.0,"Narcotics or drugs, sleeping pills",0
59688367,1,"Fairbanks, AK",14,3,3,1.0,Rifle,0
59926377,1,"Merced, CA",9,3,3,1.0,Other gun,0
60000002,2,"Elmira, NY",6,3,3,1.0,"Handgun - pistol, revolver, etc",0
60392135,2,"Barnstable Town, MA",0,3,3,1.0,Asphyxiation - includes death by gas,0
60425709,1,Rural Texas,3,3,3,1.0,Explosives,0
60609178,1,"Sheboygan, WI",14,3,3,1.0,Rifle,0
61115961,1,"Coeur d Alene, ID",8,3,3,1.0,"Narcotics or drugs, sleeping pills",0
61174880,2,Rural South Carolina,9,3,3,1.0,Other gun,0
61570130,1,"Williamsport, PA",15,3,3,1.0,Shotgun,0
61579548,2,"Hanford-Corcoran, CA",15,3,3,1.0,Shotgun,0
61806667,1,"Bremerton-Silverdale, WA",8,3,3,1.0,"Narcotics or drugs, sleeping pills",0
62024725,1,"Cedar Rapids, IA",4,3,3,1.0,Fire,0
62495526,2,"Springfield, OH",2,3,3,1.0,Drowning,0
62729174,2,"Corpus Christi, TX",0,3,3,1.0,Asphyxiation - includes death by gas,0
63759164,2,"Dubuque, IA",6,3,3,1.0,"Handgun - pistol, revolver, etc",0
63771685,1,"Fond du Lac, WI",8,3,3,1.0,"Narcotics or drugs, sleeping pills",0
64038303,1,"Ann Arbor, MI",16,3,3,1.0,Strangulation - hanging,0
64209085,1,"Baton Rouge, LA",2,3,3,1.0,Drowning,0
64261210,1,Rural Maryland,9,3,3,1.0,Other gun,0
64599054,2,"Lima, OH",15,3,3,1.0,Shotgun,0
64660371,2,"Bellingham, WA",14,3,3,1.0,Rifle,0
64939244,2,"Yuma, AZ",4,3,3,1.0,Fire,0
65026178,2,Rural Connecticut,1,3,3,1.0,"Blunt object - hammer, club, etc",0
65049745,1,"Ogden-Clearfield, UT",4,3,3,1.0,Fire,0
65253666,1,"Bloomington-Normal, IL",14,3,3,1.0,Rifle,0
66016815,2,"Lafayette, IN",1,3,3,1.0,"Blunt object - hammer, club, etc",0
66142540,1,"Colorado Springs, CO",8,3,3,1.0,"Narcotics or drugs, sleeping pills",0
66859724,1,"Jefferson City, MO",11,3,3,1.0,"Personal weapons, includes beating",0
67672283,2,"Port St. Lucie-Fort Pierce, FL",16,3,3,1.0,Strangulation - hanging,0
67731313,2,"Brunswick, GA",14,3,3,1.0,Rifle,0
67982455,2,"Winchester, VA-WV",5,3,3,1.0,"Firearm, type not stated",0
68438114,1,"Williamsport, PA",4,3,3,1.0,Fire,0
68648612,2,"Jackson, TN",14,3,3,1.0,Rifle,0
68797968,2,"Appleton, WI",15,3,3,1.0,Shotgun,0
68922972,2,"Cheyenne, WY",14,3,3,1.0,Rifle,0
69149255,1,"Owensboro, KY",0,3,3,1.0,Asphyxiation - includes death by gas,0
69559694,2,"Fort Smith, AR-OK",4,3,3,1.0,Fire,0
69872907,2,"Billings, MT",16,3,3,1.0,Strangulation - hanging,0
70164760,2,"Holland-Grand Haven, MI",11,3,3,1.0,"Personal weapons, includes beating",0
70300134,2,"Myrtle Beach-Conway, SC",0,3,3,1.0,Asphyxiation - includes death by gas,0
70601660,1,"Houston-Sugar Land-Baytown, TX",12,3,3,1.0,Poison - does not include gas,0
70673086,2,"Muskegon-Norton Shores, MI",14,3,3,1.0,Rifle,0
70831139,2,"Dubuque, IA",16,3,3,1.0,Strangulation - hanging,0
71092665,2,"Logan, UT-ID",14,3,3,1.0,Rifle,0
71726792,2,"Providence-New Bedford-Fall River, RI-MA",3,3,3,1.0,Explosives,0
71983080,1,"Columbus, IN",11,3,3,1.0,"Personal weapons, includes beating",0
72030444,2,"Winchester, VA-WV",14,3,3,1.0,Rifle,0
72537945,1,"Longview, WA",14,3,3,1.0,Rifle,0
72986369,1,"Abilene, TX",16,3,3,1.0,Strangulation - hanging,0
73159094,1,"Fairbanks, AK",15,3,3,1.0,Shotgun,0
73394335,2,"Blacksburg-Christiansburg, VA",8,3,3,1.0,"Narcotics or drugs, sleeping pills",0
74914814,1,"Columbus, OH",12,3,3,1.0,Poison - does not include gas,0
75518718,2,"Kansas City, MO-KS",13,3,3,1.0,Pushed or thrown out window,0
75570521,2,"Santa Barbara-Santa Maria, CA",2,3,3,1.0,Drowning,0
75585122,1,"Punta Gorda, FL",14,3,3,1.0,Rifle,0
75695070,2,Rural New Mexico,4,3,3,1.0,Fire,0
75765284,1,Rural Oregon,2,3,3,1.0,Drowning,0
76058973,1,"State College, PA",1,3,3,1.0,"Blunt object - hammer, club, etc",0
76205711,1,"Barnstable Town, MA",14,3,3,1.0,Rifle,0
76636363,1,"Kennewick-Richland-Pasco, WA",2,3,3,1.0,Drowning,0
76705090,2,"Janesville, WI",15,3,3,1.0,Shotgun,0
77533578,1,"Amarillo, TX",8,3,3,1.0,"Narcotics or drugs, sleeping pills",0
77805910,2,"Flagstaff, AZ",5,3,3,1.0,"Firearm, type not stated",0
78093628,9,"Houston-Sugar Land-Baytown, TX",4,3,3,1.0,Fire,0
79271687,1,"Gainesville, GA",4,3,3,1.0,Fire,0
79639831,2,"Springfield, IL",4,3,3,1.0,Fire,0
79734381,2,"Decatur, AL",8,3,3,1.0,"Narcotics or drugs, sleeping pills",0
79907931,2,"Reading, PA",4,3,3,1.0,Fire,0
80247502,2,"Duluth, MN-WI",8,3,3,1.0,"Narcotics or drugs, sleeping pills",0
80535943,2,"Napa, CA",10,3,3,1.0,Other or type unknown,0
80714216,1,"Charlottesville, VA",4,3,3,1.0,Fire,0
81417898,2,"Parkersburg-Marietta-Vienna, WV-OH",14,3,3,1.0,Rifle,0
81536823,1,"Fort Wayne, IN",8,3,3,1.0,"Narcotics or drugs, sleeping pills",0
81696091,1,"Prescott, AZ",5,3,3,1.0,"Firearm, type not stated",0
81761301,1,"Napa, CA",15,3,3,1.0,Shotgun,0
81909380,2,"Lima, OH",14,3,3,1.0,Rifle,0
82163997,2,"Cumberland, MD-WV",10,3,3,1.0,Other or type unknown,0
82184417,2,"Sherman-Denison, TX",14,3,3,1.0,Rifle,0
82807126,2,"Myrtle Beach-Conway, SC",16,3,3,1.0,Strangulation - hanging,0
82847008,2,"Wheeling, WV-OH",8,3,3,1.0,"Narcotics or drugs, sleeping pills",0
83548532,1,"Syracuse, NY",12,3,3,1.0,Poison - does not include gas,0
83721788,2,"Pocatello, ID",11,3,3,1.0,"Personal weapons, includes beating",0
84519906,1,"Oklahoma City, OK",2,3,3,1.0,Drowning,0
84673205,9,"Minneapolis-St. Paul-Bloomington, MN-WI",6,3,3,1.0,"Handgun - pistol, revolver, etc",0
84774485,2,"Binghamton, NY",16,3,3,1.0,Strangulation - hanging,0
84897775,2,"Ames, IA",11,3,3,1.0,"Personal weapons, includes beating",0
84964969,1,"Johnstown, PA",8,3,3,1.0,"Narcotics or drugs, sleeping pills",0
85358547,1,"Michigan City-La Porte, IN",4,3,3,1.0,Fire,0
85527064,1,"Richmond, VA",2,3,3,1.0,Drowning,0
85676707,2,"San Luis Obispo-Paso Robles, CA",2,3,3,1.0,Drowning,0
86145616,2,"Reading, PA",12,3,3,1.0,Poison - does not include gas,0
86200663,2,"Sheboygan, WI",11,3,3,1.0,"Personal weapons, includes beating",0
86228129,2,"Wheeling, WV-OH",15,3,3,1.0,Shotgun,0
86550283,1,Rural North Carolina,13,3,3,1.0,Pushed or thrown out window,0
87874313,1,Rural South Dakota,0,3,3,1.0,Asphyxiation - includes death by gas,0
88196964,1,"Scranton--Wilkes-Barre, PA",0,3,3,1.0,Asphyxiation - includes death by gas,0
88309425,2,"Madison, WI",16,3,3,1.0,Strangulation - hanging,0
88327620,2,"Bremerton-Silverdale, WA",14,3,3,1.0,Rifle,0
88337943,2,"Athens-Clarke County, GA",8,3,3,1.0,"Narcotics or drugs, sleeping pills",0
88355347,2,"Decatur, AL",16,3,3,1.0,Strangulation - hanging,0
88780544,1,"Binghamton, NY",0,3,3,1.0,Asphyxiation - includes death by gas,0
89257250,1,Rural Kentucky,2,3,3,1.0,Drowning,0
89434221,2,"Corvallis, OR",15,3,3,1.0,Shotgun,0
89499304,2,"Bellingham, WA",15,3,3,1.0,Shotgun,0
89621979,2,"Gainesville, FL",4,3,3,1.0,Fire,0
90372159,2,"Longview, WA",14,3,3,1.0,Rifle,0
91148932,2,"Charlotte-Gastonia-Concord, NC-SC",2,3,3,1.0,Drowning,0
91177081,2,Rural Maryland,4,3,3,1.0,Fire,0
91242081,1,"Eugene-Springfield, OR",16,3,3,1.0,Strangulation - hanging,0
91687579,1,Rural Wisconsin,16,3,3,1.0,Strangulation - hanging,0
91744234,2,"Elkhart-Goshen, IN",15,3,3,1.0,Shotgun,0
91911544,2,"Oxnard-Thousand Oaks-Ventura, CA",4,3,3,1.0,Fire,0
91919347,2,"Grand Forks, ND-MN",14,3,3,1.0,Rifle,0
92176190,2,"Atlantic City, NJ",14,3,3,1.0,Rifle,0
92217756,1,"Pensacola-Ferry Pass-Brent, FL",8,3,3,1.0,"Narcotics or drugs, sleeping pills",0
92727221,2,"Cleveland, TN",15,3,3,1.0,Shotgun,0
92821464,2,"Bend, OR",5,3,3,1.0,"Firearm, type not stated",0
93418322,1,"Laredo, TX",9,3,3,1.0,Other gun,0
93645435,1,"Deltona-Daytona Beach-Ormond Beach, FL",16,3,3,1.0,Strangulation - hanging,0
94027386,1,"Dubuque, IA",7,3,3,1.0,Knife or cutting instrument,0
94134294,1,Rural Texas,13,3,3,1.0,Pushed or thrown out window,0
94401707,2,"Sandusky, OH",11,3,3,1.0,"Personal weapons, includes beating",0
94572718,2,"Danville, VA",8,3,3,1.0,"Narcotics or drugs, sleeping pills",0
95032258,1,"Roanoke, VA",16,3,3,1.0,Strangulation - hanging,0
95073025,1,"Grand Junction, CO",15,3,3,1.0,Shotgun,0
95091945,2,"Topeka, KS",4,3,3,1.0,Fire,0
95329710,1,"Charleston-North Charleston, SC",16,3,3,1.0,Strangulation - hanging,0
95556825,2,"Sioux Falls, SD",16,3,3,1.0,Strangulation - hanging,0
95749351,1,"Elizabethtown, KY",8,3,3,1.0,"Narcotics or drugs, sleeping pills",0
95777168,2,"Elizabethtown, KY",14,3,3,1.0,Rifle,0
95993150,1,"Ithaca, NY",17,3,3,1.0,Weapon Not Reported,0
96469288,1,"Terre Haute, IN",16,3,3,1.0,Strangulation - hanging,0
96850303,2,"Missoula, MT",0,3,3,1.0,Asphyxiation - includes death by gas,0
97258879,1,"Wichita Falls, TX",0,3,3,1.0,Asphyxiation - includes death by gas,0
97283076,2,"Green Bay, WI",0,3,3,1.0,Asphyxiation - includes death by gas,0
97302715,2,"Joplin, MO",5,3,3,1.0,"Firearm, type not stated",0
97512001,2,"Jacksonville, FL",8,3,3,1.0,"Narcotics or drugs, sleeping pills",0
97789286,1,Rural Wisconsin,2,3,3,1.0,Drowning,0
97901732,1,Rural Wyoming,8,3,3,1.0,"Narcotics or drugs, sleeping pills",0
98173560,2,"Burlington, NC",5,3,3,1.0,"Firearm, type not stated",0
99186014,1,"Youngstown-Warren-Boardman, OH-PA",0,3,3,1.0,Asphyxiation - includes death by gas,0
99258503,2,"Hickory-Lenoir-Morganton, NC",8,3,3,1.0,"Narcotics or drugs, sleeping pills",0
99281386,2,Rural Maryland,8,3,3,1.0,"Narcotics or drugs, sleeping pills",0
99360806,2,"State College, PA",14,3,3,1.0,Rifle,0
193098,2,"Hickory-Lenoir-Morganton, NC",4,2,2,1.0,Fire,0
475470,2,"Kalamazoo-Portage, MI",8,2,2,1.0,"Narcotics or drugs, sleeping pills",0
515634,1,Rural North Carolina,12,2,2,1.0,Poison - does not include gas,0
534555,1,"Hagerstown-Martinsburg, MD-WV",2,2,2,1.0,Drowning,0
759413,2,Rural South Dakota,4,2,2,1.0,Fire,0
1052268,1,"San Antonio, TX",12,2,2,1.0,Poison - does not include gas,0
1130826,2,"Fond du Lac, WI",1,2,2,1.0,"Blunt object - hammer, club, etc",0
1135228,1,"Pocatello, ID",16,2,2,1.0,Strangulation - hanging,0
1147545,2,"Charlotte-Gastonia-Concord, NC-SC",12,2,2,1.0,Poison - does not include gas,0
1191714,1,"Owensboro, KY",8,2,2,1.0,"Narcotics or drugs, sleeping pills",0
1409499,2,"Los Angeles-Long Beach, CA",13,2,2,1.0,Pushed or thrown out window,0
1520788,1,"Allentown-Bethlehem-Easton, PA-NJ",3,2,2,1.0,Explosives,0
1562518,2,"Hot Springs, AR",14,2,2,1.0,Rifle,0
1588887,1,"Danville, IL",1,2,2,1.0,"Blunt object - hammer, club, etc",0
1633666,2,"Atlantic City, NJ",8,2,2,1.0,"Narcotics or drugs, sleeping pills",0
1670427,1,"Columbia, MO",8,2,2,1.0,"Narcotics or drugs, sleeping pills",0
1770192,1,"Binghamton, NY",16,2,2,1.0,Strangulation - hanging,0
2069345,1,"Davenport-Moline-Rock Island, IA-IL",0,2,2,1.0,Asphyxiation - includes death by gas,0
2357232,9,"Alexandria, LA",10,2,2,1.0,Other or type unknown,0
2359717,1,"Anchorage, AK",0,2,2,1.0,Asphyxiation - includes death by gas,0
2360178,2,"Deltona-Daytona Beach-Ormond Beach, FL",9,2,2,1.0,Other gun,0
2831826,1,Rural Oregon,13,2,2,1.0,Pushed or thrown out window,0
3015935,2,"Bend, OR",15,2,2,1.0,Shotgun,0
3761161,2,"Racine, WI",1,2,2,1.0,"Blunt object - hammer, club, etc",0
3779722,2,"Lubbock, TX",4,2,2,1.0,Fire,0
3919946,1,"Worcester, MA",0,2,2,1.0,Asphyxiation - includes death by gas,0
3942747,1,"Yuma, AZ",4,2,2,1.0,Fire,0
4052934,1,"Gainesville, GA",8,2,2,1.0,"Narcotics or drugs, sleeping pills",0
4263526,9,"Tuscaloosa, AL",5,2,2,1.0,"Firearm, type not stated",0
4349096,2,"Philadelphia-Camden-Wilmington, PA-NJ-DE",13,2,2,1.0,Pushed or thrown out window,0
4354492,2,"Lakeland, FL",0,2,2,1.0,Asphyxiation - includes death by gas,0
4442334,2,"Dothan, AL",4,2,2,1.0,Fire,0
4497536,2,"Missoula, MT",10,2,2,1.0,Other or type unknown,0
4582175,9,"Anniston-Oxford, AL",6,2,2,1.0,"Handgun - pistol, revolver, etc",0
5063206,2,"Jackson, MI",14,2,2,1.0,Rifle,0
5905644,1,"Augusta-Richmond County, GA-SC",8,2,2,1.0,"Narcotics or drugs, sleeping pills",0
6058490,2,"Myrtle Beach-Conway, SC",8,2,2,1.0,"Narcotics or drugs, sleeping pills",0
6181539,2,"Fond du Lac, WI",14,2,2,1.0,Rifle,0
6444826,1,"Lansing-East Lansing, MI",2,2,2,1.0,Drowning,0
6624626,2,"Augusta-Richmond County, GA-SC",2,2,2,1.0,Drowning,0
6650044,2,"Chico, CA",0,2,2,1.0,Asphyxiation - includes death by gas,0
6739693,9,"Dallas-Fort Worth-Arlington, TX",11,2,2,1.0,"Personal weapons, includes beating",0
6977973,2,Rural Maine,4,2,2,1.0,Fire,0
7438181,2,"Madera, CA",14,2,2,1.0,Rifle,0
7723632,2,"Erie, PA",2,2,2,1.0,Drowning,0
7927243,2,"St. Joseph, MO-KS",0,2,2,1.0,Asphyxiation - includes death by gas,0
7954320,2,"Honolulu, HI",13,2,2,1.0,Pushed or thrown out window,0
7970398,1,"Corpus Christi, TX",2,2,2,1.0,Drowning,0
8243896,2,"Wilmington, NC",8,2,2,1.0,"Narcotics or drugs, sleeping pills",0
8267503,2,"Boulder, CO",5,2,2,1.0,"Firearm, type not stated",0
8430221,1,"Valdosta, GA",4,2,2,1.0,Fire,0
8517587,2,"Oshkosh-Neenah, WI",0,2,2,1.0,Asphyxiation - includes death by gas,0
8657099,2,"Albany-Schenectady-Troy, NY",8,2,2,1.0,"Narcotics or drugs, sleeping pills",0
8875632,2,"Holland-Grand Haven, MI",4,2,2,1.0,Fire,0
8942083,2,"Santa Cruz-Watsonville, CA",14,2,2,1.0,Rifle,0
9205881,2,"Mount Vernon-Anacortes, WA",8,2,2,1.0,"Narcotics or drugs, sleeping pills",0
9557333,2,"Williamsport, PA",5,2,2,1.0,"Firearm, type not stated",0
9676914,2,"Oxnard-Thousand Oaks-Ventura, CA",2,2,2,1.0,Drowning,0
9854750,2,"Brownsville-Harlingen, TX",9,2,2,1.0,Other gun,0
9884883,2,"Jefferson City, MO",14,2,2,1.0,Rifle,0
10062250,1,Rural Nevada,16,2,2,1.0,Strangulation - hanging,0
10363273,2,"Olympia, WA",8,2,2,1.0,"Narcotics or drugs, sleeping pills",0
10512863,1,"Florence, SC",0,2,2,1.0,Asphyxiation - includes death by gas,0
10648227,1,"Madison, WI",4,2,2,1.0,Fire,0
10658736,2,Rural New York,12,2,2,1.0,Poison - does not include gas,0
10926429,2,"Wausau, WI",5,2,2,1.0,"Firearm, type not stated",0
11580369,1,"Bloomington-Normal, IL",16,2,2,1.0,Strangulation - hanging,0
11601687,1,"Columbia, MO",2,2,2,1.0,Drowning,0
11682267,2,"Olympia, WA",14,2,2,1.0,Rifle,0
11720716,1,"Decatur, IL",9,2,2,1.0,Other gun,0
12195822,1,"Texarkana, TX-Texarkana, AR",2,2,2,1.0,Drowning,0
12328939,2,Rural New Mexico,3,2,2,1.0,Explosives,0
12401406,2,"Lakeland, FL",8,2,2,1.0,"Narcotics or drugs, sleeping pills",0
12567421,2,"Decatur, IL",15,2,2,1.0,Shotgun,0
12690516,1,"Eau Claire, WI",2,2,2,1.0,Drowning,0
12840678,1,"Memphis, TN-MS-AR",13,2,2,1.0,Pushed or thrown out window,0
13007154,2,Rural Missouri,2,2,2,1.0,Drowning,0
13079092,2,"Orlando-Kissimmee, FL",12,2,2,1.0,Poison - does not include gas,0
13090265,1,"Missoula, MT",0,2,2,1.0,Asphyxiation - includes death by gas,0
13143875,1,"Charleston-North Charleston, SC",2,2,2,1.0,Drowning,0
13325218,2,"Indianapolis, IN",2,2,2,1.0,Drowning,0
13550324,1,"Anchorage, AK",9,2,2,1.0,Other gun,0
13786203,9,"Holland-Grand Haven, MI",10,2,2,1.0,Other or type unknown,0
14116427,1,"Jonesboro, AR",9,2,2,1.0,Other gun,0
14205244,2,"Birmingham-Hoover, AL",0,2,2,1.0,Asphyxiation - includes death by gas,0
14270828,1,"Appleton, WI",10,2,2,1.0,Other or type unknown,0
14436886,1,"Appleton, WI",5,2,2,1.0,"Firearm, type not stated",0
14473013,2,"Bowling Green, KY",15,2,2,1.0,Shotgun,0
14580845,2,Rural Wisconsin,3,2,2,1.0,Explosives,0
14815979,2,"Sioux Falls, SD",14,2,2,1.0,Rifle,0
15164488,1,"Mansfield, OH",14,2,2,1.0,Rifle,0
15175808,1,Rural Idaho,16,2,2,1.0,Strangulation - hanging,0
15217776,1,"Columbus, GA-AL",9,2,2,1.0,Other gun,0
15385477,9,"Houston-Sugar Land-Baytown, TX",7,2,2,1.0,Knife or cutting instrument,0
15445272,2,"Little Rock-North Little Rock, AR",2,2,2,1.0,Drowning,0
15692570,1,Rural Mississippi,12,2,2,1.0,Poison - does not include gas,0
15941748,1,"Ogden-Clearfield, UT",8,2,2,1.0,"Narcotics or drugs, sleeping pills",0
15986945,1,"Kankakee-Bradley, IL",14,2,2,1.0,Rifle,0
15990342,1,"Burlington-South Burlington, VT",15,2,2,1.0,Shotgun,0
16516622,2,"Savannah, GA",2,2,2,1.0,Drowning,0
16611821,1,Rural Pennsylvania,3,2,2,1.0,Explosives,0
16679721,2,"Denver-Aurora, CO",12,2,2,1.0,Poison - does not include gas,0
16859660,1,"Naples-Marco Island, FL",8,2,2,1.0,"Narcotics or drugs, sleeping pills",0
16995032,2,"Pocatello, ID",1,2,2,1.0,"Blunt object - hammer, club, etc",0
17061823,2,Rural Wyoming,2,2,2,1.0,Drowning,0
17073633,1,"Kalamazoo-Portage, MI",9,2,2,1.0,Other gun,0
17419748,2,"Pittsfield, MA",1,2,2,1.0,"Blunt object - hammer, club, etc",0
17505344,2,"Norwich-New London, CT",14,2,2,1.0,Rifle,0
17654559,2,"Sioux City, IA-NE-SD",14,2,2,1.0,Rifle,0
18354116,1,"Winston-Salem, NC",8,2,2,1.0,"Narcotics or drugs, sleeping pills",0
18388175,9,"Columbus, OH",11,2,2,1.0,"Personal weapons, includes beating",0
18553296,2,"St. Cloud, MN",16,2,2,1.0,Strangulation - hanging,0
19132478,2,"Abilene, TX",14,2,2,1.0,Rifle,0
19574545,1,"Logan, UT-ID",10,2,2,1.0,Other or type unknown,0
19714701,2,"Laredo, TX",0,2,2,1.0,Asphyxiation - includes death by gas,0
19742592,2,"Peoria, IL",14,2,2,1.0,Rifle,0
20169645,1,"Santa Fe, NM",2,2,2,1.0,Drowning,0
20257234,2,Rural Massachusetts,10,2,2,1.0,Other or type unknown,0
20486427,1,"Killeen-Temple-Fort Hood, TX",16,2,2,1.0,Strangulation - hanging,0
20675087,1,"Saginaw, MI",0,2,2,1.0,Asphyxiation - includes death by gas,0
20707280,1,"Cumberland, MD-WV",5,2,2,1.0,"Firearm, type not stated",0
20717756,1,Rural Washington,9,2,2,1.0,Other gun,0
20756842,1,"Columbia, SC",2,2,2,1.0,Drowning,0
20889685,2,"Topeka, KS",8,2,2,1.0,"Narcotics or drugs, sleeping pills",0
21139703,1,"Peoria, IL",0,2,2,1.0,Asphyxiation - includes death by gas,0
21222241,2,"Durham, NC",0,2,2,1.0,Asphyxiation - includes death by gas,0
21229962,1,"Springfield, MO",12,2,2,1.0,Poison - does not include gas,0
21480785,2,"Eau Claire, WI",5,2,2,1.0,"Firearm, type not stated",0
21544170,1,"Tucson, AZ",13,2,2,1.0,Pushed or thrown out window,0
21613056,1,"Norwich-New London, CT",0,2,2,1.0,Asphyxiation - includes death by gas,0
21740823,1,Rural Maine,8,2,2,1.0,"Narcotics or drugs, sleeping pills",0
21756488,2,"Canton-Massillon, OH",0,2,2,1.0,Asphyxiation - includes death by gas,0
21801693,2,"Auburn-Opelika, AL",14,2,2,1.0,Rifle,0
22222071,1,"Eau Claire, WI",1,2,2,1.0,"Blunt object - hammer, club, etc",0
22824218,1,Rural Louisiana,12,2,2,1.0,Poison - does not include gas,0
22957216,1,"Chico, CA",0,2,2,1.0,Asphyxiation - includes death by gas,0
23363412,1,Rural Arkansas,12,2,2,1.0,Poison - does not include gas,0
23439683,1,"Stockton, CA",9,2,2,1.0,Other gun,0
23467677,1,"Rochester, MN",14,2,2,1.0,Rifle,0
23674254,1,"Ogden-Clearfield, UT",16,2,2,1.0,Strangulation - hanging,0
23753426,2,"Virginia Beach-Norfolk-Newport News, VA-NC",13,2,2,1.0,Pushed or thrown out window,0
23788825,2,"Jacksonville, FL",3,2,2,1.0,Explosives,0
24117630,1,"Davenport-Moline-Rock Island, IA-IL",8,2,2,1.0,"Narcotics or drugs, sleeping pills",0
24569243,2,"Auburn-Opelika, AL",1,2,2,1.0,"Blunt object - hammer, club, etc",0
24915001,2,"Wichita Falls, TX",14,2,2,1.0,Rifle,0
25146080,1,"Odessa, TX",12,2,2,1.0,Poison - does not include gas,0
25201684,2,"Omaha-Council Bluffs, NE-IA",2,2,2,1.0,Drowning,0
25386490,1,"Rochester, MN",0,2,2,1.0,Asphyxiation - includes death by gas,0
25876264,2,"Port St. Lucie-Fort Pierce, FL",4,2,2,1.0,Fire,0
26545113,2,"Fairbanks, AK",15,2,2,1.0,Shotgun,0
26585795,2,"State College, PA",15,2,2,1.0,Shotgun,0
26610195,2,"Longview, TX",4,2,2,1.0,Fire,0
26736870,1,"Huntsville, AL",0,2,2,1.0,Asphyxiation - includes death by gas,0
26889095,2,"Rochester, NY",17,2,2,1.0,Weapon Not Reported,0
26968846,2,"Lebanon, PA",15,2,2,1.0,Shotgun,0
27086819,1,"Idaho Falls, ID",15,2,2,1.0,Shotgun,0
27172600,1,"Glens Falls, NY",14,2,2,1.0,Rifle,0
27398942,2,"Bismarck, ND",14,2,2,1.0,Rifle,0
27517106,2,Rural Nebraska,8,2,2,1.0,"Narcotics or drugs, sleeping pills",0
28010770,2,"Lawton, OK",0,2,2,1.0,Asphyxiation - includes death by gas,0
28158520,1,Rural California,12,2,2,1.0,Poison - does not include gas,0
28207867,1,"Fort Smith, AR-OK",9,2,2,1.0,Other gun,0
28248607,2,"Bend, OR",9,2,2,1.0,Other gun,0
28289511,1,"Mansfield, OH",15,2,2,1.0,Shotgun,0
29426264,2,"Hattiesburg, MS",5,2,2,1.0,"Firearm, type not stated",0
29445940,9,"Wilmington, NC",6,2,2,1.0,"Handgun - pistol, revolver, etc",0
29519741,2,"Wenatchee, WA",15,2,2,1.0,Shotgun,0
30018573,2,"Gainesville, GA",0,2,2,1.0,Asphyxiation - includes death by gas,0
30028275,1,"Syracuse, NY",0,2,2,1.0,Asphyxiation - includes death by gas,0
30089849,9,"Columbus, OH",8,2,2,1.0,"Narcotics or drugs, sleeping pills",0
30239208,9,"San Diego-Carlsbad-San Marcos, CA",6,2,2,1.0,"Handgun - pistol, revolver, etc",0
30249770,1,"Santa Rosa-Petaluma, CA",2,2,2,1.0,Drowning,0
30309485,2,"Fairbanks, AK",4,2,2,1.0,Fire,0
30334306,2,Rural West Virginia,9,2,2,1.0,Other gun,0
30357465,2,"Odessa, TX",12,2,2,1.0,Poison - does not include gas,0
30721573,2,"Valdosta, GA",15,2,2,1.0,Shotgun,0
30745117,1,Rural South Dakota,8,2,2,1.0,"Narcotics or drugs, sleeping pills",0
30855003,2,"Idaho Falls, ID",14,2,2,1.0,Rifle,0
31169048,2,"Missoula, MT",11,2,2,1.0,"Personal weapons, includes beating",0
31692469,2,"Bay City, MI",9,2,2,1.0,Other gun,0
31804982,1,"Dover, DE",0,2,2,1.0,Asphyxiation - includes death by gas,0
32000659,2,"Mount Vernon-Anacortes, WA",15,2,2,1.0,Shotgun,0
32187057,2,"Great Falls, MT",15,2,2,1.0,Shotgun,0
32271484,2,"Portland-South Portland-Biddeford, ME",0,2,2,1.0,Asphyxiation - includes death by gas,0
32376158,2,"St. Cloud, MN",0,2,2,1.0,Asphyxiation - includes death by gas,0
32482726,2,"Rome, GA",14,2,2,1.0,Rifle,0
32711821,2,"Bangor, ME",16,2,2,1.0,Strangulation - hanging,0
32742185,1,"Napa, CA",3,2,2,1.0,Explosives,0
33069714,1,Rural Vermont,0,2,2,1.0,Asphyxiation - includes death by gas,0
33214215,9,"Dalton, GA",10,2,2,1.0,Other or type unknown,0
33341363,9,"Columbus, GA-AL",5,2,2,1.0,"Firearm, type not stated",0
33369382,2,"Weirton-Steubenville, WV-OH",14,2,2,1.0,Rifle,0
33419112,1,"Redding, CA",8,2,2,1.0,"Narcotics or drugs, sleeping pills",0
33445660,2,"Fairbanks, AK",1,2,2,1.0,"Blunt object - hammer, club, etc",0
33455839,1,"Salem, OR",13,2,2,1.0,Pushed or thrown out window,0
33726751,9,"Charlotte-Gastonia-Concord, NC-SC",11,2,2,1.0,"Personal weapons, includes beating",0
33822192,2,"Lawrence, KS",1,2,2,1.0,"Blunt object - hammer, club, etc",0
33839216,2,"Warner Robins, GA",15,2,2,1.0,Shotgun,0
33963170,2,"Dubuque, IA",0,2,2,1.0,Asphyxiation - includes death by gas,0
33973152,2,Rural Montana,16,2,2,1.0,Strangulation - hanging,0
34161714,2,"Goldsboro, NC",5,2,2,1.0,"Firearm, type not stated",0
34162683,1,"Panama City-Lynn Haven, FL",9,2,2,1.0,Other gun,0
34183157,2,Rural Arkansas,12,2,2,1.0,Poison - does not include gas,0
34380430,1,"Amarillo, TX",12,2,2,1.0,Poison - does not include gas,0
34456703,1,"Yakima, WA",8,2,2,1.0,"Narcotics or drugs, sleeping pills",0
34856718,2,"Green Bay, WI",4,2,2,1.0,Fire,0
34912327,1,"Memphis, TN-MS-AR",12,2,2,1.0,Poison - does not include gas,0
35120713,1,"Kingston, NY",8,2,2,1.0,"Narcotics or drugs, sleeping pills",0
35135028,1,"Dubuque, IA",1,2,2,1.0,"Blunt object - hammer, club, etc",0
35160882,1,"Florence, SC",8,2,2,1.0,"Narcotics or drugs, sleeping pills",0
35582251,2,"Augusta-Richmond County, GA-SC",8,2,2,1.0,"Narcotics or drugs, sleeping pills",0
35907041,1,"Flagstaff, AZ",0,2,2,1.0,Asphyxiation - includes death by gas,0
36325627,2,"Missoula, MT",1,2,2,1.0,"Blunt object - hammer, club, etc",0
36885698,1,"Vineland-Millville-Bridgeton, NJ",4,2,2,1.0,Fire,0
37034163,2,"Grand Forks, ND-MN",0,2,2,1.0,Asphyxiation - includes death by gas,0
37066729,1,"Terre Haute, IN",14,2,2,1.0,Rifle,0
37529834,2,Rural Michigan,9,2,2,1.0,Other gun,0
37546472,2,"Lynchburg, VA",9,2,2,1.0,Other gun,0
37550473,2,Rural Nevada,12,2,2,1.0,Poison - does not include gas,0
37571945,1,"Eugene-Springfield, OR",0,2,2,1.0,Asphyxiation - includes death by gas,0
37608841,2,"St. George, UT",5,2,2,1.0,"Firearm, type not stated",0
37884662,1,"Fayetteville-Springdale-Rogers, AR-MO",9,2,2,1.0,Other gun,0
38051876,2,"Tuscaloosa, AL",1,2,2,1.0,"Blunt object - hammer, club, etc",0
38179763,1,"South Bend-Mishawaka, IN-MI",0,2,2,1.0,Asphyxiation - includes death by gas,0
38481510,1,"Great Falls, MT",15,2,2,1.0,Shotgun,0
38549215,1,"Harrisonburg, VA",1,2,2,1.0,"Blunt object - hammer, club, etc",0
38583168,2,"Saginaw, MI",8,2,2,1.0,"Narcotics or drugs, sleeping pills",0
38606015,1,"Blacksburg-Christiansburg, VA",0,2,2,1.0,Asphyxiation - includes death by gas,0
38711455,1,"Killeen-Temple-Fort Hood, TX",8,2,2,1.0,"Narcotics or drugs, sleeping pills",0
38946297,2,"Oshkosh-Neenah, WI",10,2,2,1.0,Other or type unknown,0
39056877,2,"Louisville, KY-IN",2,2,2,1.0,Drowning,0
39147165,1,"San Antonio, TX",8,2,2,1.0,"Narcotics or drugs, sleeping pills",0
39192067,1,"St. George, UT",14,2,2,1.0,Rifle,0
39324247,2,"Vero Beach, FL",15,2,2,1.0,Shotgun,0
39435308,2,"Eau Claire, WI",1,2,2,1.0,"Blunt object - hammer, club, etc",0
40033548,1,"Knoxville, TN",16,2,2,1.0,Strangulation - hanging,0
40084018,2,"Tallahassee, FL",9,2,2,1.0,Other gun,0
40595008,1,"Oshkosh-Neenah, WI",1,2,2,1.0,"Blunt object - hammer, club, etc",0
40635749,2,"State College, PA",11,2,2,1.0,"Personal weapons, includes beating",0
40839491,1,"Kankakee-Bradley, IL",1,2,2,1.0,"Blunt object - hammer, club, etc",0
40989330,2,"Gainesville, GA",14,2,2,1.0,Rifle,0
41039064,1,"Ocala, FL",4,2,2,1.0,Fire,0
41085209,2,"Ogden-Clearfield, UT",4,2,2,1.0,Fire,0
41191136,2,Rural Vermont,4,2,2,1.0,Fire,0
41329448,1,"Medford, OR",0,2,2,1.0,Asphyxiation - includes death by gas,0
41681415,2,"Reno-Sparks, NV",15,2,2,1.0,Shotgun,0
41693241,1,"Scranton--Wilkes-Barre, PA",3,2,2,1.0,Explosives,0
42095455,2,"Winston-Salem, NC",0,2,2,1.0,Asphyxiation - includes death by gas,0
42242759,2,"Idaho Falls, ID",15,2,2,1.0,Shotgun,0
42479633,2,"Jacksonville, NC",0,2,2,1.0,Asphyxiation - includes death by gas,0
42682375,1,"Bloomington-Normal, IL",15,2,2,1.0,Shotgun,0
42818589,2,"Peoria, IL",8,2,2,1.0,"Narcotics or drugs, sleeping pills",0
43333272,1,"Odessa, TX",8,2,2,1.0,"Narcotics or drugs, sleeping pills",0
43689796,1,"Orlando-Kissimmee, FL",2,2,2,1.0,Drowning,0
43701166,1,"Corpus Christi, TX",9,2,2,1.0,Other gun,0
43703579,2,"Kankakee-Bradley, IL",11,2,2,1.0,"Personal weapons, includes beating",0
44210266,2,"Cedar Rapids, IA",4,2,2,1.0,Fire,0
44306047,2,"Niles-Benton Harbor, MI",8,2,2,1.0,"Narcotics or drugs, sleeping pills",0
44423969,2,"Evansville, IN-KY",16,2,2,1.0,Strangulation - hanging,0
44536818,1,"Modesto, CA",2,2,2,1.0,Drowning,0
44718737,2,"Albany-Schenectady-Troy, NY",2,2,2,1.0,Drowning,0
44941554,1,"Gadsden, AL",4,2,2,1.0,Fire,0
44943184,1,"Jackson, MS",3,2,2,1.0,Explosives,0
45414426,2,"Cleveland, TN",8,2,2,1.0,"Narcotics or drugs, sleeping pills",0
45550045,2,Rural Illinois,13,2,2,1.0,Pushed or thrown out window,0
45634324,2,"Grand Rapids-Wyoming, MI",9,2,2,1.0,Other gun,0
45675254,1,"Atlantic City, NJ",9,2,2,1.0,Other gun,0
45698211,2,"Anderson, SC",16,2,2,1.0,Strangulation - hanging,0
45706038,2,"San Diego-Carlsbad-San Marcos, CA",8,2,2,1.0,"Narcotics or drugs, sleeping pills",0
45728261,2,"Bay City, MI",5,2,2,1.0,"Firearm, type not stated",0
45752342,1,Rural Nebraska,8,2,2,1.0,"Narcotics or drugs, sleeping pills",0
45835964,2,Rural Tennessee,2,2,2,1.0,Drowning,0
45973680,1,"Coeur d Alene, ID",15,2,2,1.0,Shotgun,0
46321262,2,"Owensboro, KY",15,2,2,1.0,Shotgun,0
46354051,2,"Mount Vernon-Anacortes, WA",11,2,2,1.0,"Personal weapons, includes beating",0
46385576,1,"Hickory-Lenoir-Morganton, NC",4,2,2,1.0,Fire,0
46508776,9,"Tuscaloosa, AL",12,2,2,1.0,Poison - does not include gas,0
46836864,2,"Lewiston, ID-WA",0,2,2,1.0,Asphyxiation - includes death by gas,0
47016320,1,"Ames, IA",5,2,2,1.0,"Firearm, type not stated",0
47102856,1,"Wausau, WI",15,2,2,1.0,Shotgun,0
47320343,9,"Toledo, OH",7,2,2,1.0,Knife or cutting instrument,0
47367084,1,"Lake Charles, LA",9,2,2,1.0,Other gun,0
47531476,2,"Duluth, MN-WI",3,2,2,1.0,Explosives,0
47816802,1,"Sheboygan, WI",15,2,2,1.0,Shotgun,0
47961153,1,"Spokane, WA",9,2,2,1.0,Other gun,0
48315449,1,"Burlington-South Burlington, VT",8,2,2,1.0,"Narcotics or drugs, sleeping pills",0
48407341,1,"Bloomington-Normal, IL",11,2,2,1.0,"Personal weapons, includes beating",0
48516455,1,"Myrtle Beach-Conway, SC",8,2,2,1.0,"Narcotics or drugs, sleeping pills",0
48665241,2,"Worcester, MA",8,2,2,1.0,"Narcotics or drugs, sleeping pills",0
48753806,2,"Wausau, WI",0,2,2,1.0,Asphyxiation - includes death by gas,0
48941939,9,Rural Oklahoma,8,2,2,1.0,"Narcotics or drugs, sleeping pills",0
49176382,2,"Lincoln, NE",5,2,2,1.0,"Firearm, type not stated",0
49618748,2,Rural Maryland,5,2,2,1.0,"Firearm, type not stated",0
49826526,9,"Kingsport-Bristol-Bristol, TN-VA",10,2,2,1.0,Other or type unknown,0
49859676,1,"Myrtle Beach-Conway, SC",0,2,2,1.0,Asphyxiation - includes death by gas,0
50031242,2,"Greensboro-High Point, NC",12,2,2,1.0,Poison - does not include gas,0
50118511,1,Rural Virginia,16,2,2,1.0,Strangulation - hanging,0
50231241,1,"Elmira, NY",10,2,2,1.0,Other or type unknown,0
50620077,2,"El Paso, TX",8,2,2,1.0,"Narcotics or drugs, sleeping pills",0
50834537,1,"Lansing-East Lansing, MI",16,2,2,1.0,Strangulation - hanging,0
51141203,2,"Charleston-North Charleston, SC",9,2,2,1.0,Other gun,0
51405058,1,"Raleigh-Cary, NC",12,2,2,1.0,Poison - does not include gas,0
51620726,2,"Athens-Clarke County, GA",4,2,2,1.0,Fire,0
51806486,1,"Salinas, CA",2,2,2,1.0,Drowning,0
52011819,1,"York-Hanover, PA",4,2,2,1.0,Fire,0
52100124,2,"Bloomington, IN",16,2,2,1.0,Strangulation - hanging,0
52135320,1,"Duluth, MN-WI",16,2,2,1.0,Strangulation - hanging,0
52363958,1,"Danville, IL",15,2,2,1.0,Shotgun,0
52427265,2,"Laredo, TX",8,2,2,1.0,"Narcotics or drugs, sleeping pills",0
52514849,1,Rural Nebraska,0,2,2,1.0,Asphyxiation - includes death by gas,0
52707922,2,"Yuma, AZ",16,2,2,1.0,Strangulation - hanging,0
52882632,2,Rural North Dakota,0,2,2,1.0,Asphyxiation - includes death by gas,0
52952228,1,"Tallahassee, FL",3,2,2,1.0,Explosives,0
53125200,2,"Eau Claire, WI",14,2,2,1.0,Rifle,0
53725041,2,"Wenatchee, WA",16,2,2,1.0,Strangulation - hanging,0
53968906,2,"Fort Smith, AR-OK",8,2,2,1.0,"Narcotics or drugs, sleeping pills",0
53971722,2,"Chattanooga, TN-GA",2,2,2,1.0,Drowning,0
54237495,1,"Lafayette, LA",9,2,2,1.0,Other gun,0
54424250,2,"Napa, CA",15,2,2,1.0,Shotgun,0
54461506,2,"Las Vegas-Paradise, NV",12,2,2,1.0,Poison - does not include gas,0
54790820,2,Rural Nevada,3,2,2,1.0,Explosives,0
54800214,1,"San Angelo, TX",8,2,2,1.0,"Narcotics or drugs, sleeping pills",0
54872646,1,"Reno-Sparks, NV",9,2,2,1.0,Other gun,0
55710687,2,"Houma-Bayou Cane-Thibodaux, LA",8,2,2,1.0,"Narcotics or drugs, sleeping pills",0
55829728,1,"Albany-Schenectady-Troy, NY",2,2,2,1.0,Drowning,0
55864472,1,Rural Maryland,0,2,2,1.0,Asphyxiation - includes death by gas,0
55937016,2,"Warner Robins, GA",14,2,2,1.0,Rifle,0
56011543,2,"Danville, IL",0,2,2,1.0,Asphyxiation - includes death by gas,0
56017309,2,"Warner Robins, GA",4,2,2,1.0,Fire,0
56107949,2,"Utica-Rome, NY",17,2,2,1.0,Weapon Not Reported,0
56224472,2,"Sandusky, OH",10,2,2,1.0,Other or type unknown,0
56263067,1,Rural Ohio,3,2,2,1.0,Explosives,0
56323680,1,"Rapid City, SD",8,2,2,1.0,"Narcotics or drugs, sleeping pills",0
56382795,1,Rural Massachusetts,7,2,2,1.0,Knife or cutting instrument,0
56401758,2,"Anderson, SC",4,2,2,1.0,Fire,0
56585837,1,"Kingsport-Bristol-Bristol, TN-VA",4,2,2,1.0,Fire,0
56609485,1,"Ocean City, NJ",0,2,2,1.0,Asphyxiation - includes death by gas,0
56629649,1,Rural North Carolina,16,2,2,1.0,Strangulation - hanging,0
57074162,2,"Lancaster, PA",2,2,2,1.0,Drowning,0
57116160,1,"Green Bay, WI",4,2,2,1.0,Fire,0
57146272,2,"Rapid City, SD",0,2,2,1.0,Asphyxiation - includes death by gas,0
57160822,2,"Palm Bay-Melbourne-Titusville, FL",4,2,2,1.0,Fire,0
57165836,2,Rural Delaware,4,2,2,1.0,Fire,0
57716851,1,"Niles-Benton Harbor, MI",8,2,2,1.0,"Narcotics or drugs, sleeping pills",0
57818058,2,Rural Iowa,9,2,2,1.0,Other gun,0
57826556,2,"Minneapolis-St. Paul-Bloomington, MN-WI",12,2,2,1.0,Poison - does not include gas,0
57838088,2,"Baltimore-Towson, MD",13,2,2,1.0,Pushed or thrown out window,0
58220513,9,"Denver-Aurora, CO",6,2,2,1.0,"Handgun - pistol, revolver, etc",0
58363709,1,"Santa Barbara-Santa Maria, CA",8,2,2,1.0,"Narcotics or drugs, sleeping pills",0
58384047,1,"Appleton, WI",15,2,2,1.0,Shotgun,0
58400632,1,"Tucson, AZ",2,2,2,1.0,Drowning,0
58445720,2,Rural Wisconsin,2,2,2,1.0,Drowning,0
58567549,2,"Bismarck, ND",1,2,2,1.0,"Blunt object - hammer, club, etc",0
58610936,2,"Morgantown, WV",11,2,2,1.0,"Personal weapons, includes beating",0
58714313,2,"Rockford, IL",14,2,2,1.0,Rifle,0
58830503,2,"Shreveport-Bossier City, LA",8,2,2,1.0,"Narcotics or drugs, sleeping pills",0
59268342,2,"Carson City, NV",11,2,2,1.0,"Personal weapons, includes beating",0
59341618,2,"Des Moines, IA",9,2,2,1.0,Other gun,0
59777039,2,"Prescott, AZ",2,2,2,1.0,Drowning,0
59862878,1,"Chattanooga, TN-GA",2,2,2,1.0,Drowning,0
59876357,1,"Salem, OR",3,2,2,1.0,Explosives,0
60162615,9,"Ogden-Clearfield, UT",8,2,2,1.0,"Narcotics or drugs, sleeping pills",0
60280853,2,"Mansfield, OH",5,2,2,1.0,"Firearm, type not stated",0
60340789,1,"Punta Gorda, FL",8,2,2,1.0,"Narcotics or drugs, sleeping pills",0
60370490,1,"Providence-New Bedford-Fall River, RI-MA",2,2,2,1.0,Drowning,0
60377325,1,"Sandusky, OH",2,2,2,1.0,Drowning,0
60436933,2,"Charleston, WV",0,2,2,1.0,Asphyxiation - includes death by gas,0
60479857,2,"Niles-Benton Harbor, MI",14,2,2,1.0,Rifle,0
60606312,2,"Williamsport, PA",11,2,2,1.0,"Personal weapons, includes beating",0
61029707,2,"Davenport-Moline-Rock Island, IA-IL",8,2,2,1.0,"Narcotics or drugs, sleeping pills",0
61139828,2,"Casper, WY",14,2,2,1.0,Rifle,0
61665460,2,"McAllen-Edinburg-Mission, TX",4,2,2,1.0,Fire,0
61777207,1,"Eau Claire, WI",4,2,2,1.0,Fire,0
62031755,1,Rural Hawaii,2,2,2,1.0,Drowning,0
62079118,1,Rural Colorado,9,2,2,1.0,Other gun,0
62322059,1,"Jacksonville, NC",1,2,2,1.0,"Blunt object - hammer, club, etc",0
62344187,1,"Merced, CA",0,2,2,1.0,Asphyxiation - includes death by gas,0
62685986,2,"Las Cruces, NM",15,2,2,1.0,Shotgun,0
63611915,2,"Holland-Grand Haven, MI",8,2,2,1.0,"Narcotics or drugs, sleeping pills",0
63616456,2,"Wausau, WI",11,2,2,1.0,"Personal weapons, includes beating",0
64069426,2,"Bakersfield, CA",8,2,2,1.0,"Narcotics or drugs, sleeping pills",0
64089049,2,"Norwich-New London, CT",15,2,2,1.0,Shotgun,0
64583289,1,"Iowa City, IA",15,2,2,1.0,Shotgun,0
65227755,2,"Kingston, NY",4,2,2,1.0,Fire,0
65280316,2,"Gulfport-Biloxi, MS",2,2,2,1.0,Drowning,0
65414126,1,"Austin-Round Rock, TX",12,2,2,1.0,Poison - does not include gas,0
65621799,2,"Medford, OR",15,2,2,1.0,Shotgun,0
65832528,1,"Sarasota-Bradenton-Venice, FL",12,2,2,1.0,Poison - does not include gas,0
66247070,2,"Hickory-Lenoir-Morganton, NC",0,2,2,1.0,Asphyxiation - includes death by gas,0
66385874,9,Rural Tennessee,8,2,2,1.0,"Narcotics or drugs, sleeping pills",0
66500619,2,"Elizabethtown, KY",0,2,2,1.0,Asphyxiation - includes death by gas,0
66604253,1,"Oshkosh-Neenah, WI",5,2,2,1.0,"Firearm, type not stated",0
66620348,1,"Lafayette, LA",16,2,2,1.0,Strangulation - hanging,0
66774176,2,"Janesville, WI",14,2,2,1.0,Rifle,0
66920170,2,"Hagerstown-Martinsburg, MD-WV",16,2,2,1.0,Strangulation - hanging,0
66927330,1,Rural Montana,16,2,2,1.0,Strangulation - hanging,0
67333192,2,"Scranton--Wilkes-Barre, PA",13,2,2,1.0,Pushed or thrown out window,0
67413213,1,"Sumter, SC",4,2,2,1.0,Fire,0
67487150,2,"Provo-Orem, UT",14,2,2,1.0,Rifle,0
67502275,9,"Lake Charles, LA",6,2,2,1.0,"Handgun - pistol, revolver, etc",0
67547571,9,"Dothan, AL",5,2,2,1.0,"Firearm, type not stated",0
67702051,1,"Barnstable Town, MA",2,2,2,1.0,Drowning,0
67743457,1,"Hinesville-Fort Stewart, GA",11,2,2,1.0,"Personal weapons, includes beating",0
67880963,1,"Raleigh-Cary, NC",0,2,2,1.0,Asphyxiation - includes death by gas,0
68083567,1,"Ann Arbor, MI",9,2,2,1.0,Other gun,0
68441051,2,"Toledo, OH",3,2,2,1.0,Explosives,0
68597355,9,"Fayetteville, NC",9,2,2,1.0,Other gun,0
68678354,2,"Bowling Green, KY",2,2,2,1.0,Drowning,0
68682743,2,"Fond du Lac, WI",15,2,2,1.0,Shotgun,0
68811729,2,"Oklahoma City, OK",12,2,2,1.0,Poison - does not include gas,0
68981819,1,"Greenville, SC",9,2,2,1.0,Other gun,0
69002437,2,"Muncie, IN",11,2,2,1.0,"Personal weapons, includes beating",0
69056475,2,"Holland-Grand Haven, MI",14,2,2,1.0,Rifle,0
69127579,2,"Little Rock-North Little Rock, AR",8,2,2,1.0,"Narcotics or drugs, sleeping pills",0
69412353,2,"Provo-Orem, UT",1,2,2,1.0,"Blunt object - hammer, club, etc",0
69431901,1,"Cheyenne, WY",0,2,2,1.0,Asphyxiation - includes death by gas,0
69541305,1,"Bremerton-Silverdale, WA",4,2,2,1.0,Fire,0
69723686,1,"Jackson, MI",0,2,2,1.0,Asphyxiation - includes death by gas,0
69778807,2,"Alexandria, LA",0,2,2,1.0,Asphyxiation - includes death by gas,0
69789135,1,"Lawrence, KS",1,2,2,1.0,"Blunt object - hammer, club, etc",0
69822358,9,"Fort Smith, AR-OK",6,2,2,1.0,"Handgun - pistol, revolver, etc",0
69969490,2,"Springfield, IL",0,2,2,1.0,Asphyxiation - includes death by gas,0
70071727,1,"Casper, WY",1,2,2,1.0,"Blunt object - hammer, club, etc",0
70135406,2,"Michigan City-La Porte, IN",14,2,2,1.0,Rifle,0
70168431,1,Rural Montana,0,2,2,1.0,Asphyxiation - includes death by gas,0
70250958,1,"San Luis Obispo-Paso Robles, CA",0,2,2,1.0,Asphyxiation - includes death by gas,0
70529415,2,"Punta Gorda, FL",1,2,2,1.0,"Blunt object - hammer, club, etc",0
70624221,1,"Gainesville, FL",4,2,2,1.0,Fire,0
70638654,1,"Portland-Vancouver-Beaverton, OR-WA",3,2,2,1.0,Explosives,0
70644895,1,Rural South Carolina,2,2,2,1.0,Drowning,0
70780510,1,"Pascagoula, MS",8,2,2,1.0,"Narcotics or drugs, sleeping pills",0
71151185,2,"Champaign-Urbana, IL",16,2,2,1.0,Strangulation - hanging,0
71493470,2,"Sherman-Denison, TX",4,2,2,1.0,Fire,0
71524145,9,Rural South Carolina,10,2,2,1.0,Other or type unknown,0
71940892,1,"Charlotte-Gastonia-Concord, NC-SC",2,2,2,1.0,Drowning,0
71966530,1,"Longview, TX",16,2,2,1.0,Strangulation - hanging,0
72094308,1,Rural Florida,12,2,2,1.0,Poison - does not include gas,0
72123334,2,"Riverside-San Bernardino, CA",3,2,2,1.0,Explosives,0
72418176,1,"Ithaca, NY",14,2,2,1.0,Rifle,0
72431815,2,"Lawrence, KS",5,2,2,1.0,"Firearm, type not stated",0
72724016,2,"Binghamton, NY",14,2,2,1.0,Rifle,0
72977587,1,"Albany-Schenectady-Troy, NY",9,2,2,1.0,Other gun,0
73000179,1,"Sheboygan, WI",8,2,2,1.0,"Narcotics or drugs, sleeping pills",0
73200891,2,"Boulder, CO",15,2,2,1.0,Shotgun,0
73253055,2,"Greenville, SC",2,2,2,1.0,Drowning,0
73280487,2,"Portland-South Portland-Biddeford, ME",9,2,2,1.0,Other gun,0
73349649,2,"Sandusky, OH",1,2,2,1.0,"Blunt object - hammer, club, etc",0
73429315,9,"Wilmington, NC",11,2,2,1.0,"Personal weapons, includes beating",0
73481077,2,"Lewiston-Auburn, ME",15,2,2,1.0,Shotgun,0
73555720,1,"Hinesville-Fort Stewart, GA",16,2,2,1.0,Strangulation - hanging,0
73868963,2,"Holland-Grand Haven, MI",1,2,2,1.0,"Blunt object - hammer, club, etc",0
74054347,2,"Fort Collins-Loveland, CO",9,2,2,1.0,Other gun,0
74070078,2,"Holland-Grand Haven, MI",16,2,2,1.0,Strangulation - hanging,0
74462020,2,"South Bend-Mishawaka, IN-MI",0,2,2,1.0,Asphyxiation - includes death by gas,0
74536153,2,"Ogden-Clearfield, UT",3,2,2,1.0,Explosives,0
74620028,2,"Portland-Vancouver-Beaverton, OR-WA",3,2,2,1.0,Explosives,0
74649938,1,"Champaign-Urbana, IL",0,2,2,1.0,Asphyxiation - includes death by gas,0
74865310,1,"Great Falls, MT",14,2,2,1.0,Rifle,0
74976544,1,"Mobile, AL",0,2,2,1.0,Asphyxiation - includes death by gas,0
75090062,9,"Reno-Sparks, NV",4,2,2,1.0,Fire,0
75350014,1,"Danville, IL",11,2,2,1.0,"Personal weapons, includes beating",0
75358813,1,"Jackson, MI",9,2,2,1.0,Other gun,0
75448696,2,"Rochester, NY",8,2,2,1.0,"Narcotics or drugs, sleeping pills",0
75818140,1,"New Haven-Milford, CT",2,2,2,1.0,Drowning,0
75907386,1,"Anchorage, AK",2,2,2,1.0,Drowning,0
76098189,2,"Harrisburg-Carlisle, PA",2,2,2,1.0,Drowning,0
76104688,1,"Baltimore-Towson, MD",13,2,2,1.0,Pushed or thrown out window,0
76393676,1,"Champaign-Urbana, IL",14,2,2,1.0,Rifle,0
76412317,2,"La Crosse, WI-MN",10,2,2,1.0,Other or type unknown,0
76430179,2,"Panama City-Lynn Haven, FL",15,2,2,1.0,Shotgun,0
76538645,2,"Fairbanks, AK",16,2,2,1.0,Strangulation - hanging,0
77115383,1,"Albany, GA",4,2,2,1.0,Fire,0
77428509,2,"Lewiston, ID-WA",1,2,2,1.0,"Blunt object - hammer, club, etc",0
77442724,2,"Killeen-Temple-Fort Hood, TX",12,2,2,1.0,Poison - does not include gas,0
77482599,9,Rural Oklahoma,1,2,2,1.0,"Blunt object - hammer, club, etc",0
77525344,1,Rural Utah,9,2,2,1.0,Other gun,0
77536835,1,"Youngstown-Warren-Boardman, OH-PA",2,2,2,1.0,Drowning,0
77571739,1,Rural North Dakota,16,2,2,1.0,Strangulation - hanging,0
77575440,1,"Lewiston, ID-WA",15,2,2,1.0,Shotgun,0
78218483,2,"Monroe, MI",0,2,2,1.0,Asphyxiation - includes death by gas,0
78277582,1,"Hattiesburg, MS",9,2,2,1.0,Other gun,0
78491740,1,"San Luis Obispo-Paso Robles, CA",8,2,2,1.0,"Narcotics or drugs, sleeping pills",0
78650679,1,"Anderson, IN",4,2,2,1.0,Fire,0
78820451,2,"Dubuque, IA",15,2,2,1.0,Shotgun,0
78840903,2,"Sumter, SC",4,2,2,1.0,Fire,0
79185035,2,"Beaumont-Port Arthur, TX",2,2,2,1.0,Drowning,0
79244611,9,"Peoria, IL",11,2,2,1.0,"Personal weapons, includes beating",0
79526445,9,Rural Oklahoma,7,2,2,1.0,Knife or cutting instrument,0
79659543,1,"Phoenix-Mesa-Scottsdale, AZ",13,2,2,1.0,Pushed or thrown out window,0
79778789,1,"Birmingham-Hoover, AL",2,2,2,1.0,Drowning,0
80229346,1,"Dothan, AL",8,2,2,1.0,"Narcotics or drugs, sleeping pills",0
80273252,1,"Birmingham-Hoover, AL",8,2,2,1.0,"Narcotics or drugs, sleeping pills",0
80310276,1,"Boulder, CO",0,2,2,1.0,Asphyxiation - includes death by gas,0
80874738,1,"Elmira, NY",0,2,2,1.0,Asphyxiation - includes death by gas,0
80875251,1,"Atlanta-Sandy Springs-Marietta, GA",13,2,2,1.0,Pushed or thrown out window,0
80972159,2,"Santa Rosa-Petaluma, CA",8,2,2,1.0,"Narcotics or drugs, sleeping pills",0
81124107,2,"Allentown-Bethlehem-Easton, PA-NJ",13,2,2,1.0,Pushed or thrown out window,0
81244951,2,"Jefferson City, MO",1,2,2,1.0,"Blunt object - hammer, club, etc",0
81249683,1,"Gulfport-Biloxi, MS",4,2,2,1.0,Fire,0
81527937,9,"Akron, OH",10,2,2,1.0,Other or type unknown,0
81804804,2,"Morristown, TN",5,2,2,1.0,"Firearm, type not stated",0
81820762,1,Rural North Dakota,8,2,2,1.0,"Narcotics or drugs, sleeping pills",0
81890108,1,"Wilmington, NC",0,2,2,1.0,Asphyxiation - includes death by gas,0
82418451,1,"Champaign-Urbana, IL",16,2,2,1.0,Strangulation - hanging,0
82593933,2,"Yakima, WA",0,2,2,1.0,Asphyxiation - includes death by gas,0
82715665,1,"Texarkana, TX-Texarkana, AR",4,2,2,1.0,Fire,0
82910117,9,"Reno-Sparks, NV",5,2,2,1.0,"Firearm, type not stated",0
83190997,1,"Gainesville, FL",0,2,2,1.0,Asphyxiation - includes death by gas,0
83268553,2,Rural Mississippi,8,2,2,1.0,"Narcotics or drugs, sleeping pills",0
83606679,2,"Modesto, CA",2,2,2,1.0,Drowning,0
83650485,2,"Morgantown, WV",5,2,2,1.0,"Firearm, type not stated",0
83677260,1,"Houma-Bayou Cane-Thibodaux, LA",8,2,2,1.0,"Narcotics or drugs, sleeping pills",0
83727831,9,"Flint, MI",10,2,2,1.0,Other or type unknown,0
83750967,1,"Boston-Cambridge-Quincy, MA-NH",13,2,2,1.0,Pushed or thrown out window,0
83891705,1,"Springfield, OH",2,2,2,1.0,Drowning,0
84230365,2,"Reno-Sparks, NV",0,2,2,1.0,Asphyxiation - includes death by gas,0
84236071,1,"Beaumont-Port Arthur, TX",8,2,2,1.0,"Narcotics or drugs, sleeping pills",0
84277734,1,"Salisbury, MD",0,2,2,1.0,Asphyxiation - includes death by gas,0
84479003,1,"New Orleans-Metairie-Kenner, LA",13,2,2,1.0,Pushed or thrown out window,0
84507793,2,"Bay City, MI",4,2,2,1.0,Fire,0
84904130,2,"Jefferson City, MO",11,2,2,1.0,"Personal weapons, includes beating",0
85302949,1,"Jefferson City, MO",16,2,2,1.0,Strangulation - hanging,0
85355420,1,"Palm Bay-Melbourne-Titusville, FL",2,2,2,1.0,Drowning,0
85666049,1,"Ogden-Clearfield, UT",0,2,2,1.0,Asphyxiation - includes death by gas,0
85797194,2,"Hanford-Corcoran, CA",16,2,2,1.0,Strangulation - hanging,0
86130202,2,"Vineland-Millville-Bridgeton, NJ",0,2,2,1.0,Asphyxiation - includes death by gas,0
86144695,1,"Lebanon, PA",8,2,2,1.0,"Narcotics or drugs, sleeping pills",0
86292924,1,"Odessa, TX",0,2,2,1.0,Asphyxiation - includes death by gas,0
86524878,2,"Sacramento-Roseville, CA",12,2,2,1.0,Poison - does not include gas,0
86564253,9,"Auburn-Opelika, AL",5,2,2,1.0,"Firearm, type not stated",0
86828556,2,"Midland, TX",16,2,2,1.0,Strangulation - hanging,0
86919392,2,Rural North Dakota,16,2,2,1.0,Strangulation - hanging,0
86974440,1,"St. George, UT",7,2,2,1.0,Knife or cutting instrument,0
87011752,2,"Little Rock-North Little Rock, AR",3,2,2,1.0,Explosives,0
87052037,2,"Cheyenne, WY",5,2,2,1.0,"Firearm, type not stated",0
87100655,1,"Pascagoula, MS",0,2,2,1.0,Asphyxiation - includes death by gas,0
87108131,2,Rural Nevada,0,2,2,1.0,Asphyxiation - includes death by gas,0
87134836,2,"Hanford-Corcoran, CA",8,2,2,1.0,"Narcotics or drugs, sleeping pills",0
87344281,2,Rural West Virginia,12,2,2,1.0,Poison - does not include gas,0
87463421,2,"San Antonio, TX",8,2,2,1.0,"Narcotics or drugs, sleeping pills",0
87487876,2,Rural Indiana,9,2,2,1.0,Other gun,0
87535184,1,"Fayetteville, NC",4,2,2,1.0,Fire,0
87685525,1,"Greensboro-High Point, NC",8,2,2,1.0,"Narcotics or drugs, sleeping pills",0
87734712,2,"Johnstown, PA",15,2,2,1.0,Shotgun,0
87997380,1,"Norwich-New London, CT",8,2,2,1.0,"Narcotics or drugs, sleeping pills",0
88114501,1,"Lewiston-Auburn, ME",15,2,2,1.0,Shotgun,0
88148921,2,"Olympia, WA",4,2,2,1.0,Fire,0
88587179,1,"Louisville, KY-IN",12,2,2,1.0,Poison - does not include gas,0
88612148,2,"Durham, NC",12,2,2,1.0,Poison - does not include gas,0
88622616,2,"Coeur d Alene, ID",15,2,2,1.0,Shotgun,0
89055913,2,"Eau Claire, WI",15,2,2,1.0,Shotgun,0
89139318,2,"Tyler, TX",4,2,2,1.0,Fire,0
89373968,2,"Sandusky, OH",5,2,2,1.0,"Firearm, type not stated",0
89376610,1,Rural New York,2,2,2,1.0,Drowning,0
89686474,2,"Asheville, NC",16,2,2,1.0,Strangulation - hanging,0
89904759,2,"Gadsden, AL",5,2,2,1.0,"Firearm, type not stated",0
90073006,2,"Greenville, NC",16,2,2,1.0,Strangulation - hanging,0
90240661,1,"Hartford, CT",9,2,2,1.0,Other gun,0
90328939,2,"South Bend-Mishawaka, IN-MI",2,2,2,1.0,Drowning,0
90350575,2,"Rapid City, SD",14,2,2,1.0,Rifle,0
90358590,1,"San Jose-Sunnyvale-Santa Clara, CA",3,2,2,1.0,Explosives,0
90611142,1,"Victoria, TX",12,2,2,1.0,Poison - does not include gas,0
90857827,2,"Eau Claire, WI",16,2,2,1.0,Strangulation - hanging,0
91368478,1,"Clarksville, TN-KY",4,2,2,1.0,Fire,0
91501099,2,"Carson City, NV",5,2,2,1.0,"Firearm, type not stated",0
91597174,1,"Oshkosh-Neenah, WI",0,2,2,1.0,Asphyxiation - includes death by gas,0
91925046,2,"Cleveland, TN",11,2,2,1.0,"Personal weapons, includes beating",0
92117296,2,"Huntington-Ashland, WV-KY-OH",4,2,2,1.0,Fire,0
92291988,2,"Yakima, WA",8,2,2,1.0,"Narcotics or drugs, sleeping pills",0
92328690,2,Rural Texas,12,2,2,1.0,Poison - does not include gas,0
92629658,1,"New Orleans-Metairie-Kenner, LA",12,2,2,1.0,Poison - does not include gas,0
92639690,1,"Madison, WI",16,2,2,1.0,Strangulation - hanging,0
92670674,1,"Hartford, CT",2,2,2,1.0,Drowning,0
92698360,1,"Lawton, OK",4,2,2,1.0,Fire,0
93230657,2,"Morristown, TN",8,2,2,1.0,"Narcotics or drugs, sleeping pills",0
93406891,1,Rural Connecticut,5,2,2,1.0,"Firearm, type not stated",0
93891051,1,"Atlantic City, NJ",12,2,2,1.0,Poison - does not include gas,0
93941833,1,Rural Kansas,9,2,2,1.0,Other gun,0
93949621,1,"Ames, IA",4,2,2,1.0,Fire,0
94082777,2,"Shreveport-Bossier City, LA",9,2,2,1.0,Other gun,0
94397560,1,"Fayetteville, NC",8,2,2,1.0,"Narcotics or drugs, sleeping pills",0
94463065,2,Rural Hawaii,4,2,2,1.0,Fire,0
95087656,2,"Lincoln, NE",4,2,2,1.0,Fire,0
95258541,1,"Wichita, KS",8,2,2,1.0,"Narcotics or drugs, sleeping pills",0
95381944,1,Rural Maryland,16,2,2,1.0,Strangulation - hanging,0
95443984,1,Rural Mississippi,13,2,2,1.0,Pushed or thrown out window,0
95520062,1,"Fond du Lac, WI",10,2,2,1.0,Other or type unknown,0
95531439,1,Rural New Hampshire,0,2,2,1.0,Asphyxiation - includes death by gas,0
95616539,2,"Oshkosh-Neenah, WI",14,2,2,1.0,Rifle,0
95631205,2,"Flagstaff, AZ",4,2,2,1.0,Fire,0
95936926,1,Rural Colorado,2,2,2,1.0,Drowning,0
96090596,2,"Rome, GA",15,2,2,1.0,Shotgun,0
96131564,2,"Anderson, IN",14,2,2,1.0,Rifle,0
96142843,2,"Blacksburg-Christiansburg, VA",1,2,2,1.0,"Blunt object - hammer, club, etc",0
96156661,1,"Appleton, WI",0,2,2,1.0,Asphyxiation - includes death by gas,0
96198891,2,"Casper, WY",1,2,2,1.0,"Blunt object - hammer, club, etc",0
96303175,1,"Casper, WY",0,2,2,1.0,Asphyxiation - includes death by gas,0
96523041,1,"Wheeling, WV-OH",4,2,2,1.0,Fire,0
96959113,2,"Lake Charles, LA",8,2,2,1.0,"Narcotics or drugs, sleeping pills",0
97127230,1,"Huntington-Ashland, WV-KY-OH",4,2,2,1.0,Fire,0
97140402,2,"Panama City-Lynn Haven, FL",8,2,2,1.0,"Narcotics or drugs, sleeping pills",0
97618046,2,"Danville, IL",14,2,2,1.0,Rifle,0
97977238,2,"Corvallis, OR",14,2,2,1.0,Rifle,0
98229582,1,"Fayetteville, NC",12,2,2,1.0,Poison - does not include gas,0
98290567,1,"Hagerstown-Martinsburg, MD-WV",0,2,2,1.0,Asphyxiation - includes death by gas,0
98362566,2,"Kokomo, IN",16,2,2,1.0,Strangulation - hanging,0
98504594,2,"Prescott, AZ",15,2,2,1.0,Shotgun,0
98589419,1,"Abilene, TX",4,2,2,1.0,Fire,0
98761056,2,"Grand Junction, CO",12,2,2,1.0,Poison - does not include gas,0
98929077,2,"Rochester, MN",8,2,2,1.0,"Narcotics or drugs, sleeping pills",0
98938675,1,"Bellingham, WA",0,2,2,1.0,Asphyxiation - includes death by gas,0
99178133,9,Rural North Carolina,1,2,2,1.0,"Blunt object - hammer, club, etc",0
99218511,2,"Grand Rapids-Wyoming, MI",2,2,2,1.0,Drowning,0
99388752,2,"Casper, WY",15,2,2,1.0,Shotgun,0
99446146,9,Rural Oregon,7,2,2,1.0,Knife or cutting instrument,0
99796603,2,"Sarasota-Bradenton-Venice, FL",2,2,2,1.0,Drowning,0
99798412,2,"Greenville, NC",1,2,2,1.0,"Blunt object - hammer, club, etc",0
99857665,2,"Knoxville, TN",2,2,2,1.0,Drowning,0
50583,2,"Bismarck, ND",5,1,1,1.0,"Firearm, type not stated",0
76129,1,"Springfield, MO",9,1,1,1.0,Other gun,0
174581,9,"Odessa, TX",11,1,1,1.0,"Personal weapons, includes beating",0
184223,2,"Johnstown, PA",8,1,1,1.0,"Narcotics or drugs, sleeping pills",0
196136,9,"Atlanta-Sandy Springs-Marietta, GA",11,1,1,1.0,"Personal weapons, includes beating",0
337563,1,"Terre Haute, IN",2,1,1,1.0,Drowning,0
363381,9,"Dothan, AL",11,1,1,1.0,"Personal weapons, includes beating",0
390713,9,"Monroe, LA",5,1,1,1.0,"Firearm, type not stated",0
513385,2,"Vineland-Millville-Bridgeton, NJ",4,1,1,1.0,Fire,0
517573,1,"Savannah, GA",0,1,1,1.0,Asphyxiation - includes death by gas,0
636391,1,"Harrisonburg, VA",4,1,1,1.0,Fire,0
719715,1,Rural Idaho,8,1,1,1.0,"Narcotics or drugs, sleeping pills",0
783609,1,"Trenton-Ewing, NJ",13,1,1,1.0,Pushed or thrown out window,0
855327,1,"Rome, GA",0,1,1,1.0,Asphyxiation - includes death by gas,0
1181343,2,"Wausau, WI",12,1,1,1.0,Poison - does not include gas,0
1214312,9,Rural Tennessee,4,1,1,1.0,Fire,0
1252275,2,"College Station-Bryan, TX",4,1,1,1.0,Fire,0
1285536,1,"Olympia, WA",0,1,1,1.0,Asphyxiation - includes death by gas,0
1381873,2,"Lakeland, FL",9,1,1,1.0,Other gun,0
1438424,2,"Boulder, CO",14,1,1,1.0,Rifle,0
1474653,2,"Jefferson City, MO",8,1,1,1.0,"Narcotics or drugs, sleeping pills",0
1500428,9,Rural Virginia,8,1,1,1.0,"Narcotics or drugs, sleeping pills",0
1550748,2,"Hinesville-Fort Stewart, GA",0,1,1,1.0,Asphyxiation - includes death by gas,0
1555832,1,"Reading, PA",3,1,1,1.0,Explosives,0
1762966,2,"Lake Charles, LA",0,1,1,1.0,Asphyxiation - includes death by gas,0
1772503,9,"Knoxville, TN",0,1,1,1.0,Asphyxiation - includes death by gas,0
1901095,1,"Bridgeport-Stamford-Norwalk, CT",13,1,1,1.0,Pushed or thrown out window,0
1992890,2,"Warner Robins, GA",8,1,1,1.0,"Narcotics or drugs, sleeping pills",0
1995978,2,"Atlantic City, NJ",2,1,1,1.0,Drowning,0
2015492,2,"Coeur d Alene, ID",0,1,1,1.0,Asphyxiation - includes death by gas,0
2116241,2,"Tampa-St. Petersburg-Clearwater, FL",13,1,1,1.0,Pushed or thrown out window,0
2195032,2,"Columbia, SC",2,1,1,1.0,Drowning,0
2358065,9,Rural Iowa,6,1,1,1.0,"Handgun - pistol, revolver, etc",0
2363798,2,"St. George, UT",11,1,1,1.0,"Personal weapons, includes beating",0
2364620,1,"Pittsfield, MA",9,1,1,1.0,Other gun,0
2369168,1,"Seattle-Tacoma-Bellevue, WA",13,1,1,1.0,Pushed or thrown out window,0
2426011,2,Rural Oregon,13,1,1,1.0,Pushed or thrown out window,0
2523336,2,"Mobile, AL",8,1,1,1.0,"Narcotics or drugs, sleeping pills",0
2621932,9,"Detroit-Warren-Livonia, MI",11,1,1,1.0,"Personal weapons, includes beating",0
2648316,2,"El Centro, CA",12,1,1,1.0,Poison - does not include gas,0
2694152,2,"Saginaw, MI",2,1,1,1.0,Drowning,0
2734469,2,"Vineland-Millville-Bridgeton, NJ",2,1,1,1.0,Drowning,0
2785365,2,"Fort Collins-Loveland, CO",4,1,1,1.0,Fire,0
2796575,1,"Fond du Lac, WI",0,1,1,1.0,Asphyxiation - includes death by gas,0
2799065,1,"Texarkana, TX-Texarkana, AR",0,1,1,1.0,Asphyxiation - includes death by gas,0
2815808,1,"Cleveland, TN",4,1,1,1.0,Fire,0
2881127,1,"Sheboygan, WI",0,1,1,1.0,Asphyxiation - includes death by gas,0
2904836,1,"Chico, CA",9,1,1,1.0,Other gun,0
2983435,1,"La Crosse, WI-MN",0,1,1,1.0,Asphyxiation - includes death by gas,0
3032477,9,"Jonesboro, AR",5,1,1,1.0,"Firearm, type not stated",0
3038523,9,"Provo-Orem, UT",10,1,1,1.0,Other or type unknown,0
3053877,9,"Jefferson City, MO",10,1,1,1.0,Other or type unknown,0
3120726,2,"Wenatchee, WA",8,1,1,1.0,"Narcotics or drugs, sleeping pills",0
3169662,1,"Barnstable Town, MA",0,1,1,1.0,Asphyxiation - includes death by gas,0
3387595,2,"Fargo, ND-MN",0,1,1,1.0,Asphyxiation - includes death by gas,0
3637261,2,Rural Alabama,12,1,1,1.0,Poison - does not include gas,0
3693261,1,"Huntsville, AL",8,1,1,1.0,"Narcotics or drugs, sleeping pills",0
3751321,1,"Oxnard-Thousand Oaks-Ventura, CA",12,1,1,1.0,Poison - does not include gas,0
3773027,2,"Binghamton, NY",17,1,1,1.0,Weapon Not Reported,0
3890297,9,"Fort Smith, AR-OK",14,1,1,1.0,Rifle,0
3917060,2,"Bremerton-Silverdale, WA",4,1,1,1.0,Fire,0
4002568,9,Rural Alabama,15,1,1,1.0,Shotgun,0
4016992,9,Rural North Carolina,2,1,1,1.0,Drowning,0
4088482,1,"Harrisburg-Carlisle, PA",2,1,1,1.0,Drowning,0
4165627,2,"Jacksonville, FL",12,1,1,1.0,Poison - does not include gas,0
4321311,2,"Dothan, AL",16,1,1,1.0,Strangulation - hanging,0
4353626,1,"Evansville, IN-KY",2,1,1,1.0,Drowning,0
4372414,2,"Lincoln, NE",8,1,1,1.0,"Narcotics or drugs, sleeping pills",0
4385515,1,"Buffalo-Niagara Falls, NY",8,1,1,1.0,"Narcotics or drugs, sleeping pills",0
4419914,2,Rural Arizona,2,1,1,1.0,Drowning,0
4456438,2,"Tallahassee, FL",4,1,1,1.0,Fire,0
4511351,2,"Longview, WA",15,1,1,1.0,Shotgun,0
4522976,2,"Lebanon, PA",8,1,1,1.0,"Narcotics or drugs, sleeping pills",0
4544626,1,"Springfield, OH",8,1,1,1.0,"Narcotics or drugs, sleeping pills",0
4591816,2,"Spokane, WA",12,1,1,1.0,Poison - does not include gas,0
4694743,2,"Kansas City, MO-KS",12,1,1,1.0,Poison - does not include gas,0
4758884,2,Rural Massachusetts,0,1,1,1.0,Asphyxiation - includes death by gas,0
4957272,2,"Springfield, IL",14,1,1,1.0,Rifle,0
5082297,2,"Anniston-Oxford, AL",1,1,1,1.0,"Blunt object - hammer, club, etc",0
5220999,2,"Texarkana, TX-Texarkana, AR",12,1,1,1.0,Poison - does not include gas,0
5354632,2,"Johnstown, PA",0,1,1,1.0,Asphyxiation - includes death by gas,0
5358256,2,"Wichita Falls, TX",4,1,1,1.0,Fire,0
5393202,1,"Blacksburg-Christiansburg, VA",4,1,1,1.0,Fire,0
5491589,2,"Poughkeepsie-Newburgh-Middletown, NY",4,1,1,1.0,Fire,0
5649876,2,"Lima, OH",2,1,1,1.0,Drowning,0
5686438,1,"Muncie, IN",4,1,1,1.0,Fire,0
5740432,2,"Jefferson City, MO",15,1,1,1.0,Shotgun,0
5916569,2,"Anderson, IN",15,1,1,1.0,Shotgun,0
5964426,1,"Napa, CA",16,1,1,1.0,Strangulation - hanging,0
6056484,2,"Durham, NC",3,1,1,1.0,Explosives,0
6178572,1,"Wichita Falls, TX",2,1,1,1.0,Drowning,0
6188528,1,"Wichita Falls, TX",8,1,1,1.0,"Narcotics or drugs, sleeping pills",0
6263310,9,"Brunswick, GA",10,1,1,1.0,Other or type unknown,0
6263872,2,"Phoenix-Mesa-Scottsdale, AZ",13,1,1,1.0,Pushed or thrown out window,0
6320397,1,"Great Falls, MT",8,1,1,1.0,"Narcotics or drugs, sleeping pills",0
6352823,2,"Joplin, MO",8,1,1,1.0,"Narcotics or drugs, sleeping pills",0
6441154,2,"South Bend-Mishawaka, IN-MI",4,1,1,1.0,Fire,0
6514021,9,"Birmingham-Hoover, AL",8,1,1,1.0,"Narcotics or drugs, sleeping pills",0
6550618,2,"McAllen-Edinburg-Mission, TX",8,1,1,1.0,"Narcotics or drugs, sleeping pills",0
6661165,2,"Virginia Beach-Norfolk-Newport News, VA-NC",12,1,1,1.0,Poison - does not include gas,0
6744343,9,"Vallejo-Fairfield, CA",6,1,1,1.0,"Handgun - pistol, revolver, etc",0
6757442,1,"Muskegon-Norton Shores, MI",8,1,1,1.0,"Narcotics or drugs, sleeping pills",0
6863081,1,"Lexington-Fayette, KY",12,1,1,1.0,Poison - does not include gas,0
6896552,2,"Cleveland-Elyria-Mentor, OH",13,1,1,1.0,Pushed or thrown out window,0
6913410,1,"Jackson, MS",2,1,1,1.0,Drowning,0
6924867,1,"Carson City, NV",11,1,1,1.0,"Personal weapons, includes beating",0
6928016,9,"Abilene, TX",1,1,1,1.0,"Blunt object - hammer, club, etc",0
6983594,9,"Fort Smith, AR-OK",1,1,1,1.0,"Blunt object - hammer, club, etc",0
7350582,2,Rural New Hampshire,12,1,1,1.0,Poison - does not include gas,0
7435112,1,"Kingston, NY",17,1,1,1.0,Weapon Not Reported,0
7504482,1,"Lubbock, TX",8,1,1,1.0,"Narcotics or drugs, sleeping pills",0
7511859,2,"Wausau, WI",9,1,1,1.0,Other gun,0
7643879,2,"Gulfport-Biloxi, MS",4,1,1,1.0,Fire,0
7702405,2,"Utica-Rome, NY",16,1,1,1.0,Strangulation - hanging,0
7899505,2,Rural Virginia,9,1,1,1.0,Other gun,0
7942017,2,"Glens Falls, NY",12,1,1,1.0,Poison - does not include gas,0
8025980,1,"Glens Falls, NY",16,1,1,1.0,Strangulation - hanging,0
8045087,1,"Saginaw, MI",2,1,1,1.0,Drowning,0
8085605,2,"Abilene, TX",8,1,1,1.0,"Narcotics or drugs, sleeping pills",0
8154587,2,"Cincinnati-Middletown, OH-KY-IN",13,1,1,1.0,Pushed or thrown out window,0
8252815,1,Rural Florida,0,1,1,1.0,Asphyxiation - includes death by gas,0
8327910,2,"Eugene-Springfield, OR",9,1,1,1.0,Other gun,0
8428894,1,"Albany, GA",0,1,1,1.0,Asphyxiation - includes death by gas,0
8429744,9,Rural Nevada,5,1,1,1.0,"Firearm, type not stated",0
8458525,1,"Iowa City, IA",14,1,1,1.0,Rifle,0
8613790,1,"Warner Robins, GA",9,1,1,1.0,Other gun,0
8643301,2,"Kokomo, IN",0,1,1,1.0,Asphyxiation - includes death by gas,0
8646909,2,"Topeka, KS",3,1,1,1.0,Explosives,0
8678012,1,"Carson City, NV",14,1,1,1.0,Rifle,0
8752088,1,"Lakeland, FL",2,1,1,1.0,Drowning,0
8796030,2,"Lansing-East Lansing, MI",0,1,1,1.0,Asphyxiation - includes death by gas,0
8864004,1,Rural New Mexico,0,1,1,1.0,Asphyxiation - includes death by gas,0
8907837,9,"Baton Rouge, LA",5,1,1,1.0,"Firearm, type not stated",0
8932928,2,"Owensboro, KY",7,1,1,1.0,Knife or cutting instrument,0
8958553,2,"Lima, OH",0,1,1,1.0,Asphyxiation - includes death by gas,0
8958784,1,"Corvallis, OR",1,1,1,1.0,"Blunt object - hammer, club, etc",0
8971652,1,"Augusta-Richmond County, GA-SC",12,1,1,1.0,Poison - does not include gas,0
8982940,1,"Knoxville, TN",12,1,1,1.0,Poison - does not include gas,0
9043219,9,"Rockford, IL",5,1,1,1.0,"Firearm, type not stated",0
9051277,2,Rural Florida,2,1,1,1.0,Drowning,0
9160512,1,"Worcester, MA",8,1,1,1.0,"Narcotics or drugs, sleeping pills",0
9479791,1,"Greenville, NC",12,1,1,1.0,Poison - does not include gas,0
9515965,2,"Lawton, OK",2,1,1,1.0,Drowning,0
9694037,2,"Jonesboro, AR",9,1,1,1.0,Other gun,0
9735960,2,"Oklahoma City, OK",13,1,1,1.0,Pushed or thrown out window,0
9771660,2,Rural North Dakota,4,1,1,1.0,Fire,0
9809006,9,"Memphis, TN-MS-AR",7,1,1,1.0,Knife or cutting instrument,0
10176033,2,Rural Mississippi,12,1,1,1.0,Poison - does not include gas,0
10359944,1,"Tyler, TX",12,1,1,1.0,Poison - does not include gas,0
10487830,1,"Wilmington, NC",16,1,1,1.0,Strangulation - hanging,0
10559302,1,"Huntsville, AL",12,1,1,1.0,Poison - does not include gas,0
10808581,1,Rural Iowa,2,1,1,1.0,Drowning,0
10954852,1,"Palm Bay-Melbourne-Titusville, FL",16,1,1,1.0,Strangulation - hanging,0
11007859,1,"Anderson, SC",2,1,1,1.0,Drowning,0
11046250,9,"Ogden-Clearfield, UT",6,1,1,1.0,"Handgun - pistol, revolver, etc",0
11060209,2,Rural Nevada,4,1,1,1.0,Fire,0
11230107,2,"Roanoke, VA",8,1,1,1.0,"Narcotics or drugs, sleeping pills",0
11269516,1,"Toledo, OH",13,1,1,1.0,Pushed or thrown out window,0
11397491,1,"Worcester, MA",16,1,1,1.0,Strangulation - hanging,0
11778418,1,"Flagstaff, AZ",4,1,1,1.0,Fire,0
11782840,1,"Fort Wayne, IN",13,1,1,1.0,Pushed or thrown out window,0
11788242,2,"Sandusky, OH",14,1,1,1.0,Rifle,0
11831880,1,"Lafayette, LA",8,1,1,1.0,"Narcotics or drugs, sleeping pills",0
11855338,2,"Bismarck, ND",16,1,1,1.0,Strangulation - hanging,0
11925398,1,"Bangor, ME",12,1,1,1.0,Poison - does not include gas,0
12145804,2,"Omaha-Council Bluffs, NE-IA",9,1,1,1.0,Other gun,0
12285280,9,Rural Utah,11,1,1,1.0,"Personal weapons, includes beating",0
12304959,1,"Kingsport-Bristol-Bristol, TN-VA",0,1,1,1.0,Asphyxiation - includes death by gas,0
12452761,2,"Elmira, NY",2,1,1,1.0,Drowning,0
12501914,1,"Lake Charles, LA",8,1,1,1.0,"Narcotics or drugs, sleeping pills",0
12522534,2,"Corpus Christi, TX",12,1,1,1.0,Poison - does not include gas,0
12525488,1,"Nashville-Davidson-Murfreesboro, TN",12,1,1,1.0,Poison - does not include gas,0
12562953,1,"Sherman-Denison, TX",8,1,1,1.0,"Narcotics or drugs, sleeping pills",0
12657954,1,Rural Oklahoma,13,1,1,1.0,Pushed or thrown out window,0
12711771,1,"Flint, MI",12,1,1,1.0,Poison - does not include gas,0
12764946,1,"Kalamazoo-Portage, MI",3,1,1,1.0,Explosives,0
12781961,1,"Redding, CA",4,1,1,1.0,Fire,0
12841443,9,"Pittsburgh, PA",7,1,1,1.0,Knife or cutting instrument,0
12855366,2,"Hartford, CT",12,1,1,1.0,Poison - does not include gas,0
12884562,2,"Hanford-Corcoran, CA",12,1,1,1.0,Poison - does not include gas,0
12927043,9,"Toledo, OH",11,1,1,1.0,"Personal weapons, includes beating",0
12946032,1,"Savannah, GA",8,1,1,1.0,"Narcotics or drugs, sleeping pills",0
13028136,2,Rural South Dakota,9,1,1,1.0,Other gun,0
13057490,1,"Morgantown, WV",16,1,1,1.0,Strangulation - hanging,0
13069124,1,"Waco, TX",16,1,1,1.0,Strangulation - hanging,0
13247822,1,"Waterloo-Cedar Falls, IA",0,1,1,1.0,Asphyxiation - includes death by gas,0
13253078,2,"Great Falls, MT",14,1,1,1.0,Rifle,0
13318209,2,"Michigan City-La Porte, IN",12,1,1,1.0,Poison - does not include gas,0
13345165,1,"Houma-Bayou Cane-Thibodaux, LA",13,1,1,1.0,Pushed or thrown out window,0
13479899,9,Rural New York,1,1,1,1.0,"Blunt object - hammer, club, etc",0
13507538,2,"Great Falls, MT",5,1,1,1.0,"Firearm, type not stated",0
13613583,1,"Providence-New Bedford-Fall River, RI-MA",13,1,1,1.0,Pushed or thrown out window,0
13631132,2,"Spartanburg, SC",12,1,1,1.0,Poison - does not include gas,0
13652255,1,"Reno-Sparks, NV",2,1,1,1.0,Drowning,0
13695992,1,"Jackson, MS",9,1,1,1.0,Other gun,0
13699431,2,"Corvallis, OR",10,1,1,1.0,Other or type unknown,0
13858238,1,"Santa Barbara-Santa Maria, CA",2,1,1,1.0,Drowning,0
14126585,2,"Johnson City, TN",8,1,1,1.0,"Narcotics or drugs, sleeping pills",0
14301335,9,"Dothan, AL",15,1,1,1.0,Shotgun,0
14527269,9,Rural Vermont,6,1,1,1.0,"Handgun - pistol, revolver, etc",0
14548124,9,"Lafayette, LA",6,1,1,1.0,"Handgun - pistol, revolver, etc",0
14611506,2,"Columbus, GA-AL",9,1,1,1.0,Other gun,0
14631297,9,"Louisville, KY-IN",10,1,1,1.0,Other or type unknown,0
14632387,2,"Binghamton, NY",8,1,1,1.0,"Narcotics or drugs, sleeping pills",0
14677339,1,"Myrtle Beach-Conway, SC",16,1,1,1.0,Strangulation - hanging,0
14753237,2,"Peoria, IL",2,1,1,1.0,Drowning,0
14782916,2,"Erie, PA",9,1,1,1.0,Other gun,0
14795077,9,Rural Alaska,1,1,1,1.0,"Blunt object - hammer, club, etc",0
14951491,9,"Greenville, SC",4,1,1,1.0,Fire,0
15138118,1,"Deltona-Daytona Beach-Ormond Beach, FL",12,1,1,1.0,Poison - does not include gas,0
15139970,1,"Bremerton-Silverdale, WA",12,1,1,1.0,Poison - does not include gas,0
15246533,9,"Huntington-Ashland, WV-KY-OH",15,1,1,1.0,Shotgun,0
15387684,1,"Waco, TX",12,1,1,1.0,Poison - does not include gas,0
15490819,2,"Valdosta, GA",4,1,1,1.0,Fire,0
15519218,2,"Sheboygan, WI",14,1,1,1.0,Rifle,0
15628523,1,"Las Cruces, NM",2,1,1,1.0,Drowning,0
15659987,1,"Burlington-South Burlington, VT",0,1,1,1.0,Asphyxiation - includes death by gas,0
15717977,2,"Weirton-Steubenville, WV-OH",16,1,1,1.0,Strangulation - hanging,0
15787603,2,"Johnson City, TN",16,1,1,1.0,Strangulation - hanging,0
15808219,1,"Vero Beach, FL",8,1,1,1.0,"Narcotics or drugs, sleeping pills",0
16021454,2,"Alexandria, LA",13,1,1,1.0,Pushed or thrown out window,0
16114572,1,Rural Kansas,16,1,1,1.0,Strangulation - hanging,0
16205107,2,"Florence-Muscle Shoals, AL",1,1,1,1.0,"Blunt object - hammer, club, etc",0
16207699,9,"Virginia Beach-Norfolk-Newport News, VA-NC",6,1,1,1.0,"Handgun - pistol, revolver, etc",0
16211347,2,"Fayetteville, NC",12,1,1,1.0,Poison - does not include gas,0
16549018,1,"Canton-Massillon, OH",0,1,1,1.0,Asphyxiation - includes death by gas,0
16662973,2,"Corvallis, OR",16,1,1,1.0,Strangulation - hanging,0
16951672,2,"Reading, PA",3,1,1,1.0,Explosives,0
16990544,9,"Farmington, NM",10,1,1,1.0,Other or type unknown,0
17068661,1,"Augusta-Richmond County, GA-SC",3,1,1,1.0,Explosives,0
17073096,2,"Elizabethtown, KY",16,1,1,1.0,Strangulation - hanging,0
17096985,9,"Corpus Christi, TX",10,1,1,1.0,Other or type unknown,0
17115786,1,"Gadsden, AL",8,1,1,1.0,"Narcotics or drugs, sleeping pills",0
17124515,2,"Deltona-Daytona Beach-Ormond Beach, FL",0,1,1,1.0,Asphyxiation - includes death by gas,0
17201614,1,"St. Joseph, MO-KS",8,1,1,1.0,"Narcotics or drugs, sleeping pills",0
17277022,1,"Burlington, NC",2,1,1,1.0,Drowning,0
17330685,1,"Columbus, IN",5,1,1,1.0,"Firearm, type not stated",0
17365937,9,"Niles-Benton Harbor, MI",15,1,1,1.0,Shotgun,0
17397948,2,"Bowling Green, KY",0,1,1,1.0,Asphyxiation - includes death by gas,0
17403513,1,"Cleveland-Elyria-Mentor, OH",12,1,1,1.0,Poison - does not include gas,0
17600918,2,"Pascagoula, MS",13,1,1,1.0,Pushed or thrown out window,0
17607852,1,"Weirton-Steubenville, WV-OH",0,1,1,1.0,Asphyxiation - includes death by gas,0
17665358,2,"Racine, WI",5,1,1,1.0,"Firearm, type not stated",0
17940506,9,"Topeka, KS",12,1,1,1.0,Poison - does not include gas,0
17990091,9,"Grand Rapids-Wyoming, MI",6,1,1,1.0,"Handgun - pistol, revolver, etc",0
18032126,1,"Fort Collins-Loveland, CO",16,1,1,1.0,Strangulation - hanging,0
18060137,1,Rural Massachusetts,6,1,1,1.0,"Handgun - pistol, revolver, etc",0
18219545,1,"Roanoke, VA",2,1,1,1.0,Drowning,0
18372183,2,"Bismarck, ND",4,1,1,1.0,Fire,0
18490098,2,Rural Idaho,9,1,1,1.0,Other gun,0
18492830,1,"Roanoke, VA",0,1,1,1.0,Asphyxiation - includes death by gas,0
18535581,9,Rural Arizona,7,1,1,1.0,Knife or cutting instrument,0
18570676,1,"Wilmington, NC",4,1,1,1.0,Fire,0
18610949,1,Rural Iowa,16,1,1,1.0,Strangulation - hanging,0
18669486,1,"Wichita Falls, TX",9,1,1,1.0,Other gun,0
18684588,1,Rural Michigan,16,1,1,1.0,Strangulation - hanging,0
18730986,1,"Norwich-New London, CT",9,1,1,1.0,Other gun,0
18884295,2,"Roanoke, VA",2,1,1,1.0,Drowning,0
18957855,2,"Wenatchee, WA",12,1,1,1.0,Poison - does not include gas,0
19007926,2,"Elmira, NY",17,1,1,1.0,Weapon Not Reported,0
19028405,2,"Danville, IL",8,1,1,1.0,"Narcotics or drugs, sleeping pills",0
19042932,1,Rural Massachusetts,10,1,1,1.0,Other or type unknown,0
19085715,2,"Mobile, AL",9,1,1,1.0,Other gun,0
19246205,2,"Racine, WI",14,1,1,1.0,Rifle,0
19264071,9,"Provo-Orem, UT",6,1,1,1.0,"Handgun - pistol, revolver, etc",0
19446489,1,"Madera, CA",0,1,1,1.0,Asphyxiation - includes death by gas,0
19502130,2,"Harrisonburg, VA",8,1,1,1.0,"Narcotics or drugs, sleeping pills",0
19600896,2,"Madera, CA",9,1,1,1.0,Other gun,0
19696168,1,"San Angelo, TX",16,1,1,1.0,Strangulation - hanging,0
19722108,9,Rural Maine,10,1,1,1.0,Other or type unknown,0
19817464,9,"Louisville, KY-IN",6,1,1,1.0,"Handgun - pistol, revolver, etc",0
19897761,1,"Topeka, KS",8,1,1,1.0,"Narcotics or drugs, sleeping pills",0
19902728,2,"Athens-Clarke County, GA",14,1,1,1.0,Rifle,0
19944250,2,"Johnson City, TN",0,1,1,1.0,Asphyxiation - includes death by gas,0
20079377,1,"Carson City, NV",2,1,1,1.0,Drowning,0
20267387,1,"Salt Lake City, UT",13,1,1,1.0,Pushed or thrown out window,0
20316864,9,Rural Alabama,4,1,1,1.0,Fire,0
20317103,2,"Dalton, GA",12,1,1,1.0,Poison - does not include gas,0
20465628,1,"Naples-Marco Island, FL",2,1,1,1.0,Drowning,0
20494371,1,Rural West Virginia,12,1,1,1.0,Poison - does not include gas,0
20665873,9,Rural Illinois,6,1,1,1.0,"Handgun - pistol, revolver, etc",0
20766051,2,"Hattiesburg, MS",16,1,1,1.0,Strangulation - hanging,0
20837164,1,"Boise City-Nampa, ID",2,1,1,1.0,Drowning,0
21180355,1,"Holland-Grand Haven, MI",16,1,1,1.0,Strangulation - hanging,0
21284165,2,"Flagstaff, AZ",8,1,1,1.0,"Narcotics or drugs, sleeping pills",0
21317206,9,"Scranton--Wilkes-Barre, PA",10,1,1,1.0,Other or type unknown,0
21403616,1,"Columbia, MO",9,1,1,1.0,Other gun,0
21498888,1,"Anchorage, AK",13,1,1,1.0,Pushed or thrown out window,0
21569580,9,"Topeka, KS",6,1,1,1.0,"Handgun - pistol, revolver, etc",0
21576759,2,"Trenton-Ewing, NJ",9,1,1,1.0,Other gun,0
21696148,1,Rural Massachusetts,11,1,1,1.0,"Personal weapons, includes beating",0
21696299,9,"Johnson City, TN",7,1,1,1.0,Knife or cutting instrument,0
21746550,1,Rural Connecticut,16,1,1,1.0,Strangulation - hanging,0
21841398,2,"Chico, CA",3,1,1,1.0,Explosives,0
22025643,1,"Trenton-Ewing, NJ",2,1,1,1.0,Drowning,0
22034227,9,"Memphis, TN-MS-AR",5,1,1,1.0,"Firearm, type not stated",0
22052418,2,"Bloomington-Normal, IL",15,1,1,1.0,Shotgun,0
22241849,2,"Sandusky, OH",9,1,1,1.0,Other gun,0
22242598,1,"Indianapolis, IN",3,1,1,1.0,Explosives,0
22345803,1,"Burlington-South Burlington, VT",2,1,1,1.0,Drowning,0
22378072,2,"Longview, WA",2,1,1,1.0,Drowning,0
22386129,1,Rural Indiana,13,1,1,1.0,Pushed or thrown out window,0
22406002,2,"Sheboygan, WI",8,1,1,1.0,"Narcotics or drugs, sleeping pills",0
22427352,1,"Hickory-Lenoir-Morganton, NC",8,1,1,1.0,"Narcotics or drugs, sleeping pills",0
22579097,1,"Utica-Rome, NY",0,1,1,1.0,Asphyxiation - includes death by gas,0
22604961,2,"Ithaca, NY",0,1,1,1.0,Asphyxiation - includes death by gas,0
22683951,1,"Monroe, LA",0,1,1,1.0,Asphyxiation - includes death by gas,0
22863094,2,"Baltimore-Towson, MD",2,1,1,1.0,Drowning,0
22960979,1,"Longview, TX",0,1,1,1.0,Asphyxiation - includes death by gas,0
22976949,9,"Lansing-East Lansing, MI",11,1,1,1.0,"Personal weapons, includes beating",0
23035575,9,"Reading, PA",4,1,1,1.0,Fire,0
23064118,1,"Albany-Schenectady-Troy, NY",13,1,1,1.0,Pushed or thrown out window,0
23095336,9,"Palm Bay-Melbourne-Titusville, FL",7,1,1,1.0,Knife or cutting instrument,0
23172110,2,"Danville, IL",5,1,1,1.0,"Firearm, type not stated",0
23176241,1,"Glens Falls, NY",1,1,1,1.0,"Blunt object - hammer, club, etc",0
23487539,9,"Philadelphia-Camden-Wilmington, PA-NJ-DE",11,1,1,1.0,"Personal weapons, includes beating",0
23505471,1,"Carson City, NV",10,1,1,1.0,Other or type unknown,0
23523701,2,"Lewiston, ID-WA",2,1,1,1.0,Drowning,0
23529732,2,"Seattle-Tacoma-Bellevue, WA",3,1,1,1.0,Explosives,0
23612762,1,"Sioux City, IA-NE-SD",16,1,1,1.0,Strangulation - hanging,0
23631800,2,"Duluth, MN-WI",2,1,1,1.0,Drowning,0
23633387,1,"Lawton, OK",16,1,1,1.0,Strangulation - hanging,0
23680199,9,Rural Alabama,9,1,1,1.0,Other gun,0
23826532,1,"Fairbanks, AK",16,1,1,1.0,Strangulation - hanging,0
23938869,1,"Decatur, AL",16,1,1,1.0,Strangulation - hanging,0
23973096,9,Rural Louisiana,6,1,1,1.0,"Handgun - pistol, revolver, etc",0
23995066,2,"Birmingham-Hoover, AL",8,1,1,1.0,"Narcotics or drugs, sleeping pills",0
24066636,9,"Green Bay, WI",10,1,1,1.0,Other or type unknown,0
24180322,2,"Dallas-Fort Worth-Arlington, TX",13,1,1,1.0,Pushed or thrown out window,0
24196062,2,"Flint, MI",2,1,1,1.0,Drowning,0
24196618,9,Rural West Virginia,7,1,1,1.0,Knife or cutting instrument,0
24377122,2,"Kankakee-Bradley, IL",14,1,1,1.0,Rifle,0
24472246,9,"Manchester-Nashua, NH",10,1,1,1.0,Other or type unknown,0
24480009,1,"Idaho Falls, ID",4,1,1,1.0,Fire,0
24522150,1,"Midland, TX",8,1,1,1.0,"Narcotics or drugs, sleeping pills",0
24837309,2,"Fond du Lac, WI",10,1,1,1.0,Other or type unknown,0
24899206,1,"Las Cruces, NM",8,1,1,1.0,"Narcotics or drugs, sleeping pills",0
25005958,2,"Dayton, OH",9,1,1,1.0,Other gun,0
25191215,1,"Kennewick-Richland-Pasco, WA",13,1,1,1.0,Pushed or thrown out window,0
25215560,9,"Little Rock-North Little Rock, AR",7,1,1,1.0,Knife or cutting instrument,0
25243608,2,"Toledo, OH",12,1,1,1.0,Poison - does not include gas,0
25303031,2,"Sherman-Denison, TX",9,1,1,1.0,Other gun,0
25351426,2,"Bloomington, IN",0,1,1,1.0,Asphyxiation - includes death by gas,0
25383579,2,"Danville, IL",4,1,1,1.0,Fire,0
25612869,2,"Sioux Falls, SD",12,1,1,1.0,Poison - does not include gas,0
25659385,2,"Greenville, NC",0,1,1,1.0,Asphyxiation - includes death by gas,0
25686074,2,"Albany, GA",8,1,1,1.0,"Narcotics or drugs, sleeping pills",0
25754351,1,"Brownsville-Harlingen, TX",0,1,1,1.0,Asphyxiation - includes death by gas,0
25804523,1,"Sioux Falls, SD",4,1,1,1.0,Fire,0
25986169,2,"Niles-Benton Harbor, MI",0,1,1,1.0,Asphyxiation - includes death by gas,0
26090071,9,"Madison, WI",10,1,1,1.0,Other or type unknown,0
26097264,1,"Buffalo-Niagara Falls, NY",2,1,1,1.0,Drowning,0
26097867,9,"Seattle-Tacoma-Bellevue, WA",11,1,1,1.0,"Personal weapons, includes beating",0
26153677,2,"Michigan City-La Porte, IN",8,1,1,1.0,"Narcotics or drugs, sleeping pills",0
26197124,2,"Abilene, TX",0,1,1,1.0,Asphyxiation - includes death by gas,0
26225160,9,"Virginia Beach-Norfolk-Newport News, VA-NC",15,1,1,1.0,Shotgun,0
26249282,1,"Decatur, IL",0,1,1,1.0,Asphyxiation - includes death by gas,0
26314861,1,"Alexandria, LA",12,1,1,1.0,Poison - does not include gas,0
26333090,1,Rural Wisconsin,12,1,1,1.0,Poison - does not include gas,0
26510130,2,"Columbia, MO",8,1,1,1.0,"Narcotics or drugs, sleeping pills",0
26567568,9,"Virginia Beach-Norfolk-Newport News, VA-NC",5,1,1,1.0,"Firearm, type not stated",0
26662195,1,"Prescott, AZ",9,1,1,1.0,Other gun,0
26841052,9,"Jonesboro, AR",10,1,1,1.0,Other or type unknown,0
26843393,2,"Monroe, MI",8,1,1,1.0,"Narcotics or drugs, sleeping pills",0
27110421,1,"Terre Haute, IN",8,1,1,1.0,"Narcotics or drugs, sleeping pills",0
27197155,1,"Jefferson City, MO",2,1,1,1.0,Drowning,0
27215485,2,Rural Kentucky,3,1,1,1.0,Explosives,0
27220841,1,"Deltona-Daytona Beach-Ormond Beach, FL",8,1,1,1.0,"Narcotics or drugs, sleeping pills",0
27315318,9,"Akron, OH",6,1,1,1.0,"Handgun - pistol, revolver, etc",0
27342617,2,"Rochester, MN",5,1,1,1.0,"Firearm, type not stated",0
27387765,1,"Madera, CA",4,1,1,1.0,Fire,0
27390216,2,"Pascagoula, MS",2,1,1,1.0,Drowning,0
27391493,2,"Santa Fe, NM",8,1,1,1.0,"Narcotics or drugs, sleeping pills",0
27492517,2,"Punta Gorda, FL",16,1,1,1.0,Strangulation - hanging,0
27503671,2,"Olympia, WA",12,1,1,1.0,Poison - does not include gas,0
27509520,9,"Rochester, NY",6,1,1,1.0,"Handgun - pistol, revolver, etc",0
27514702,2,"Pittsfield, MA",8,1,1,1.0,"Narcotics or drugs, sleeping pills",0
27530106,9,"San Antonio, TX",11,1,1,1.0,"Personal weapons, includes beating",0
27532445,1,"Morgantown, WV",11,1,1,1.0,"Personal weapons, includes beating",0
27620079,1,"Mount Vernon-Anacortes, WA",4,1,1,1.0,Fire,0
27657464,2,"Gainesville, GA",16,1,1,1.0,Strangulation - hanging,0
27661225,2,Rural Colorado,2,1,1,1.0,Drowning,0
27666826,2,"St. George, UT",14,1,1,1.0,Rifle,0
27696650,9,Rural Missouri,10,1,1,1.0,Other or type unknown,0
27712056,2,"Bay City, MI",16,1,1,1.0,Strangulation - hanging,0
27763641,9,"Goldsboro, NC",10,1,1,1.0,Other or type unknown,0
27912533,9,"Missoula, MT",1,1,1,1.0,"Blunt object - hammer, club, etc",0
27989018,1,"Norwich-New London, CT",2,1,1,1.0,Drowning,0
28058499,1,"Omaha-Council Bluffs, NE-IA",12,1,1,1.0,Poison - does not include gas,0
28200310,9,"Houma-Bayou Cane-Thibodaux, LA",6,1,1,1.0,"Handgun - pistol, revolver, etc",0
28511474,2,"Lynchburg, VA",8,1,1,1.0,"Narcotics or drugs, sleeping pills",0
28651517,1,"Roanoke, VA",12,1,1,1.0,Poison - does not include gas,0
28683414,2,"Kokomo, IN",14,1,1,1.0,Rifle,0
28741294,1,"Rochester, NY",8,1,1,1.0,"Narcotics or drugs, sleeping pills",0
28819070,2,"Pittsfield, MA",0,1,1,1.0,Asphyxiation - includes death by gas,0
28850444,1,"Ithaca, NY",5,1,1,1.0,"Firearm, type not stated",0
28868343,9,Rural Mississippi,15,1,1,1.0,Shotgun,0
29030279,1,"Vineland-Millville-Bridgeton, NJ",2,1,1,1.0,Drowning,0
29081980,2,"Peoria, IL",16,1,1,1.0,Strangulation - hanging,0
29085215,2,"Knoxville, TN",12,1,1,1.0,Poison - does not include gas,0
29207252,2,"Sioux City, IA-NE-SD",0,1,1,1.0,Asphyxiation - includes death by gas,0
29220992,1,Rural Montana,2,1,1,1.0,Drowning,0
29276463,2,"Bellingham, WA",0,1,1,1.0,Asphyxiation - includes death by gas,0
29339636,9,"Lafayette, IN",15,1,1,1.0,Shotgun,0
29340047,9,"Honolulu, HI",5,1,1,1.0,"Firearm, type not stated",0
29361177,2,"Chico, CA",12,1,1,1.0,Poison - does not include gas,0
29391257,2,"Pocatello, ID",5,1,1,1.0,"Firearm, type not stated",0
29547078,2,"Cape Coral-Fort Myers, FL",4,1,1,1.0,Fire,0
29907510,2,"Salinas, CA",4,1,1,1.0,Fire,0
29927569,2,"Grand Forks, ND-MN",2,1,1,1.0,Drowning,0
30018342,1,"Carson City, NV",0,1,1,1.0,Asphyxiation - includes death by gas,0
30071604,1,"Kingston, NY",16,1,1,1.0,Strangulation - hanging,0
30119250,1,"Montgomery, AL",0,1,1,1.0,Asphyxiation - includes death by gas,0
30134161,9,"Las Vegas-Paradise, NV",6,1,1,1.0,"Handgun - pistol, revolver, etc",0
30182919,1,"Bremerton-Silverdale, WA",0,1,1,1.0,Asphyxiation - includes death by gas,0
30293527,2,"Rochester, MN",14,1,1,1.0,Rifle,0
30371174,2,"Decatur, IL",16,1,1,1.0,Strangulation - hanging,0
30380538,1,"Danville, IL",4,1,1,1.0,Fire,0
30707099,9,"Tucson, AZ",6,1,1,1.0,"Handgun - pistol, revolver, etc",0
30715094,1,"Madison, WI",12,1,1,1.0,Poison - does not include gas,0
30727004,9,"Reno-Sparks, NV",6,1,1,1.0,"Handgun - pistol, revolver, etc",0
30727449,1,Rural New York,13,1,1,1.0,Pushed or thrown out window,0
30773718,9,"Greensboro-High Point, NC",7,1,1,1.0,Knife or cutting instrument,0
30827391,2,"Salem, OR",3,1,1,1.0,Explosives,0
30962308,1,Rural West Virginia,2,1,1,1.0,Drowning,0
30964269,1,"Bend, OR",9,1,1,1.0,Other gun,0
30995225,2,"Hot Springs, AR",0,1,1,1.0,Asphyxiation - includes death by gas,0
31078141,2,"Gainesville, GA",8,1,1,1.0,"Narcotics or drugs, sleeping pills",0
31120845,2,"Greensboro-High Point, NC",8,1,1,1.0,"Narcotics or drugs, sleeping pills",0
31200615,2,"Visalia-Porterville, CA",3,1,1,1.0,Explosives,0
31269838,1,"Dayton, OH",2,1,1,1.0,Drowning,0
31312276,1,"Yuma, AZ",8,1,1,1.0,"Narcotics or drugs, sleeping pills",0
31339634,1,"Oklahoma City, OK",12,1,1,1.0,Poison - does not include gas,0
31358630,9,"Cleveland-Elyria-Mentor, OH",1,1,1,1.0,"Blunt object - hammer, club, etc",0
31382034,2,"Charlottesville, VA",0,1,1,1.0,Asphyxiation - includes death by gas,0
31392082,2,"Michigan City-La Porte, IN",16,1,1,1.0,Strangulation - hanging,0
31501372,1,Rural Alaska,3,1,1,1.0,Explosives,0
31519943,1,"Sioux City, IA-NE-SD",0,1,1,1.0,Asphyxiation - includes death by gas,0
31527565,1,"Joplin, MO",13,1,1,1.0,Pushed or thrown out window,0
31632839,1,Rural Wisconsin,3,1,1,1.0,Explosives,0
31667960,2,Rural Hawaii,8,1,1,1.0,"Narcotics or drugs, sleeping pills",0
31717444,1,"Cheyenne, WY",4,1,1,1.0,Fire,0
31848567,9,"Panama City-Lynn Haven, FL",6,1,1,1.0,"Handgun - pistol, revolver, etc",0
31964081,2,"Terre Haute, IN",4,1,1,1.0,Fire,0
32084325,9,"Nashville-Davidson-Murfreesboro, TN",10,1,1,1.0,Other or type unknown,0
32092178,2,Rural Kentucky,2,1,1,1.0,Drowning,0
32094739,2,"Barnstable Town, MA",4,1,1,1.0,Fire,0
32096726,1,"Barnstable Town, MA",8,1,1,1.0,"Narcotics or drugs, sleeping pills",0
32140278,1,"Kokomo, IN",16,1,1,1.0,Strangulation - hanging,0
32158883,2,"Sacramento-Roseville, CA",9,1,1,1.0,Other gun,0
32171931,1,"Athens-Clarke County, GA",9,1,1,1.0,Other gun,0
32177782,1,"Muskegon-Norton Shores, MI",16,1,1,1.0,Strangulation - hanging,0
32227448,9,"Macon, GA",10,1,1,1.0,Other or type unknown,0
32407285,1,"Provo-Orem, UT",9,1,1,1.0,Other gun,0
32592908,1,"Blacksburg-Christiansburg, VA",16,1,1,1.0,Strangulation - hanging,0
32640084,1,"Rome, GA",8,1,1,1.0,"Narcotics or drugs, sleeping pills",0
32794355,2,"Mobile, AL",0,1,1,1.0,Asphyxiation - includes death by gas,0
32887552,1,"Eau Claire, WI",15,1,1,1.0,Shotgun,0
32910886,9,"Corpus Christi, TX",5,1,1,1.0,"Firearm, type not stated",0
32974621,1,"Redding, CA",0,1,1,1.0,Asphyxiation - includes death by gas,0
33047613,2,"Columbus, OH",12,1,1,1.0,Poison - does not include gas,0
33213737,1,"Rochester, MN",16,1,1,1.0,Strangulation - hanging,0
33227836,1,"St. George, UT",1,1,1,1.0,"Blunt object - hammer, club, etc",0
33253858,1,"Salinas, CA",12,1,1,1.0,Poison - does not include gas,0
33262125,1,"Johnstown, PA",3,1,1,1.0,Explosives,0
33305334,1,"Macon, GA",13,1,1,1.0,Pushed or thrown out window,0
33350948,1,"Santa Rosa-Petaluma, CA",4,1,1,1.0,Fire,0
33563730,2,"Albany, GA",0,1,1,1.0,Asphyxiation - includes death by gas,0
34060066,2,"Altoona, PA",4,1,1,1.0,Fire,0
34129202,1,Rural Hawaii,8,1,1,1.0,"Narcotics or drugs, sleeping pills",0
34150450,2,"Flagstaff, AZ",0,1,1,1.0,Asphyxiation - includes death by gas,0
34192766,1,Rural Idaho,3,1,1,1.0,Explosives,0
34195465,2,Rural California,9,1,1,1.0,Other gun,0
34245662,1,"Appleton, WI",2,1,1,1.0,Drowning,0
34248504,2,"Ames, IA",0,1,1,1.0,Asphyxiation - includes death by gas,0
34337262,2,Rural Nevada,8,1,1,1.0,"Narcotics or drugs, sleeping pills",0
34353548,1,"Jackson, TN",12,1,1,1.0,Poison - does not include gas,0
34619539,9,"Grand Rapids-Wyoming, MI",10,1,1,1.0,Other or type unknown,0
34646550,1,"Mobile, AL",12,1,1,1.0,Poison - does not include gas,0
34678833,2,"Victoria, TX",5,1,1,1.0,"Firearm, type not stated",0
34693603,2,"Boulder, CO",0,1,1,1.0,Asphyxiation - includes death by gas,0
34705962,1,"Charleston, WV",3,1,1,1.0,Explosives,0
34784626,1,Rural Indiana,2,1,1,1.0,Drowning,0
34968178,1,"Madera, CA",8,1,1,1.0,"Narcotics or drugs, sleeping pills",0
34986151,2,"Sioux City, IA-NE-SD",2,1,1,1.0,Drowning,0
35043955,9,"Cincinnati-Middletown, OH-KY-IN",7,1,1,1.0,Knife or cutting instrument,0
35126027,2,Rural Georgia,13,1,1,1.0,Pushed or thrown out window,0
35194715,2,"Ithaca, NY",16,1,1,1.0,Strangulation - hanging,0
35306175,1,Rural North Dakota,2,1,1,1.0,Drowning,0
35385061,2,"Appleton, WI",8,1,1,1.0,"Narcotics or drugs, sleeping pills",0
35428881,2,"Myrtle Beach-Conway, SC",9,1,1,1.0,Other gun,0
35458683,1,"Kokomo, IN",0,1,1,1.0,Asphyxiation - includes death by gas,0
35517017,2,"New Haven-Milford, CT",13,1,1,1.0,Pushed or thrown out window,0
35555300,9,"Honolulu, HI",7,1,1,1.0,Knife or cutting instrument,0
35623047,1,Rural Maine,0,1,1,1.0,Asphyxiation - includes death by gas,0
35649035,9,"Greenville, NC",1,1,1,1.0,"Blunt object - hammer, club, etc",0
35654686,1,"Rocky Mount, NC",8,1,1,1.0,"Narcotics or drugs, sleeping pills",0
35733502,2,"Altoona, PA",5,1,1,1.0,"Firearm, type not stated",0
35825010,1,"Hinesville-Fort Stewart, GA",2,1,1,1.0,Drowning,0
35838178,9,"Longview, TX",5,1,1,1.0,"Firearm, type not stated",0
35862240,2,"Greeley, CO",3,1,1,1.0,Explosives,0
35887468,1,"Appleton, WI",8,1,1,1.0,"Narcotics or drugs, sleeping pills",0
36027626,1,"Hinesville-Fort Stewart, GA",1,1,1,1.0,"Blunt object - hammer, club, etc",0
36065028,9,Rural West Virginia,11,1,1,1.0,"Personal weapons, includes beating",0
36259510,1,"Billings, MT",12,1,1,1.0,Poison - does not include gas,0
36329416,2,"Pine Bluff, AR",2,1,1,1.0,Drowning,0
36384019,1,"Tyler, TX",8,1,1,1.0,"Narcotics or drugs, sleeping pills",0
36595251,9,"Savannah, GA",6,1,1,1.0,"Handgun - pistol, revolver, etc",0
36683937,1,"Pensacola-Ferry Pass-Brent, FL",16,1,1,1.0,Strangulation - hanging,0
36814021,2,"Winchester, VA-WV",16,1,1,1.0,Strangulation - hanging,0
37142191,1,"Hickory-Lenoir-Morganton, NC",2,1,1,1.0,Drowning,0
37197377,1,"Eau Claire, WI",16,1,1,1.0,Strangulation - hanging,0
37215187,1,"Deltona-Daytona Beach-Ormond Beach, FL",0,1,1,1.0,Asphyxiation - includes death by gas,0
37261952,9,"Bloomington-Normal, IL",11,1,1,1.0,"Personal weapons, includes beating",0
37374518,9,"Florence-Muscle Shoals, AL",7,1,1,1.0,Knife or cutting instrument,0
37378695,1,"Dothan, AL",12,1,1,1.0,Poison - does not include gas,0
37405336,2,"Dothan, AL",0,1,1,1.0,Asphyxiation - includes death by gas,0
37413214,1,"Bakersfield, CA",12,1,1,1.0,Poison - does not include gas,0
37446065,2,"Columbia, MO",2,1,1,1.0,Drowning,0
37682784,2,"Sumter, SC",12,1,1,1.0,Poison - does not include gas,0
37722168,9,"Florence-Muscle Shoals, AL",6,1,1,1.0,"Handgun - pistol, revolver, etc",0
37841606,1,"Sandusky, OH",12,1,1,1.0,Poison - does not include gas,0
38029424,2,"Palm Bay-Melbourne-Titusville, FL",2,1,1,1.0,Drowning,0
38057610,9,"Champaign-Urbana, IL",11,1,1,1.0,"Personal weapons, includes beating",0
38120177,2,"Janesville, WI",8,1,1,1.0,"Narcotics or drugs, sleeping pills",0
38273473,1,"St. Louis, MO-IL",13,1,1,1.0,Pushed or thrown out window,0
38337581,2,Rural Iowa,3,1,1,1.0,Explosives,0
38376271,1,"Columbus, GA-AL",0,1,1,1.0,Asphyxiation - includes death by gas,0
38506861,1,"Des Moines, IA",0,1,1,1.0,Asphyxiation - includes death by gas,0
38530216,2,"Trenton-Ewing, NJ",2,1,1,1.0,Drowning,0
38738450,9,"Kennewick-Richland-Pasco, WA",5,1,1,1.0,"Firearm, type not stated",0
38813603,1,"Seattle-Tacoma-Bellevue, WA",12,1,1,1.0,Poison - does not include gas,0
38846276,9,"Bend, OR",14,1,1,1.0,Rifle,0
38856694,2,Rural New Mexico,8,1,1,1.0,"Narcotics or drugs, sleeping pills",0
38864811,1,"Kokomo, IN",8,1,1,1.0,"Narcotics or drugs, sleeping pills",0
39121797,2,"Florence-Muscle Shoals, AL",8,1,1,1.0,"Narcotics or drugs, sleeping pills",0
39149537,2,"Midland, TX",4,1,1,1.0,Fire,0
39431897,1,Rural South Dakota,9,1,1,1.0,Other gun,0
39569585,1,"Lancaster, PA",2,1,1,1.0,Drowning,0
39593810,2,"San Antonio, TX",13,1,1,1.0,Pushed or thrown out window,0
39597568,1,"Bowling Green, KY",2,1,1,1.0,Drowning,0
39708390,2,Rural Colorado,12,1,1,1.0,Poison - does not include gas,0
39775231,1,"Rochester, NY",13,1,1,1.0,Pushed or thrown out window,0
39961712,1,"Vineland-Millville-Bridgeton, NJ",3,1,1,1.0,Explosives,0
40081836,1,"Merced, CA",2,1,1,1.0,Drowning,0
40150804,1,"Akron, OH",2,1,1,1.0,Drowning,0
40266242,1,"Brunswick, GA",0,1,1,1.0,Asphyxiation - includes death by gas,0
40578755,2,"Columbia, SC",8,1,1,1.0,"Narcotics or drugs, sleeping pills",0
40596115,2,"Bay City, MI",8,1,1,1.0,"Narcotics or drugs, sleeping pills",0
40618819,1,"Birmingham-Hoover, AL",13,1,1,1.0,Pushed or thrown out window,0
40621529,9,Rural New Mexico,7,1,1,1.0,Knife or cutting instrument,0
40647072,1,"Lawton, OK",9,1,1,1.0,Other gun,0
40735131,2,"Memphis, TN-MS-AR",2,1,1,1.0,Drowning,0
40807840,1,Rural Missouri,3,1,1,1.0,Explosives,0
40813615,2,"Altoona, PA",9,1,1,1.0,Other gun,0
41100016,1,"Naples-Marco Island, FL",16,1,1,1.0,Strangulation - hanging,0
41255469,9,Rural Michigan,6,1,1,1.0,"Handgun - pistol, revolver, etc",0
41259462,9,"Spokane, WA",5,1,1,1.0,"Firearm, type not stated",0
41420051,1,"Vero Beach, FL",2,1,1,1.0,Drowning,0
41426597,2,Rural Wyoming,13,1,1,1.0,Pushed or thrown out window,0
41738364,9,"Atlanta-Sandy Springs-Marietta, GA",5,1,1,1.0,"Firearm, type not stated",0
41752055,2,"Rockford, IL",12,1,1,1.0,Poison - does not include gas,0
41787164,2,"Worcester, MA",13,1,1,1.0,Pushed or thrown out window,0
41842937,1,"Ocala, FL",2,1,1,1.0,Drowning,0
41844928,2,"Salisbury, MD",8,1,1,1.0,"Narcotics or drugs, sleeping pills",0
41966459,9,Rural Alabama,1,1,1,1.0,"Blunt object - hammer, club, etc",0
42098531,1,"Virginia Beach-Norfolk-Newport News, VA-NC",3,1,1,1.0,Explosives,0
42146411,2,"Spokane, WA",9,1,1,1.0,Other gun,0
42153222,1,"Seattle-Tacoma-Bellevue, WA",3,1,1,1.0,Explosives,0
42212969,9,Rural New Mexico,5,1,1,1.0,"Firearm, type not stated",0
42314364,1,"Fort Wayne, IN",2,1,1,1.0,Drowning,0
42321751,9,"Greenville, NC",11,1,1,1.0,"Personal weapons, includes beating",0
42322127,2,"Florence, SC",13,1,1,1.0,Pushed or thrown out window,0
42378037,1,Rural Georgia,8,1,1,1.0,"Narcotics or drugs, sleeping pills",0
42383121,1,"McAllen-Edinburg-Mission, TX",2,1,1,1.0,Drowning,0
42498016,1,"Goldsboro, NC",4,1,1,1.0,Fire,0
42593530,2,"Davenport-Moline-Rock Island, IA-IL",14,1,1,1.0,Rifle,0
42643978,1,Rural New York,12,1,1,1.0,Poison - does not include gas,0
42678083,1,"Des Moines, IA",16,1,1,1.0,Strangulation - hanging,0
42765339,1,"Jackson, TN",9,1,1,1.0,Other gun,0
42819079,2,"Ocean City, NJ",14,1,1,1.0,Rifle,0
43036538,2,"Spartanburg, SC",16,1,1,1.0,Strangulation - hanging,0
43234555,9,"Minneapolis-St. Paul-Bloomington, MN-WI",11,1,1,1.0,"Personal weapons, includes beating",0
43251733,2,"Anderson, IN",8,1,1,1.0,"Narcotics or drugs, sleeping pills",0
43274412,9,"Las Vegas-Paradise, NV",14,1,1,1.0,Rifle,0
43452519,2,"Chattanooga, TN-GA",12,1,1,1.0,Poison - does not include gas,0
43633194,1,"Bismarck, ND",1,1,1,1.0,"Blunt object - hammer, club, etc",0
43804810,9,"Columbus, GA-AL",6,1,1,1.0,"Handgun - pistol, revolver, etc",0
43805214,1,"Lewiston, ID-WA",5,1,1,1.0,"Firearm, type not stated",0
43851708,1,"Ocala, FL",9,1,1,1.0,Other gun,0
43913555,2,"Pensacola-Ferry Pass-Brent, FL",2,1,1,1.0,Drowning,0
43921287,2,"Champaign-Urbana, IL",2,1,1,1.0,Drowning,0
43989721,1,Rural Wyoming,2,1,1,1.0,Drowning,0
44100572,1,"Cheyenne, WY",13,1,1,1.0,Pushed or thrown out window,0
44135110,2,"Canton-Massillon, OH",9,1,1,1.0,Other gun,0
44149291,2,"Springfield, MO",8,1,1,1.0,"Narcotics or drugs, sleeping pills",0
44160915,1,"Cumberland, MD-WV",8,1,1,1.0,"Narcotics or drugs, sleeping pills",0
44221474,1,"Hickory-Lenoir-Morganton, NC",12,1,1,1.0,Poison - does not include gas,0
44367104,1,"Sumter, SC",8,1,1,1.0,"Narcotics or drugs, sleeping pills",0
44449891,1,Rural Montana,12,1,1,1.0,Poison - does not include gas,0
44464518,9,Rural Georgia,6,1,1,1.0,"Handgun - pistol, revolver, etc",0
44666044,1,"Battle Creek, MI",0,1,1,1.0,Asphyxiation - includes death by gas,0
44667179,1,"Burlington, NC",8,1,1,1.0,"Narcotics or drugs, sleeping pills",0
44779544,2,"Kankakee-Bradley, IL",9,1,1,1.0,Other gun,0
45005038,9,"Cheyenne, WY",8,1,1,1.0,"Narcotics or drugs, sleeping pills",0
45259309,9,"Alexandria, LA",6,1,1,1.0,"Handgun - pistol, revolver, etc",0
45288332,2,"Albuquerque, NM",3,1,1,1.0,Explosives,0
45361671,1,"Logan, UT-ID",0,1,1,1.0,Asphyxiation - includes death by gas,0
45411069,2,"Lewiston-Auburn, ME",5,1,1,1.0,"Firearm, type not stated",0
45552647,1,"Reno-Sparks, NV",12,1,1,1.0,Poison - does not include gas,0
45565225,2,"Flint, MI",12,1,1,1.0,Poison - does not include gas,0
45636821,1,"Fort Smith, AR-OK",3,1,1,1.0,Explosives,0
45663934,2,"Charleston, WV",9,1,1,1.0,Other gun,0
45725580,2,"Bismarck, ND",12,1,1,1.0,Poison - does not include gas,0
46011326,1,"Yuba City, CA",12,1,1,1.0,Poison - does not include gas,0
46246229,2,"Jacksonville, NC",4,1,1,1.0,Fire,0
46265012,2,"Rocky Mount, NC",2,1,1,1.0,Drowning,0
46265053,1,"Jacksonville, FL",12,1,1,1.0,Poison - does not include gas,0
46356757,1,"Monroe, LA",4,1,1,1.0,Fire,0
46386850,2,"Baton Rouge, LA",12,1,1,1.0,Poison - does not include gas,0
46461799,1,"Mansfield, OH",8,1,1,1.0,"Narcotics or drugs, sleeping pills",0
46591583,2,"Ogden-Clearfield, UT",2,1,1,1.0,Drowning,0
46612336,2,"Cheyenne, WY",4,1,1,1.0,Fire,0
46673442,2,"Madera, CA",0,1,1,1.0,Asphyxiation - includes death by gas,0
46807990,2,"New Haven-Milford, CT",3,1,1,1.0,Explosives,0
46941344,1,"Colorado Springs, CO",2,1,1,1.0,Drowning,0
46962193,2,"Burlington, NC",8,1,1,1.0,"Narcotics or drugs, sleeping pills",0
47009014,9,"Ann Arbor, MI",10,1,1,1.0,Other or type unknown,0
47261635,2,"Honolulu, HI",12,1,1,1.0,Poison - does not include gas,0
47431100,2,"Wichita, KS",12,1,1,1.0,Poison - does not include gas,0
47646112,2,"Pueblo, CO",8,1,1,1.0,"Narcotics or drugs, sleeping pills",0
47954644,1,Rural Michigan,12,1,1,1.0,Poison - does not include gas,0
47963875,1,Rural South Carolina,16,1,1,1.0,Strangulation - hanging,0
48008607,9,"Allentown-Bethlehem-Easton, PA-NJ",6,1,1,1.0,"Handgun - pistol, revolver, etc",0
48038943,1,"Lincoln, NE",2,1,1,1.0,Drowning,0
48084249,2,"Macon, GA",2,1,1,1.0,Drowning,0
48105174,1,"Alexandria, LA",3,1,1,1.0,Explosives,0
48110344,9,"Sarasota-Bradenton-Venice, FL",6,1,1,1.0,"Handgun - pistol, revolver, etc",0
48168185,1,"Warner Robins, GA",8,1,1,1.0,"Narcotics or drugs, sleeping pills",0
48203151,9,"Rochester, NY",15,1,1,1.0,Shotgun,0
48263095,2,"Kankakee-Bradley, IL",5,1,1,1.0,"Firearm, type not stated",0
48273684,9,"Orlando-Kissimmee, FL",1,1,1,1.0,"Blunt object - hammer, club, etc",0
48368961,1,"Pine Bluff, AR",0,1,1,1.0,Asphyxiation - includes death by gas,0
48397372,2,"Charlottesville, VA",2,1,1,1.0,Drowning,0
48561353,2,"Valdosta, GA",8,1,1,1.0,"Narcotics or drugs, sleeping pills",0
48637261,2,Rural Alaska,12,1,1,1.0,Poison - does not include gas,0
48648104,1,"Hattiesburg, MS",0,1,1,1.0,Asphyxiation - includes death by gas,0
48686893,1,"Honolulu, HI",3,1,1,1.0,Explosives,0
48727240,2,"Santa Cruz-Watsonville, CA",4,1,1,1.0,Fire,0
48793463,2,"Providence-New Bedford-Fall River, RI-MA",13,1,1,1.0,Pushed or thrown out window,0
48821126,2,"Richmond, VA",12,1,1,1.0,Poison - does not include gas,0
48827067,1,"Wichita, KS",16,1,1,1.0,Strangulation - hanging,0
48885345,9,"New York-New Jersey-Long Island, NY-NJ",14,1,1,1.0,Rifle,0
48901149,1,Rural Tennessee,12,1,1,1.0,Poison - does not include gas,0
48968008,1,"Charleston, WV",2,1,1,1.0,Drowning,0
48984797,1,Rural Oregon,12,1,1,1.0,Poison - does not include gas,0
48989233,2,"Bay City, MI",15,1,1,1.0,Shotgun,0
49020471,1,"Altoona, PA",11,1,1,1.0,"Personal weapons, includes beating",0
49182504,1,"Dubuque, IA",0,1,1,1.0,Asphyxiation - includes death by gas,0
49281679,1,"Warner Robins, GA",4,1,1,1.0,Fire,0
49302104,1,"Des Moines, IA",12,1,1,1.0,Poison - does not include gas,0
49314400,9,"Binghamton, NY",1,1,1,1.0,"Blunt object - hammer, club, etc",0
49383585,2,"Wenatchee, WA",5,1,1,1.0,"Firearm, type not stated",0
49399734,2,Rural Arizona,8,1,1,1.0,"Narcotics or drugs, sleeping pills",0
49500643,9,"Fargo, ND-MN",6,1,1,1.0,"Handgun - pistol, revolver, etc",0
49539756,2,"Carson City, NV",4,1,1,1.0,Fire,0
49553884,9,"Tulsa, OK",15,1,1,1.0,Shotgun,0
49592199,1,"Lewiston, ID-WA",8,1,1,1.0,"Narcotics or drugs, sleeping pills",0
49611066,2,"Raleigh-Cary, NC",2,1,1,1.0,Drowning,0
49649685,2,"Visalia-Porterville, CA",8,1,1,1.0,"Narcotics or drugs, sleeping pills",0
49670877,2,"Roanoke, VA",9,1,1,1.0,Other gun,0
49782414,2,"Kankakee-Bradley, IL",2,1,1,1.0,Drowning,0
49959108,2,"Madison, WI",4,1,1,1.0,Fire,0
49993603,1,"Wenatchee, WA",16,1,1,1.0,Strangulation - hanging,0
50006746,2,"Altoona, PA",3,1,1,1.0,Explosives,0
50204501,2,"Brownsville-Harlingen, TX",4,1,1,1.0,Fire,0
50270654,9,"Tulsa, OK",1,1,1,1.0,"Blunt object - hammer, club, etc",0
50379675,1,"Lancaster, PA",16,1,1,1.0,Strangulation - hanging,0
50389811,2,"Vineland-Millville-Bridgeton, NJ",9,1,1,1.0,Other gun,0
50454133,1,"Knoxville, TN",13,1,1,1.0,Pushed or thrown out window,0
50464692,1,"Hartford, CT",3,1,1,1.0,Explosives,0
50471685,2,"Rocky Mount, NC",8,1,1,1.0,"Narcotics or drugs, sleeping pills",0
50552362,2,"Tulsa, OK",9,1,1,1.0,Other gun,0
50563727,2,"Huntsville, AL",0,1,1,1.0,Asphyxiation - includes death by gas,0
50634709,2,"Boulder, CO",4,1,1,1.0,Fire,0
51120120,2,"Erie, PA",8,1,1,1.0,"Narcotics or drugs, sleeping pills",0
51188399,2,"Danville, IL",15,1,1,1.0,Shotgun,0
51251099,1,"Sherman-Denison, TX",0,1,1,1.0,Asphyxiation - includes death by gas,0
51303978,2,"Syracuse, NY",12,1,1,1.0,Poison - does not include gas,0
51349989,1,"Fairbanks, AK",0,1,1,1.0,Asphyxiation - includes death by gas,0
51379771,2,Rural Minnesota,12,1,1,1.0,Poison - does not include gas,0
51432192,2,"Boston-Cambridge-Quincy, MA-NH",12,1,1,1.0,Poison - does not include gas,0
51544115,1,"Providence-New Bedford-Fall River, RI-MA",12,1,1,1.0,Poison - does not include gas,0
51599290,1,"Pocatello, ID",5,1,1,1.0,"Firearm, type not stated",0
51608286,2,"Green Bay, WI",2,1,1,1.0,Drowning,0
51656283,1,"Fort Smith, AR-OK",8,1,1,1.0,"Narcotics or drugs, sleeping pills",0
51698583,2,"San Angelo, TX",14,1,1,1.0,Rifle,0
51727866,2,"Dayton, OH",13,1,1,1.0,Pushed or thrown out window,0
51800521,1,Rural Illinois,3,1,1,1.0,Explosives,0
51827890,2,"Anchorage, AK",8,1,1,1.0,"Narcotics or drugs, sleeping pills",0
51881335,1,Rural Hawaii,13,1,1,1.0,Pushed or thrown out window,0
51984265,2,"Detroit-Warren-Livonia, MI",13,1,1,1.0,Pushed or thrown out window,0
52011749,1,"Richmond, VA",12,1,1,1.0,Poison - does not include gas,0
52074593,1,"Columbia, MO",0,1,1,1.0,Asphyxiation - includes death by gas,0
52205363,2,"Springfield, MA",8,1,1,1.0,"Narcotics or drugs, sleeping pills",0
52229413,2,"Longview, WA",5,1,1,1.0,"Firearm, type not stated",0
52358428,2,"Myrtle Beach-Conway, SC",4,1,1,1.0,Fire,0
52368250,2,"Anderson, IN",4,1,1,1.0,Fire,0
52509990,2,"Des Moines, IA",8,1,1,1.0,"Narcotics or drugs, sleeping pills",0
52583737,2,Rural New Mexico,9,1,1,1.0,Other gun,0
52652795,9,"Phoenix-Mesa-Scottsdale, AZ",0,1,1,1.0,Asphyxiation - includes death by gas,0
52654804,1,"Durham, NC",2,1,1,1.0,Drowning,0
52674140,1,"Gadsden, AL",3,1,1,1.0,Explosives,0
52855469,9,"Fayetteville, NC",6,1,1,1.0,"Handgun - pistol, revolver, etc",0
52888041,1,"Rapid City, SD",9,1,1,1.0,Other gun,0
52896849,1,"Morgantown, WV",9,1,1,1.0,Other gun,0
52952323,1,"Joplin, MO",8,1,1,1.0,"Narcotics or drugs, sleeping pills",0
53247210,2,"Port St. Lucie-Fort Pierce, FL",12,1,1,1.0,Poison - does not include gas,0
53468050,1,Rural Washington,0,1,1,1.0,Asphyxiation - includes death by gas,0
53503305,2,"Parkersburg-Marietta-Vienna, WV-OH",16,1,1,1.0,Strangulation - hanging,0
53725509,1,"Fargo, ND-MN",0,1,1,1.0,Asphyxiation - includes death by gas,0
53851594,1,"Winston-Salem, NC",0,1,1,1.0,Asphyxiation - includes death by gas,0
53886152,1,"Omaha-Council Bluffs, NE-IA",13,1,1,1.0,Pushed or thrown out window,0
53922741,1,"Greeley, CO",0,1,1,1.0,Asphyxiation - includes death by gas,0
53934558,1,"Mount Vernon-Anacortes, WA",11,1,1,1.0,"Personal weapons, includes beating",0
53973559,2,"Mansfield, OH",16,1,1,1.0,Strangulation - hanging,0
54077995,1,"Oxnard-Thousand Oaks-Ventura, CA",2,1,1,1.0,Drowning,0
54104173,2,"Fond du Lac, WI",8,1,1,1.0,"Narcotics or drugs, sleeping pills",0
54156603,2,"Rocky Mount, NC",4,1,1,1.0,Fire,0
54163538,2,"Naples-Marco Island, FL",3,1,1,1.0,Explosives,0
54166412,2,"Hagerstown-Martinsburg, MD-WV",9,1,1,1.0,Other gun,0
54186223,2,Rural Maine,9,1,1,1.0,Other gun,0
54296149,2,"Fayetteville-Springdale-Rogers, AR-MO",9,1,1,1.0,Other gun,0
54355552,2,"Ames, IA",16,1,1,1.0,Strangulation - hanging,0
54356273,2,"York-Hanover, PA",2,1,1,1.0,Drowning,0
54602740,9,"Lawton, OK",8,1,1,1.0,"Narcotics or drugs, sleeping pills",0
54637401,1,"Ames, IA",15,1,1,1.0,Shotgun,0
54666661,2,Rural South Carolina,12,1,1,1.0,Poison - does not include gas,0
54734863,9,"Merced, CA",1,1,1,1.0,"Blunt object - hammer, club, etc",0
54759998,1,"Harrisonburg, VA",8,1,1,1.0,"Narcotics or drugs, sleeping pills",0
54768017,1,"Johnstown, PA",16,1,1,1.0,Strangulation - hanging,0
54771436,1,"Phoenix-Mesa-Scottsdale, AZ",12,1,1,1.0,Poison - does not include gas,0
54848765,1,"Cincinnati-Middletown, OH-KY-IN",3,1,1,1.0,Explosives,0
54880546,2,"Cape Coral-Fort Myers, FL",12,1,1,1.0,Poison - does not include gas,0
54918126,2,"San Diego-Carlsbad-San Marcos, CA",3,1,1,1.0,Explosives,0
55022777,2,"Knoxville, TN",9,1,1,1.0,Other gun,0
55036096,1,"Santa Rosa-Petaluma, CA",3,1,1,1.0,Explosives,0
55059661,2,"Asheville, NC",5,1,1,1.0,"Firearm, type not stated",0
55092207,1,"Eau Claire, WI",11,1,1,1.0,"Personal weapons, includes beating",0
55262161,1,"Janesville, WI",2,1,1,1.0,Drowning,0
55275940,9,Rural Michigan,15,1,1,1.0,Shotgun,0
55289132,1,"Sioux Falls, SD",14,1,1,1.0,Rifle,0
55294015,1,"Jonesboro, AR",16,1,1,1.0,Strangulation - hanging,0
55313543,1,"Hartford, CT",12,1,1,1.0,Poison - does not include gas,0
55376419,2,"Michigan City-La Porte, IN",9,1,1,1.0,Other gun,0
55391396,2,"Elkhart-Goshen, IN",12,1,1,1.0,Poison - does not include gas,0
55410784,2,"Chattanooga, TN-GA",4,1,1,1.0,Fire,0
55430260,2,"Pensacola-Ferry Pass-Brent, FL",12,1,1,1.0,Poison - does not include gas,0
55479796,1,"Provo-Orem, UT",2,1,1,1.0,Drowning,0
55545575,2,"Fairbanks, AK",14,1,1,1.0,Rifle,0
55561407,2,Rural Hawaii,2,1,1,1.0,Drowning,0
55684669,1,"Peoria, IL",13,1,1,1.0,Pushed or thrown out window,0
55729700,2,"Cumberland, MD-WV",9,1,1,1.0,Other gun,0
55873516,2,"Great Falls, MT",1,1,1,1.0,"Blunt object - hammer, club, etc",0
55896848,9,Rural Texas,6,1,1,1.0,"Handgun - pistol, revolver, etc",0
55905139,2,"Charlottesville, VA",16,1,1,1.0,Strangulation - hanging,0
55945438,1,"Lakeland, FL",3,1,1,1.0,Explosives,0
55979495,2,"Grand Junction, CO",2,1,1,1.0,Drowning,0
56116226,2,"Rochester, MN",15,1,1,1.0,Shotgun,0
56131183,1,"Albany-Schenectady-Troy, NY",3,1,1,1.0,Explosives,0
56260260,9,Rural North Carolina,5,1,1,1.0,"Firearm, type not stated",0
56289402,2,"Lafayette, LA",2,1,1,1.0,Drowning,0
56332375,9,"Auburn-Opelika, AL",6,1,1,1.0,"Handgun - pistol, revolver, etc",0
56498656,2,Rural Montana,9,1,1,1.0,Other gun,0
56571096,1,"Fond du Lac, WI",15,1,1,1.0,Shotgun,0
56655364,9,"Jonesboro, AR",6,1,1,1.0,"Handgun - pistol, revolver, etc",0
56670090,2,"Johnstown, PA",9,1,1,1.0,Other gun,0
56697580,2,"Cumberland, MD-WV",16,1,1,1.0,Strangulation - hanging,0
56810362,2,"Michigan City-La Porte, IN",0,1,1,1.0,Asphyxiation - includes death by gas,0
56866405,9,"Springfield, OH",5,1,1,1.0,"Firearm, type not stated",0
56890180,2,"Poughkeepsie-Newburgh-Middletown, NY",8,1,1,1.0,"Narcotics or drugs, sleeping pills",0
56913204,1,"Kingsport-Bristol-Bristol, TN-VA",9,1,1,1.0,Other gun,0
57117277,2,"Jackson, TN",8,1,1,1.0,"Narcotics or drugs, sleeping pills",0
57230482,9,"Spartanburg, SC",1,1,1,1.0,"Blunt object - hammer, club, etc",0
57265182,2,"Morristown, TN",0,1,1,1.0,Asphyxiation - includes death by gas,0
57331780,1,"Tuscaloosa, AL",12,1,1,1.0,Poison - does not include gas,0
57331966,1,"Longview, TX",8,1,1,1.0,"Narcotics or drugs, sleeping pills",0
57369965,2,"Redding, CA",4,1,1,1.0,Fire,0
57381763,2,"Peoria, IL",9,1,1,1.0,Other gun,0
57396915,1,"Tampa-St. Petersburg-Clearwater, FL",12,1,1,1.0,Poison - does not include gas,0
57421329,1,"San Luis Obispo-Paso Robles, CA",2,1,1,1.0,Drowning,0
57482780,1,"Danville, IL",10,1,1,1.0,Other or type unknown,0
57494796,2,"Ithaca, NY",15,1,1,1.0,Shotgun,0
57537901,1,"Glens Falls, NY",17,1,1,1.0,Weapon Not Reported,0
57558231,2,"Memphis, TN-MS-AR",12,1,1,1.0,Poison - does not include gas,0
57642373,2,"Honolulu, HI",2,1,1,1.0,Drowning,0
57674275,2,"Harrisonburg, VA",0,1,1,1.0,Asphyxiation - includes death by gas,0
57682905,2,"Grand Junction, CO",5,1,1,1.0,"Firearm, type not stated",0
57832073,2,"Pocatello, ID",16,1,1,1.0,Strangulation - hanging,0
57851510,2,"Buffalo-Niagara Falls, NY",12,1,1,1.0,Poison - does not include gas,0
58037285,2,Rural Delaware,2,1,1,1.0,Drowning,0
58064226,2,"San Jose-Sunnyvale-Santa Clara, CA",9,1,1,1.0,Other gun,0
58152201,2,"Morgantown, WV",9,1,1,1.0,Other gun,0
58239115,9,"Tyler, TX",11,1,1,1.0,"Personal weapons, includes beating",0
58472205,2,"Springfield, IL",2,1,1,1.0,Drowning,0
58530211,2,"St. George, UT",8,1,1,1.0,"Narcotics or drugs, sleeping pills",0
58542787,2,"Springfield, IL",3,1,1,1.0,Explosives,0
58567984,1,"Fort Collins-Loveland, CO",9,1,1,1.0,Other gun,0
58622849,1,"Goldsboro, NC",16,1,1,1.0,Strangulation - hanging,0
58797151,1,Rural Alaska,12,1,1,1.0,Poison - does not include gas,0
58910568,1,"Lynchburg, VA",2,1,1,1.0,Drowning,0
58981441,1,"Elmira, NY",12,1,1,1.0,Poison - does not include gas,0
58982998,1,"Bowling Green, KY",4,1,1,1.0,Fire,0
59024809,9,"Riverside-San Bernardino, CA",8,1,1,1.0,"Narcotics or drugs, sleeping pills",0
59034694,1,"Sherman-Denison, TX",2,1,1,1.0,Drowning,0
59064467,2,"Punta Gorda, FL",14,1,1,1.0,Rifle,0
59104730,1,"Wausau, WI",9,1,1,1.0,Other gun,0
59321915,1,"Akron, OH",12,1,1,1.0,Poison - does not include gas,0
59458265,1,"Midland, TX",9,1,1,1.0,Other gun,0
59496417,1,"Barnstable Town, MA",16,1,1,1.0,Strangulation - hanging,0
59597308,1,"Santa Cruz-Watsonville, CA",4,1,1,1.0,Fire,0
59649560,9,"Ann Arbor, MI",7,1,1,1.0,Knife or cutting instrument,0
59694705,1,"Dubuque, IA",10,1,1,1.0,Other or type unknown,0
59764873,1,"Jacksonville, NC",16,1,1,1.0,Strangulation - hanging,0
59996452,1,"York-Hanover, PA",2,1,1,1.0,Drowning,0
60150935,1,"Clarksville, TN-KY",2,1,1,1.0,Drowning,0
60351974,2,"Blacksburg-Christiansburg, VA",2,1,1,1.0,Drowning,0
60564613,1,"Sandusky, OH",16,1,1,1.0,Strangulation - hanging,0
60594528,2,"Lebanon, PA",14,1,1,1.0,Rifle,0
60686467,1,"Appleton, WI",16,1,1,1.0,Strangulation - hanging,0
60830411,9,"Charlotte-Gastonia-Concord, NC-SC",7,1,1,1.0,Knife or cutting instrument,0
60855058,9,"Peoria, IL",6,1,1,1.0,"Handgun - pistol, revolver, etc",0
60997712,2,"Youngstown-Warren-Boardman, OH-PA",2,1,1,1.0,Drowning,0
61150682,2,Rural Nevada,2,1,1,1.0,Drowning,0
61162979,2,Rural Louisiana,12,1,1,1.0,Poison - does not include gas,0
61163264,2,"Kennewick-Richland-Pasco, WA",16,1,1,1.0,Strangulation - hanging,0
61215294,1,"Montgomery, AL",9,1,1,1.0,Other gun,0
61287429,1,"St. Cloud, MN",0,1,1,1.0,Asphyxiation - includes death by gas,0
61316307,2,"Charleston, WV",8,1,1,1.0,"Narcotics or drugs, sleeping pills",0
61372595,2,"St. Cloud, MN",2,1,1,1.0,Drowning,0
61485828,2,"Ithaca, NY",1,1,1,1.0,"Blunt object - hammer, club, etc",0
61530403,9,"Brownsville-Harlingen, TX",1,1,1,1.0,"Blunt object - hammer, club, etc",0
61556071,1,"Morristown, TN",9,1,1,1.0,Other gun,0
61723672,2,"Lewiston, ID-WA",16,1,1,1.0,Strangulation - hanging,0
61788271,2,"Grand Junction, CO",4,1,1,1.0,Fire,0
61826667,1,"Springfield, IL",3,1,1,1.0,Explosives,0
61843950,2,"Victoria, TX",8,1,1,1.0,"Narcotics or drugs, sleeping pills",0
61876856,1,"Pittsfield, MA",0,1,1,1.0,Asphyxiation - includes death by gas,0
61950629,2,"Oshkosh-Neenah, WI",8,1,1,1.0,"Narcotics or drugs, sleeping pills",0
61991556,2,"Deltona-Daytona Beach-Ormond Beach, FL",8,1,1,1.0,"Narcotics or drugs, sleeping pills",0
62016802,2,"Wenatchee, WA",9,1,1,1.0,Other gun,0
62037286,2,"Rockford, IL",0,1,1,1.0,Asphyxiation - includes death by gas,0
62050024,9,"Binghamton, NY",14,1,1,1.0,Rifle,0
62135066,1,"Greeley, CO",9,1,1,1.0,Other gun,0
62235874,2,"Elizabethtown, KY",8,1,1,1.0,"Narcotics or drugs, sleeping pills",0
62417295,2,"Bakersfield, CA",12,1,1,1.0,Poison - does not include gas,0
62437313,1,"Denver-Aurora, CO",13,1,1,1.0,Pushed or thrown out window,0
62559029,1,"Buffalo-Niagara Falls, NY",3,1,1,1.0,Explosives,0
62592447,2,"Vineland-Millville-Bridgeton, NJ",14,1,1,1.0,Rifle,0
62677249,1,"Durham, NC",0,1,1,1.0,Asphyxiation - includes death by gas,0
62997789,1,"Baton Rouge, LA",3,1,1,1.0,Explosives,0
63029286,2,"Sarasota-Bradenton-Venice, FL",9,1,1,1.0,Other gun,0
63029753,2,"Florence, SC",9,1,1,1.0,Other gun,0
63083297,2,"La Crosse, WI-MN",16,1,1,1.0,Strangulation - hanging,0
63190649,1,"Portland-South Portland-Biddeford, ME",0,1,1,1.0,Asphyxiation - includes death by gas,0
63207432,2,"Bismarck, ND",8,1,1,1.0,"Narcotics or drugs, sleeping pills",0
63212705,9,"Fayetteville-Springdale-Rogers, AR-MO",14,1,1,1.0,Rifle,0
63279839,2,"Greensboro-High Point, NC",0,1,1,1.0,Asphyxiation - includes death by gas,0
63286692,2,"Columbia, MO",13,1,1,1.0,Pushed or thrown out window,0
63296522,2,"San Jose-Sunnyvale-Santa Clara, CA",3,1,1,1.0,Explosives,0
63318343,2,"Wausau, WI",4,1,1,1.0,Fire,0
63344862,9,"Des Moines, IA",11,1,1,1.0,"Personal weapons, includes beating",0
63350675,2,"Morgantown, WV",16,1,1,1.0,Strangulation - hanging,0
63447582,2,"Bloomington, IN",5,1,1,1.0,"Firearm, type not stated",0
63528703,1,"Binghamton, NY",8,1,1,1.0,"Narcotics or drugs, sleeping pills",0
63599411,1,Rural Alabama,0,1,1,1.0,Asphyxiation - includes death by gas,0
63660307,1,"Bowling Green, KY",0,1,1,1.0,Asphyxiation - includes death by gas,0
63677227,1,"Bangor, ME",16,1,1,1.0,Strangulation - hanging,0
63677912,1,"Danville, VA",2,1,1,1.0,Drowning,0
63798643,9,"Lakeland, FL",6,1,1,1.0,"Handgun - pistol, revolver, etc",0
63833224,9,Rural Alabama,0,1,1,1.0,Asphyxiation - includes death by gas,0
63867225,1,Rural Delaware,8,1,1,1.0,"Narcotics or drugs, sleeping pills",0
63910224,2,"Williamsport, PA",4,1,1,1.0,Fire,0
63933860,1,"Pittsfield, MA",15,1,1,1.0,Shotgun,0
63990886,1,"Santa Cruz-Watsonville, CA",8,1,1,1.0,"Narcotics or drugs, sleeping pills",0
64048710,2,"Sioux Falls, SD",15,1,1,1.0,Shotgun,0
64148204,1,Rural Massachusetts,15,1,1,1.0,Shotgun,0
64271417,2,"Oshkosh-Neenah, WI",5,1,1,1.0,"Firearm, type not stated",0
64310919,1,"Morgantown, WV",2,1,1,1.0,Drowning,0
64321814,9,"Utica-Rome, NY",1,1,1,1.0,"Blunt object - hammer, club, etc",0
64372776,2,"Mansfield, OH",14,1,1,1.0,Rifle,0
64379488,1,"Pueblo, CO",4,1,1,1.0,Fire,0
64388103,9,"Poughkeepsie-Newburgh-Middletown, NY",7,1,1,1.0,Knife or cutting instrument,0
64492957,2,"Houma-Bayou Cane-Thibodaux, LA",0,1,1,1.0,Asphyxiation - includes death by gas,0
64495243,9,"Kalamazoo-Portage, MI",6,1,1,1.0,"Handgun - pistol, revolver, etc",0
64647845,2,"Reno-Sparks, NV",2,1,1,1.0,Drowning,0
64710159,2,"Nashville-Davidson-Murfreesboro, TN",12,1,1,1.0,Poison - does not include gas,0
64722141,2,"Lubbock, TX",8,1,1,1.0,"Narcotics or drugs, sleeping pills",0
64837078,2,"Topeka, KS",2,1,1,1.0,Drowning,0
65048332,1,"San Diego-Carlsbad-San Marcos, CA",3,1,1,1.0,Explosives,0
65052882,1,Rural Wyoming,9,1,1,1.0,Other gun,0
65110081,1,"Wichita, KS",0,1,1,1.0,Asphyxiation - includes death by gas,0
65208918,2,"Wheeling, WV-OH",14,1,1,1.0,Rifle,0
65250899,2,"Naples-Marco Island, FL",2,1,1,1.0,Drowning,0
65283589,2,Rural Connecticut,12,1,1,1.0,Poison - does not include gas,0
65306556,9,Rural Louisiana,11,1,1,1.0,"Personal weapons, includes beating",0
65400663,2,"Muskegon-Norton Shores, MI",2,1,1,1.0,Drowning,0
65418413,1,"Savannah, GA",2,1,1,1.0,Drowning,0
65455151,2,"Binghamton, NY",4,1,1,1.0,Fire,0
65508861,9,"Harrisburg-Carlisle, PA",5,1,1,1.0,"Firearm, type not stated",0
65512636,2,"Eau Claire, WI",8,1,1,1.0,"Narcotics or drugs, sleeping pills",0
65593853,2,"Spartanburg, SC",9,1,1,1.0,Other gun,0
65611694,1,"Clarksville, TN-KY",16,1,1,1.0,Strangulation - hanging,0
65625005,2,"Owensboro, KY",10,1,1,1.0,Other or type unknown,0
65712762,1,"State College, PA",16,1,1,1.0,Strangulation - hanging,0
65728563,1,"Valdosta, GA",3,1,1,1.0,Explosives,0
65750008,2,"Flint, MI",13,1,1,1.0,Pushed or thrown out window,0
65815494,2,"Corvallis, OR",12,1,1,1.0,Poison - does not include gas,0
65831138,9,Rural Georgia,0,1,1,1.0,Asphyxiation - includes death by gas,0
65945267,2,"Bloomington, IN",8,1,1,1.0,"Narcotics or drugs, sleeping pills",0
66079897,2,"Cheyenne, WY",16,1,1,1.0,Strangulation - hanging,0
66097362,2,Rural Hawaii,9,1,1,1.0,Other gun,0
66129761,2,"Wausau, WI",16,1,1,1.0,Strangulation - hanging,0
66130453,2,"Saginaw, MI",3,1,1,1.0,Explosives,0
66247625,9,"Grand Rapids-Wyoming, MI",11,1,1,1.0,"Personal weapons, includes beating",0
66329372,2,"Fayetteville-Springdale-Rogers, AR-MO",8,1,1,1.0,"Narcotics or drugs, sleeping pills",0
66366119,9,"Olympia, WA",6,1,1,1.0,"Handgun - pistol, revolver, etc",0
66427476,2,"Salem, OR",8,1,1,1.0,"Narcotics or drugs, sleeping pills",0
66470070,2,"Dover, DE",1,1,1,1.0,"Blunt object - hammer, club, etc",0
66748382,2,"Lewiston, ID-WA",8,1,1,1.0,"Narcotics or drugs, sleeping pills",0
66756623,2,"Milwaukee-Waukesha-West Allis, WI",3,1,1,1.0,Explosives,0
66779714,2,"Cedar Rapids, IA",8,1,1,1.0,"Narcotics or drugs, sleeping pills",0
66801141,9,Rural Arkansas,1,1,1,1.0,"Blunt object - hammer, club, etc",0
66824015,2,"Lawrence, KS",4,1,1,1.0,Fire,0
67029183,2,"Kokomo, IN",15,1,1,1.0,Shotgun,0
67167882,1,"College Station-Bryan, TX",9,1,1,1.0,Other gun,0
67233778,1,"Waco, TX",8,1,1,1.0,"Narcotics or drugs, sleeping pills",0
67263518,2,"Burlington, NC",12,1,1,1.0,Poison - does not include gas,0
67503247,2,"Hagerstown-Martinsburg, MD-WV",8,1,1,1.0,"Narcotics or drugs, sleeping pills",0
67601632,2,"Great Falls, MT",4,1,1,1.0,Fire,0
67612528,2,"Indianapolis, IN",3,1,1,1.0,Explosives,0
67732366,2,"Carson City, NV",10,1,1,1.0,Other or type unknown,0
67772617,2,"Oxnard-Thousand Oaks-Ventura, CA",8,1,1,1.0,"Narcotics or drugs, sleeping pills",0
67775558,2,"Lexington-Fayette, KY",3,1,1,1.0,Explosives,0
67902538,2,"Lima, OH",12,1,1,1.0,Poison - does not include gas,0
67939079,1,"Greensboro-High Point, NC",2,1,1,1.0,Drowning,0
68056172,1,Rural Hawaii,16,1,1,1.0,Strangulation - hanging,0
68071981,2,"Elkhart-Goshen, IN",14,1,1,1.0,Rifle,0
68077597,2,Rural Connecticut,5,1,1,1.0,"Firearm, type not stated",0
68141023,1,"Fort Wayne, IN",16,1,1,1.0,Strangulation - hanging,0
68207461,1,"Elmira, NY",16,1,1,1.0,Strangulation - hanging,0
68369117,1,Rural Arizona,2,1,1,1.0,Drowning,0
68407948,1,"Logan, UT-ID",15,1,1,1.0,Shotgun,0
68565380,1,"Norwich-New London, CT",13,1,1,1.0,Pushed or thrown out window,0
68628864,2,"Pine Bluff, AR",9,1,1,1.0,Other gun,0
68800490,1,"Appleton, WI",4,1,1,1.0,Fire,0
68853526,1,Rural Wisconsin,9,1,1,1.0,Other gun,0
68973636,2,"San Angelo, TX",1,1,1,1.0,"Blunt object - hammer, club, etc",0
68984081,2,"Ames, IA",5,1,1,1.0,"Firearm, type not stated",0
69069064,2,"Longview, TX",12,1,1,1.0,Poison - does not include gas,0
69075189,2,"Kokomo, IN",8,1,1,1.0,"Narcotics or drugs, sleeping pills",0
69177129,1,"Huntington-Ashland, WV-KY-OH",0,1,1,1.0,Asphyxiation - includes death by gas,0
69257199,2,"Springfield, MO",9,1,1,1.0,Other gun,0
69417492,2,"Jacksonville, FL",13,1,1,1.0,Pushed or thrown out window,0
69447888,1,"Rome, GA",16,1,1,1.0,Strangulation - hanging,0
69476564,1,"York-Hanover, PA",13,1,1,1.0,Pushed or thrown out window,0
69510678,1,"Bay City, MI",1,1,1,1.0,"Blunt object - hammer, club, etc",0
69664620,2,"Dothan, AL",3,1,1,1.0,Explosives,0
69707629,9,"Rochester, NY",11,1,1,1.0,"Personal weapons, includes beating",0
69724660,9,"Warner Robins, GA",6,1,1,1.0,"Handgun - pistol, revolver, etc",0
69760185,2,"Sheboygan, WI",15,1,1,1.0,Shotgun,0
69879544,2,"Lebanon, PA",1,1,1,1.0,"Blunt object - hammer, club, etc",0
69984968,1,"Gulfport-Biloxi, MS",13,1,1,1.0,Pushed or thrown out window,0
70150214,1,"Lincoln, NE",3,1,1,1.0,Explosives,0
70158397,2,"Missoula, MT",16,1,1,1.0,Strangulation - hanging,0
70191843,2,"Lincoln, NE",13,1,1,1.0,Pushed or thrown out window,0
70296415,1,"Bridgeport-Stamford-Norwalk, CT",2,1,1,1.0,Drowning,0
70302192,2,"Carson City, NV",14,1,1,1.0,Rifle,0
70328197,2,"San Angelo, TX",0,1,1,1.0,Asphyxiation - includes death by gas,0
70353401,1,"Kalamazoo-Portage, MI",12,1,1,1.0,Poison - does not include gas,0
70357837,1,"Jackson, MI",8,1,1,1.0,"Narcotics or drugs, sleeping pills",0
70400141,9,"Virginia Beach-Norfolk-Newport News, VA-NC",11,1,1,1.0,"Personal weapons, includes beating",0
70511184,1,"Alexandria, LA",13,1,1,1.0,Pushed or thrown out window,0
70630265,1,"Reading, PA",2,1,1,1.0,Drowning,0
70757275,1,"Dover, DE",4,1,1,1.0,Fire,0
70853465,1,Rural Delaware,0,1,1,1.0,Asphyxiation - includes death by gas,0
70978534,2,Rural North Dakota,8,1,1,1.0,"Narcotics or drugs, sleeping pills",0
71081904,1,Rural Hawaii,0,1,1,1.0,Asphyxiation - includes death by gas,0
71129863,2,"Fresno, CA",12,1,1,1.0,Poison - does not include gas,0
71284182,9,"Roanoke, VA",10,1,1,1.0,Other or type unknown,0
71314438,2,"Lebanon, PA",0,1,1,1.0,Asphyxiation - includes death by gas,0
71359840,1,"Burlington-South Burlington, VT",16,1,1,1.0,Strangulation - hanging,0
71370145,9,"Provo-Orem, UT",7,1,1,1.0,Knife or cutting instrument,0
71504359,2,"Wenatchee, WA",14,1,1,1.0,Rifle,0
71563079,1,"Utica-Rome, NY",16,1,1,1.0,Strangulation - hanging,0
71735070,2,"Gainesville, GA",4,1,1,1.0,Fire,0
71777363,2,Rural Maryland,0,1,1,1.0,Asphyxiation - includes death by gas,0
71970569,2,"Odessa, TX",8,1,1,1.0,"Narcotics or drugs, sleeping pills",0
72039337,1,"Greensboro-High Point, NC",12,1,1,1.0,Poison - does not include gas,0
72053308,2,"Dover, DE",0,1,1,1.0,Asphyxiation - includes death by gas,0
72081938,2,"Ithaca, NY",17,1,1,1.0,Weapon Not Reported,0
72084625,2,"Logan, UT-ID",1,1,1,1.0,"Blunt object - hammer, club, etc",0
72123299,9,"Terre Haute, IN",10,1,1,1.0,Other or type unknown,0
72187899,1,"Davenport-Moline-Rock Island, IA-IL",9,1,1,1.0,Other gun,0
72212927,1,"Dalton, GA",12,1,1,1.0,Poison - does not include gas,0
72243032,9,"Salem, OR",5,1,1,1.0,"Firearm, type not stated",0
72256663,1,"Memphis, TN-MS-AR",3,1,1,1.0,Explosives,0
72279217,2,"Anderson, SC",13,1,1,1.0,Pushed or thrown out window,0
72338191,9,Rural Kentucky,6,1,1,1.0,"Handgun - pistol, revolver, etc",0
72371561,9,"Grand Rapids-Wyoming, MI",5,1,1,1.0,"Firearm, type not stated",0
72390282,2,"Racine, WI",2,1,1,1.0,Drowning,0
72430122,2,"Iowa City, IA",0,1,1,1.0,Asphyxiation - includes death by gas,0
72460926,9,Rural New York,15,1,1,1.0,Shotgun,0
72613422,1,"St. Joseph, MO-KS",16,1,1,1.0,Strangulation - hanging,0
72691133,9,"Columbus, OH",9,1,1,1.0,Other gun,0
72718723,9,Rural Kansas,5,1,1,1.0,"Firearm, type not stated",0
72777944,1,"Winchester, VA-WV",4,1,1,1.0,Fire,0
72936158,9,"Raleigh-Cary, NC",14,1,1,1.0,Rifle,0
73069543,2,"Mount Vernon-Anacortes, WA",4,1,1,1.0,Fire,0
73123205,2,"Youngstown-Warren-Boardman, OH-PA",3,1,1,1.0,Explosives,0
73132009,1,"Kennewick-Richland-Pasco, WA",9,1,1,1.0,Other gun,0
73318924,2,"Mobile, AL",2,1,1,1.0,Drowning,0
73328745,2,"Decatur, AL",12,1,1,1.0,Poison - does not include gas,0
73470848,2,"St. Cloud, MN",4,1,1,1.0,Fire,0
73496797,1,"Fort Wayne, IN",9,1,1,1.0,Other gun,0
73500366,2,"Visalia-Porterville, CA",12,1,1,1.0,Poison - does not include gas,0
73544954,1,"Ithaca, NY",1,1,1,1.0,"Blunt object - hammer, club, etc",0
73547587,1,"Columbus, GA-AL",16,1,1,1.0,Strangulation - hanging,0
73577825,1,"La Crosse, WI-MN",4,1,1,1.0,Fire,0
73664056,2,"Austin-Round Rock, TX",13,1,1,1.0,Pushed or thrown out window,0
73748144,1,"Evansville, IN-KY",9,1,1,1.0,Other gun,0
73763953,1,"Johnstown, PA",0,1,1,1.0,Asphyxiation - includes death by gas,0
73947435,1,"Rochester, NY",12,1,1,1.0,Poison - does not include gas,0
73962680,1,"Monroe, MI",4,1,1,1.0,Fire,0
74003819,1,"Columbia, SC",12,1,1,1.0,Poison - does not include gas,0
74095889,1,"Port St. Lucie-Fort Pierce, FL",9,1,1,1.0,Other gun,0
74110444,1,"Bloomington, IN",13,1,1,1.0,Pushed or thrown out window,0
74268677,1,"Provo-Orem, UT",13,1,1,1.0,Pushed or thrown out window,0
74403715,2,"Odessa, TX",0,1,1,1.0,Asphyxiation - includes death by gas,0
74558415,2,"Holland-Grand Haven, MI",12,1,1,1.0,Poison - does not include gas,0
74993322,2,"Oxnard-Thousand Oaks-Ventura, CA",12,1,1,1.0,Poison - does not include gas,0
75006425,2,"Memphis, TN-MS-AR",13,1,1,1.0,Pushed or thrown out window,0
75238785,2,"Springfield, OH",8,1,1,1.0,"Narcotics or drugs, sleeping pills",0
75268152,2,"Miami-Fort Lauderdale, FL",3,1,1,1.0,Explosives,0
75434978,1,"Charleston, WV",12,1,1,1.0,Poison - does not include gas,0
75486240,2,"Sheboygan, WI",9,1,1,1.0,Other gun,0
75505373,1,"Springfield, MA",13,1,1,1.0,Pushed or thrown out window,0
75753565,1,"Wheeling, WV-OH",8,1,1,1.0,"Narcotics or drugs, sleeping pills",0
75799907,2,"Brunswick, GA",2,1,1,1.0,Drowning,0
75810363,1,"Florence-Muscle Shoals, AL",8,1,1,1.0,"Narcotics or drugs, sleeping pills",0
75846085,1,"Punta Gorda, FL",15,1,1,1.0,Shotgun,0
75910322,1,"Fayetteville, NC",0,1,1,1.0,Asphyxiation - includes death by gas,0
75923868,2,Rural North Carolina,13,1,1,1.0,Pushed or thrown out window,0
75936878,1,Rural Illinois,0,1,1,1.0,Asphyxiation - includes death by gas,0
75964820,1,"Charleston-North Charleston, SC",12,1,1,1.0,Poison - does not include gas,0
75979526,2,"Portland-South Portland-Biddeford, ME",13,1,1,1.0,Pushed or thrown out window,0
76009566,2,"Albuquerque, NM",2,1,1,1.0,Drowning,0
76155311,2,"Lewiston-Auburn, ME",4,1,1,1.0,Fire,0
76419942,2,Rural Illinois,8,1,1,1.0,"Narcotics or drugs, sleeping pills",0
76526563,2,Rural West Virginia,3,1,1,1.0,Explosives,0
76599330,1,"Chattanooga, TN-GA",12,1,1,1.0,Poison - does not include gas,0
76823124,1,"Raleigh-Cary, NC",16,1,1,1.0,Strangulation - hanging,0
76878417,2,"Elkhart-Goshen, IN",0,1,1,1.0,Asphyxiation - includes death by gas,0
77165278,9,"Terre Haute, IN",1,1,1,1.0,"Blunt object - hammer, club, etc",0
77168412,2,"Pine Bluff, AR",8,1,1,1.0,"Narcotics or drugs, sleeping pills",0
77213802,1,"Pittsburgh, PA",12,1,1,1.0,Poison - does not include gas,0
77345347,1,Rural Illinois,13,1,1,1.0,Pushed or thrown out window,0
77565316,1,"Cedar Rapids, IA",0,1,1,1.0,Asphyxiation - includes death by gas,0
77602395,2,"Billings, MT",15,1,1,1.0,Shotgun,0
77713365,2,"Sheboygan, WI",1,1,1,1.0,"Blunt object - hammer, club, etc",0
77758363,1,"Fayetteville, NC",13,1,1,1.0,Pushed or thrown out window,0
77831471,1,"McAllen-Edinburg-Mission, TX",8,1,1,1.0,"Narcotics or drugs, sleeping pills",0
78074614,1,"San Angelo, TX",9,1,1,1.0,Other gun,0
78168793,1,"Danville, IL",0,1,1,1.0,Asphyxiation - includes death by gas,0
78206541,2,"Grand Rapids-Wyoming, MI",13,1,1,1.0,Pushed or thrown out window,0
78275618,9,"Sacramento-Roseville, CA",8,1,1,1.0,"Narcotics or drugs, sleeping pills",0
78300503,1,"Bay City, MI",0,1,1,1.0,Asphyxiation - includes death by gas,0
78319222,9,Rural Tennessee,14,1,1,1.0,Rifle,0
78329548,1,"Williamsport, PA",16,1,1,1.0,Strangulation - hanging,0
78371302,1,"Holland-Grand Haven, MI",8,1,1,1.0,"Narcotics or drugs, sleeping pills",0
78416591,2,"Springfield, OH",0,1,1,1.0,Asphyxiation - includes death by gas,0
78445443,1,"Rockford, IL",9,1,1,1.0,Other gun,0
78465001,2,"Bismarck, ND",0,1,1,1.0,Asphyxiation - includes death by gas,0
78467260,1,"Duluth, MN-WI",9,1,1,1.0,Other gun,0
78488838,9,"Saginaw, MI",15,1,1,1.0,Shotgun,0
78542258,9,"Joplin, MO",10,1,1,1.0,Other or type unknown,0
78545166,1,"Harrisburg-Carlisle, PA",3,1,1,1.0,Explosives,0
78556992,2,"Lewiston, ID-WA",15,1,1,1.0,Shotgun,0
78609040,1,"Topeka, KS",9,1,1,1.0,Other gun,0
78722271,2,"Grand Forks, ND-MN",10,1,1,1.0,Other or type unknown,0
78757239,1,"Cape Coral-Fort Myers, FL",8,1,1,1.0,"Narcotics or drugs, sleeping pills",0
78772696,1,"Pensacola-Ferry Pass-Brent, FL",0,1,1,1.0,Asphyxiation - includes death by gas,0
78773928,2,Rural Maryland,12,1,1,1.0,Poison - does not include gas,0
78791655,9,"Asheville, NC",1,1,1,1.0,"Blunt object - hammer, club, etc",0
78793105,1,"Madera, CA",9,1,1,1.0,Other gun,0
78815202,2,"Danville, IL",1,1,1,1.0,"Blunt object - hammer, club, etc",0
78864130,2,"Fort Collins-Loveland, CO",8,1,1,1.0,"Narcotics or drugs, sleeping pills",0
79026587,9,Rural Michigan,8,1,1,1.0,"Narcotics or drugs, sleeping pills",0
79031275,9,"Rapid City, SD",7,1,1,1.0,Knife or cutting instrument,0
79054109,2,"Manchester-Nashua, NH",8,1,1,1.0,"Narcotics or drugs, sleeping pills",0
79101336,1,"Iowa City, IA",0,1,1,1.0,Asphyxiation - includes death by gas,0
79117771,9,"Kingston, NY",6,1,1,1.0,"Handgun - pistol, revolver, etc",0
79142405,2,"Lafayette, IN",8,1,1,1.0,"Narcotics or drugs, sleeping pills",0
79181303,1,"Elkhart-Goshen, IN",16,1,1,1.0,Strangulation - hanging,0
79293679,2,"Blacksburg-Christiansburg, VA",0,1,1,1.0,Asphyxiation - includes death by gas,0
79305350,2,"Missoula, MT",14,1,1,1.0,Rifle,0
79327284,9,"Macon, GA",6,1,1,1.0,"Handgun - pistol, revolver, etc",0
79508054,2,Rural Connecticut,8,1,1,1.0,"Narcotics or drugs, sleeping pills",0
79531708,2,Rural Connecticut,14,1,1,1.0,Rifle,0
79600623,2,"San Luis Obispo-Paso Robles, CA",8,1,1,1.0,"Narcotics or drugs, sleeping pills",0
79656693,1,"Erie, PA",16,1,1,1.0,Strangulation - hanging,0
79792927,1,"Hot Springs, AR",8,1,1,1.0,"Narcotics or drugs, sleeping pills",0
79834682,1,"Mount Vernon-Anacortes, WA",0,1,1,1.0,Asphyxiation - includes death by gas,0
79864153,1,"Johnstown, PA",2,1,1,1.0,Drowning,0
79939340,2,"Las Cruces, NM",8,1,1,1.0,"Narcotics or drugs, sleeping pills",0
80071700,2,"Cedar Rapids, IA",16,1,1,1.0,Strangulation - hanging,0
80116247,1,"Oshkosh-Neenah, WI",14,1,1,1.0,Rifle,0
80162217,1,"Jacksonville, FL",13,1,1,1.0,Pushed or thrown out window,0
80321889,2,"Modesto, CA",9,1,1,1.0,Other gun,0
80459577,2,"Jacksonville, NC",9,1,1,1.0,Other gun,0
80462372,2,"Ithaca, NY",13,1,1,1.0,Pushed or thrown out window,0
80644630,2,"Bangor, ME",2,1,1,1.0,Drowning,0
80724689,1,"Vineland-Millville-Bridgeton, NJ",13,1,1,1.0,Pushed or thrown out window,0
80744453,1,"Orlando-Kissimmee, FL",12,1,1,1.0,Poison - does not include gas,0
80748535,2,"Logan, UT-ID",7,1,1,1.0,Knife or cutting instrument,0
80863767,2,"Prescott, AZ",9,1,1,1.0,Other gun,0
80892216,9,"Knoxville, TN",7,1,1,1.0,Knife or cutting instrument,0
80994348,2,"Modesto, CA",12,1,1,1.0,Poison - does not include gas,0
81038707,1,"Honolulu, HI",9,1,1,1.0,Other gun,0
81042629,2,"Killeen-Temple-Fort Hood, TX",2,1,1,1.0,Drowning,0
81262995,2,Rural Tennessee,12,1,1,1.0,Poison - does not include gas,0
81295370,9,"Atlanta-Sandy Springs-Marietta, GA",7,1,1,1.0,Knife or cutting instrument,0
81295852,2,"Harrisburg-Carlisle, PA",9,1,1,1.0,Other gun,0
81301453,2,"Ocala, FL",4,1,1,1.0,Fire,0
81634757,1,"Medford, OR",2,1,1,1.0,Drowning,0
81719977,2,"Corpus Christi, TX",2,1,1,1.0,Drowning,0
81753454,1,"Green Bay, WI",12,1,1,1.0,Poison - does not include gas,0
81831182,2,"Portland-South Portland-Biddeford, ME",2,1,1,1.0,Drowning,0
81947439,1,Rural Iowa,12,1,1,1.0,Poison - does not include gas,0
82039851,2,"Houston-Sugar Land-Baytown, TX",12,1,1,1.0,Poison - does not include gas,0
82052205,2,"Athens-Clarke County, GA",9,1,1,1.0,Other gun,0
82091596,1,"Jackson, MS",13,1,1,1.0,Pushed or thrown out window,0
82106443,1,"Grand Forks, ND-MN",8,1,1,1.0,"Narcotics or drugs, sleeping pills",0
82242566,2,"Charleston, WV",3,1,1,1.0,Explosives,0
82291303,2,"New Orleans-Metairie-Kenner, LA",3,1,1,1.0,Explosives,0
82311297,9,Rural Arkansas,0,1,1,1.0,Asphyxiation - includes death by gas,0
82321532,9,Rural North Carolina,9,1,1,1.0,Other gun,0
82377025,2,Rural Kentucky,12,1,1,1.0,Poison - does not include gas,0
82408401,1,"Utica-Rome, NY",9,1,1,1.0,Other gun,0
82541976,1,"Rome, GA",9,1,1,1.0,Other gun,0
82586240,2,"Cleveland, TN",4,1,1,1.0,Fire,0
82603004,1,"Cedar Rapids, IA",8,1,1,1.0,"Narcotics or drugs, sleeping pills",0
82787858,1,"Longview, TX",3,1,1,1.0,Explosives,0
82857845,1,"Kalamazoo-Portage, MI",16,1,1,1.0,Strangulation - hanging,0
82881896,9,"Atlanta-Sandy Springs-Marietta, GA",14,1,1,1.0,Rifle,0
82972030,2,"Pascagoula, MS",9,1,1,1.0,Other gun,0
82980414,2,"Boulder, CO",8,1,1,1.0,"Narcotics or drugs, sleeping pills",0
83150434,2,"Boise City-Nampa, ID",12,1,1,1.0,Poison - does not include gas,0
83241157,2,"Greeley, CO",0,1,1,1.0,Asphyxiation - includes death by gas,0
83247951,2,"La Crosse, WI-MN",8,1,1,1.0,"Narcotics or drugs, sleeping pills",0
83300723,2,"Greenville, SC",12,1,1,1.0,Poison - does not include gas,0
83338050,2,"Winston-Salem, NC",2,1,1,1.0,Drowning,0
83378730,1,"Erie, PA",2,1,1,1.0,Drowning,0
83527342,9,"Grand Rapids-Wyoming, MI",7,1,1,1.0,Knife or cutting instrument,0
83658833,1,"Wichita, KS",12,1,1,1.0,Poison - does not include gas,0
83675604,2,"Medford, OR",2,1,1,1.0,Drowning,0
83783620,9,"Shreveport-Bossier City, LA",7,1,1,1.0,Knife or cutting instrument,0
83835163,2,"Rochester, NY",12,1,1,1.0,Poison - does not include gas,0
83853711,2,"Eugene-Springfield, OR",13,1,1,1.0,Pushed or thrown out window,0
84007930,2,"Brunswick, GA",9,1,1,1.0,Other gun,0
84184806,2,"Hinesville-Fort Stewart, GA",1,1,1,1.0,"Blunt object - hammer, club, etc",0
84236503,2,"St. Joseph, MO-KS",8,1,1,1.0,"Narcotics or drugs, sleeping pills",0
84526515,1,"Rochester, NY",2,1,1,1.0,Drowning,0
84631652,9,Rural Oklahoma,14,1,1,1.0,Rifle,0
84789627,9,Rural Kansas,11,1,1,1.0,"Personal weapons, includes beating",0
84842002,1,Rural Vermont,3,1,1,1.0,Explosives,0
84916153,2,"Sheboygan, WI",0,1,1,1.0,Asphyxiation - includes death by gas,0
85074721,1,"Huntsville, AL",4,1,1,1.0,Fire,0
85260130,2,Rural Delaware,8,1,1,1.0,"Narcotics or drugs, sleeping pills",0
85270140,2,"Odessa, TX",4,1,1,1.0,Fire,0
85321008,9,"Charleston, WV",1,1,1,1.0,"Blunt object - hammer, club, etc",0
85456929,2,"Tulsa, OK",12,1,1,1.0,Poison - does not include gas,0
85537337,9,"Hot Springs, AR",15,1,1,1.0,Shotgun,0
85556286,9,"Boise City-Nampa, ID",10,1,1,1.0,Other or type unknown,0
85584003,1,"Huntsville, AL",16,1,1,1.0,Strangulation - hanging,0
85635490,9,"Jacksonville, NC",1,1,1,1.0,"Blunt object - hammer, club, etc",0
85646434,9,"Bremerton-Silverdale, WA",1,1,1,1.0,"Blunt object - hammer, club, etc",0
85713901,9,"Rocky Mount, NC",6,1,1,1.0,"Handgun - pistol, revolver, etc",0
85774540,2,"Fargo, ND-MN",16,1,1,1.0,Strangulation - hanging,0
85946338,2,"Norwich-New London, CT",5,1,1,1.0,"Firearm, type not stated",0
86026543,1,"Lafayette, LA",12,1,1,1.0,Poison - does not include gas,0
86039528,1,"Reno-Sparks, NV",8,1,1,1.0,"Narcotics or drugs, sleeping pills",0
86082584,1,"Iowa City, IA",12,1,1,1.0,Poison - does not include gas,0
86157141,2,Rural Nebraska,12,1,1,1.0,Poison - does not include gas,0
86159135,2,"Port St. Lucie-Fort Pierce, FL",9,1,1,1.0,Other gun,0
86176080,2,"Fort Smith, AR-OK",0,1,1,1.0,Asphyxiation - includes death by gas,0
86296526,1,"Napa, CA",2,1,1,1.0,Drowning,0
86329079,2,"Deltona-Daytona Beach-Ormond Beach, FL",12,1,1,1.0,Poison - does not include gas,0
86420303,1,"Battle Creek, MI",9,1,1,1.0,Other gun,0
86477538,2,"Rocky Mount, NC",16,1,1,1.0,Strangulation - hanging,0
86510349,9,"Charleston, WV",11,1,1,1.0,"Personal weapons, includes beating",0
86565651,1,Rural South Carolina,3,1,1,1.0,Explosives,0
86586653,2,"Jackson, MS",12,1,1,1.0,Poison - does not include gas,0
86606428,9,"Yuma, AZ",7,1,1,1.0,Knife or cutting instrument,0
86727061,1,"Rockford, IL",16,1,1,1.0,Strangulation - hanging,0
86857845,1,"Stockton, CA",12,1,1,1.0,Poison - does not include gas,0
86989853,9,"Medford, OR",10,1,1,1.0,Other or type unknown,0
87057576,1,"Saginaw, MI",12,1,1,1.0,Poison - does not include gas,0
87115533,2,"Deltona-Daytona Beach-Ormond Beach, FL",2,1,1,1.0,Drowning,0
87215718,1,Rural South Carolina,13,1,1,1.0,Pushed or thrown out window,0
87230452,1,"Lincoln, NE",13,1,1,1.0,Pushed or thrown out window,0
87292072,2,Rural Indiana,2,1,1,1.0,Drowning,0
87447086,2,"Altoona, PA",16,1,1,1.0,Strangulation - hanging,0
87643029,1,"Macon, GA",0,1,1,1.0,Asphyxiation - includes death by gas,0
87677368,2,"Logan, UT-ID",8,1,1,1.0,"Narcotics or drugs, sleeping pills",0
87700672,9,Rural Louisiana,7,1,1,1.0,Knife or cutting instrument,0
87775208,1,"Iowa City, IA",16,1,1,1.0,Strangulation - hanging,0
87904968,1,"Portland-South Portland-Biddeford, ME",2,1,1,1.0,Drowning,0
87954526,9,"Bakersfield, CA",15,1,1,1.0,Shotgun,0
87955648,9,"Denver-Aurora, CO",9,1,1,1.0,Other gun,0
87976219,9,Rural Ohio,8,1,1,1.0,"Narcotics or drugs, sleeping pills",0
88042143,2,"Madera, CA",4,1,1,1.0,Fire,0
88113344,2,"Columbus, GA-AL",4,1,1,1.0,Fire,0
88161011,2,"Williamsport, PA",0,1,1,1.0,Asphyxiation - includes death by gas,0
88213300,1,"Fort Collins-Loveland, CO",8,1,1,1.0,"Narcotics or drugs, sleeping pills",0
88242379,1,"Ames, IA",1,1,1,1.0,"Blunt object - hammer, club, etc",0
88281598,9,"Knoxville, TN",6,1,1,1.0,"Handgun - pistol, revolver, etc",0
88301247,9,"Greensboro-High Point, NC",9,1,1,1.0,Other gun,0
88469943,1,"Sandusky, OH",5,1,1,1.0,"Firearm, type not stated",0
88558600,1,Rural Washington,12,1,1,1.0,Poison - does not include gas,0
88630064,9,"Youngstown-Warren-Boardman, OH-PA",10,1,1,1.0,Other or type unknown,0
88810631,9,"Houma-Bayou Cane-Thibodaux, LA",7,1,1,1.0,Knife or cutting instrument,0
88873101,2,"Santa Rosa-Petaluma, CA",3,1,1,1.0,Explosives,0
88886823,9,"Columbia, SC",10,1,1,1.0,Other or type unknown,0
88903461,2,"St. Cloud, MN",5,1,1,1.0,"Firearm, type not stated",0
88978389,1,"Carson City, NV",15,1,1,1.0,Shotgun,0
89088832,2,"Toledo, OH",9,1,1,1.0,Other gun,0
89143826,2,"Joplin, MO",16,1,1,1.0,Strangulation - hanging,0
89173417,1,"Bloomington, IN",4,1,1,1.0,Fire,0
89176150,2,"Las Cruces, NM",16,1,1,1.0,Strangulation - hanging,0
89219718,9,"Riverside-San Bernardino, CA",11,1,1,1.0,"Personal weapons, includes beating",0
89308997,2,"San Francisco-Oakland-Fremont, CA",3,1,1,1.0,Explosives,0
89370036,2,"Lynchburg, VA",0,1,1,1.0,Asphyxiation - includes death by gas,0
89442620,2,"Reno-Sparks, NV",4,1,1,1.0,Fire,0
89458941,2,"Redding, CA",2,1,1,1.0,Drowning,0
89798806,2,"Blacksburg-Christiansburg, VA",4,1,1,1.0,Fire,0
89803734,9,"Denver-Aurora, CO",5,1,1,1.0,"Firearm, type not stated",0
89818792,2,"Jackson, MS",0,1,1,1.0,Asphyxiation - includes death by gas,0
90008353,1,"Naples-Marco Island, FL",3,1,1,1.0,Explosives,0
90060065,1,"Billings, MT",16,1,1,1.0,Strangulation - hanging,0
90061010,2,"Bangor, ME",8,1,1,1.0,"Narcotics or drugs, sleeping pills",0
90102882,1,Rural Illinois,8,1,1,1.0,"Narcotics or drugs, sleeping pills",0
90104129,2,Rural New York,3,1,1,1.0,Explosives,0
90154577,1,"Orlando-Kissimmee, FL",0,1,1,1.0,Asphyxiation - includes death by gas,0
90207523,2,"Carson City, NV",15,1,1,1.0,Shotgun,0
90264776,1,Rural North Dakota,4,1,1,1.0,Fire,0
90390430,1,"Springfield, MO",13,1,1,1.0,Pushed or thrown out window,0
90455027,9,"Kansas City, MO-KS",11,1,1,1.0,"Personal weapons, includes beating",0
90521339,2,Rural Texas,3,1,1,1.0,Explosives,0
90774543,1,"Vineland-Millville-Bridgeton, NJ",0,1,1,1.0,Asphyxiation - includes death by gas,0
90835209,2,"Ocala, FL",2,1,1,1.0,Drowning,0
90958364,2,"Killeen-Temple-Fort Hood, TX",4,1,1,1.0,Fire,0
90970744,2,"Fort Collins-Loveland, CO",0,1,1,1.0,Asphyxiation - includes death by gas,0
90990498,1,"Odessa, TX",4,1,1,1.0,Fire,0
91002394,1,"Florence-Muscle Shoals, AL",2,1,1,1.0,Drowning,0
91050122,1,"Parkersburg-Marietta-Vienna, WV-OH",2,1,1,1.0,Drowning,0
91209854,2,"Sandusky, OH",8,1,1,1.0,"Narcotics or drugs, sleeping pills",0
91305461,2,"Lebanon, PA",16,1,1,1.0,Strangulation - hanging,0
91324326,1,"Appleton, WI",14,1,1,1.0,Rifle,0
91354756,2,"Columbus, GA-AL",2,1,1,1.0,Drowning,0
91381063,1,"Valdosta, GA",2,1,1,1.0,Drowning,0
91438733,2,"Austin-Round Rock, TX",3,1,1,1.0,Explosives,0
91443206,1,"Nashville-Davidson-Murfreesboro, TN",3,1,1,1.0,Explosives,0
91452153,1,"Baltimore-Towson, MD",3,1,1,1.0,Explosives,0
92076496,2,"Houston-Sugar Land-Baytown, TX",3,1,1,1.0,Explosives,0
92129722,2,Rural Pennsylvania,13,1,1,1.0,Pushed or thrown out window,0
92305457,1,"Anderson, IN",0,1,1,1.0,Asphyxiation - includes death by gas,0
92325838,2,Rural Vermont,13,1,1,1.0,Pushed or thrown out window,0
92365855,1,"Punta Gorda, FL",16,1,1,1.0,Strangulation - hanging,0
92432995,1,"Morristown, TN",8,1,1,1.0,"Narcotics or drugs, sleeping pills",0
92468854,2,"Visalia-Porterville, CA",2,1,1,1.0,Drowning,0
92501429,2,"Jefferson City, MO",4,1,1,1.0,Fire,0
92696478,1,"Redding, CA",16,1,1,1.0,Strangulation - hanging,0
92760388,1,"Las Cruces, NM",16,1,1,1.0,Strangulation - hanging,0
92791986,9,"Cincinnati-Middletown, OH-KY-IN",11,1,1,1.0,"Personal weapons, includes beating",0
92863798,2,Rural Kansas,12,1,1,1.0,Poison - does not include gas,0
92871635,1,"Sherman-Denison, TX",16,1,1,1.0,Strangulation - hanging,0
92900836,1,"Redding, CA",12,1,1,1.0,Poison - does not include gas,0
92911840,2,"Stockton, CA",9,1,1,1.0,Other gun,0
92940619,9,"Buffalo-Niagara Falls, NY",10,1,1,1.0,Other or type unknown,0
93022929,1,"Fort Smith, AR-OK",2,1,1,1.0,Drowning,0
93127626,1,"Jefferson City, MO",4,1,1,1.0,Fire,0
93152317,1,"Glens Falls, NY",5,1,1,1.0,"Firearm, type not stated",0
93153304,9,"Akron, OH",7,1,1,1.0,Knife or cutting instrument,0
93195041,1,"Sioux City, IA-NE-SD",2,1,1,1.0,Drowning,0
93269119,2,"Weirton-Steubenville, WV-OH",5,1,1,1.0,"Firearm, type not stated",0
93511161,1,Rural Mississippi,3,1,1,1.0,Explosives,0
93522042,2,"Lancaster, PA",13,1,1,1.0,Pushed or thrown out window,0
93588284,9,"Rocky Mount, NC",5,1,1,1.0,"Firearm, type not stated",0
93627199,1,Rural South Dakota,16,1,1,1.0,Strangulation - hanging,0
93633226,1,"Greensboro-High Point, NC",0,1,1,1.0,Asphyxiation - includes death by gas,0
93695152,1,"Ithaca, NY",4,1,1,1.0,Fire,0
93701601,2,"Altoona, PA",0,1,1,1.0,Asphyxiation - includes death by gas,0
93748213,1,"Monroe, MI",0,1,1,1.0,Asphyxiation - includes death by gas,0
93818040,9,"Salt Lake City, UT",10,1,1,1.0,Other or type unknown,0
93858775,1,"Burlington, NC",16,1,1,1.0,Strangulation - hanging,0
93922002,2,"Terre Haute, IN",0,1,1,1.0,Asphyxiation - includes death by gas,0
93955452,1,"Provo-Orem, UT",0,1,1,1.0,Asphyxiation - includes death by gas,0
93995728,2,"Indianapolis, IN",13,1,1,1.0,Pushed or thrown out window,0
94113755,2,"Iowa City, IA",15,1,1,1.0,Shotgun,0
94161497,2,"Lawrence, KS",15,1,1,1.0,Shotgun,0
94170382,1,"Oxnard-Thousand Oaks-Ventura, CA",8,1,1,1.0,"Narcotics or drugs, sleeping pills",0
94171613,2,Rural Montana,2,1,1,1.0,Drowning,0
94284108,1,"Grand Rapids-Wyoming, MI",13,1,1,1.0,Pushed or thrown out window,0
94335121,2,"Lewiston, ID-WA",11,1,1,1.0,"Personal weapons, includes beating",0
94336800,2,"Sioux City, IA-NE-SD",5,1,1,1.0,"Firearm, type not stated",0
94455430,2,"Yuba City, CA",2,1,1,1.0,Drowning,0
94546153,1,"Midland, TX",0,1,1,1.0,Asphyxiation - includes death by gas,0
94568375,2,"Burlington-South Burlington, VT",15,1,1,1.0,Shotgun,0
94662153,2,Rural Connecticut,0,1,1,1.0,Asphyxiation - includes death by gas,0
94773798,2,"Punta Gorda, FL",0,1,1,1.0,Asphyxiation - includes death by gas,0
95055478,1,"Omaha-Council Bluffs, NE-IA",8,1,1,1.0,"Narcotics or drugs, sleeping pills",0
95215325,2,"Rochester, MN",4,1,1,1.0,Fire,0
95348404,2,"Greenville, NC",4,1,1,1.0,Fire,0
95397559,9,"Dayton, OH",11,1,1,1.0,"Personal weapons, includes beating",0
95411549,1,"Kankakee-Bradley, IL",9,1,1,1.0,Other gun,0
95443221,2,"Boston-Cambridge-Quincy, MA-NH",13,1,1,1.0,Pushed or thrown out window,0
95558360,9,"Lansing-East Lansing, MI",6,1,1,1.0,"Handgun - pistol, revolver, etc",0
95646815,2,"Roanoke, VA",12,1,1,1.0,Poison - does not include gas,0
95648883,9,"Syracuse, NY",10,1,1,1.0,Other or type unknown,0
95761778,2,"St. George, UT",15,1,1,1.0,Shotgun,0
95855023,1,"Jackson, MS",12,1,1,1.0,Poison - does not include gas,0
95977734,1,"Lincoln, NE",8,1,1,1.0,"Narcotics or drugs, sleeping pills",0
96023799,9,"St. George, UT",5,1,1,1.0,"Firearm, type not stated",0
96103774,2,"Colorado Springs, CO",2,1,1,1.0,Drowning,0
96159110,1,"Warner Robins, GA",0,1,1,1.0,Asphyxiation - includes death by gas,0
96187447,2,"Mount Vernon-Anacortes, WA",0,1,1,1.0,Asphyxiation - includes death by gas,0
96369628,2,"Clarksville, TN-KY",4,1,1,1.0,Fire,0
96424781,1,"Madison, WI",0,1,1,1.0,Asphyxiation - includes death by gas,0
96530488,2,"Trenton-Ewing, NJ",13,1,1,1.0,Pushed or thrown out window,0
96532554,2,"Kokomo, IN",4,1,1,1.0,Fire,0
96615038,2,"Johnson City, TN",4,1,1,1.0,Fire,0
96708008,1,"Altoona, PA",4,1,1,1.0,Fire,0
96709312,2,"Lewiston-Auburn, ME",0,1,1,1.0,Asphyxiation - includes death by gas,0
96756540,1,"Milwaukee-Waukesha-West Allis, WI",12,1,1,1.0,Poison - does not include gas,0
96897073,2,"Lafayette, IN",12,1,1,1.0,Poison - does not include gas,0
97022169,1,"Brunswick, GA",16,1,1,1.0,Strangulation - hanging,0
97024931,2,"Kankakee-Bradley, IL",0,1,1,1.0,Asphyxiation - includes death by gas,0
97047751,1,"Lansing-East Lansing, MI",12,1,1,1.0,Poison - does not include gas,0
97067853,2,"Topeka, KS",9,1,1,1.0,Other gun,0
97151914,2,"El Centro, CA",8,1,1,1.0,"Narcotics or drugs, sleeping pills",0
97247593,2,"Glens Falls, NY",16,1,1,1.0,Strangulation - hanging,0
97285565,1,"Ocala, FL",0,1,1,1.0,Asphyxiation - includes death by gas,0
97324946,1,"Napa, CA",10,1,1,1.0,Other or type unknown,0
97489783,1,"Farmington, NM",0,1,1,1.0,Asphyxiation - includes death by gas,0
97508238,2,"Raleigh-Cary, NC",3,1,1,1.0,Explosives,0
97526873,2,"Mount Vernon-Anacortes, WA",5,1,1,1.0,"Firearm, type not stated",0
97583149,1,"Burlington, NC",12,1,1,1.0,Poison - does not include gas,0
97642609,2,Rural Tennessee,13,1,1,1.0,Pushed or thrown out window,0
97654443,1,"Wheeling, WV-OH",0,1,1,1.0,Asphyxiation - includes death by gas,0
97667822,9,"Fayetteville, NC",14,1,1,1.0,Rifle,0
97753285,9,"Spokane, WA",10,1,1,1.0,Other or type unknown,0
97767598,2,Rural Colorado,9,1,1,1.0,Other gun,0
97784579,1,"Farmington, NM",4,1,1,1.0,Fire,0
97883679,9,"Salt Lake City, UT",8,1,1,1.0,"Narcotics or drugs, sleeping pills",0
97885842,2,"Charleston, WV",2,1,1,1.0,Drowning,0
97930060,2,"Owensboro, KY",0,1,1,1.0,Asphyxiation - includes death by gas,0
97972999,2,"Pensacola-Ferry Pass-Brent, FL",9,1,1,1.0,Other gun,0
98047358,2,"Rome, GA",4,1,1,1.0,Fire,0
98220278,1,Rural Alaska,13,1,1,1.0,Pushed or thrown out window,0
98541898,2,"Anderson, IN",0,1,1,1.0,Asphyxiation - includes death by gas,0
98548718,2,"Muskegon-Norton Shores, MI",0,1,1,1.0,Asphyxiation - includes death by gas,0
98568989,2,"Ann Arbor, MI",8,1,1,1.0,"Narcotics or drugs, sleeping pills",0
98744465,2,"Lubbock, TX",2,1,1,1.0,Drowning,0
98757512,1,"Amarillo, TX",9,1,1,1.0,Other gun,0
99003992,1,"Poughkeepsie-Newburgh-Middletown, NY",9,1,1,1.0,Other gun,0
99156325,9,"Austin-Round Rock, TX",6,1,1,1.0,"Handgun - pistol, revolver, etc",0
99367976,1,"Springfield, IL",8,1,1,1.0,"Narcotics or drugs, sleeping pills",0
99441329,1,"El Centro, CA",3,1,1,1.0,Explosives,0
99486098,1,Rural Maine,12,1,1,1.0,Poison - does not include gas,0
99518568,2,"Bend, OR",13,1,1,1.0,Pushed or thrown out window,0
99596720,9,"Fayetteville, NC",15,1,1,1.0,Shotgun,0
99672723,2,Rural Florida,12,1,1,1.0,Poison - does not include gas,0
99716668,9,"Olympia, WA",7,1,1,1.0,Knife or cutting instrument,0
99730740,2,"Harrisburg-Carlisle, PA",3,1,1,1.0,Explosives,0
99892085,2,"Goldsboro, NC",4,1,1,1.0,Fire,0
